XOOXOOOOXXOXOOXXOOXXOOOOOXOXOOOOOXOOOOXXOOXOXOOXOXXOOOOXOXOOOOXOOOOOOOOOOOXOOXOOOXOOOOXXOOXOXXOOOXOOX
OOOXXOOOOOOXOOXOXXOOOOOXOOOOXOOOXOXOXOOOXOOOOOOOOXOXOOOXOOOOOOOOXOOOXOOOOOOXOOOOOOOOOOOOOXOOOXOXOOOOO
XXOXXXXOOOOOOOOXOXOOXOXXOXOOOXOOXOOXOXXOXOXXXXOXOXOOOXOOOXOOXXXOOOOOOOOOOOOXOOOOXOOXOOOOOXOXOXOOOOXXX
XOXXXOOOOOXOXOXOOOOXOOOOXOOOXOOXXXXOXOOOOOOOXOOOOOOOOOXXOOOOXOXXOXOXOOXXOOOOOOXXOOOXOOXOXXOXXOOXOOOOO
XOOOXOXOOOOOXOOOOXOOOOOOOXOOOOOOXXXOOOXOOOOOOXOOXOOOOOXOOXOOXXOOXOOOOOXOXOXOOOOOOXXOOOOOOOOXOOOOOXXOX
OXOOXOOOOOOOOOOOXXXOOOOOXOXOOOXOOOOXOXOOOOOOOXOOOOOOOOOOOXOOXOOOOXOOOOOXOOOXXXOOOOXXXOOOXXOOOOOOOXOOO
XOXOOOOOOOOOOOOOOOXOOXOOOOOXOOOOOOXOXOXOOXOOOXOOXXXXXOOXOOXXXOOOXOXXOOXOOOOOXXOOOXXOOOOOXOOOOOOXOOOOO
OOOOOOOOOXOXXOOXOOOOOOOXXOXOOOOOOXXOXXOXOOXOOXXOXOOOOXOOOXOOOOOXOOOOXOXOXXOOOOOOOXOXOOOOOXOOOOOOOOXOO
OOOOOXOOXOXOOXXXOOOOOOXXOOOOOXXOOOOOOOOXOOOOXOOXOOOOOXXXOXXOOOOXXXOOOOOOXOOXOXOXXOOOXXXOXOXOOXOOXXOOO
OXXOXOOXXOXXOOXOOOXXOOOOOXOXOXXXXOOOOOOOOOOXXOOOOOOXXXXOOOOOOOXOOXOOOXOOOOXOOXXOOOXOOXOOOXOOXOOOOXOXO
OOOXOOOOOOOOOOXOXOOOOOOXOOOOOXOOXOOOOXXOOOOOOOOXOOOOXOXOOOOOXOOXXOOXOXOOOOOXOXXOOOOXOOXXOOXOOOOOOXOOO
OOOOXOXXXOOXOXXOOOOXXOOOXOOOOOXOOOOOOOXXXOOXOOOOXOOXXOXXOOOOOOXOOOOOOXOOXOOOOOOXOOOOXXOXXXOOOOXOOOOXO
OOOXOXXXOXOOOOOOOOXXOOOOOXOXOOXXOOOXOXOXXXOOOOOOOOOOOOXOOOOOOXOOOXXXOOXOOOXOOOXXOOOOOOOOXOXOOOXOOOXOO
XOOXOOXXOXXOOOOXOXXOXOOOOOOOXOOOXOOXOOXOOOOOOXXOOOOXOOOOOOXOOXOOOOOXOOOXOOOOOOXXXOXOOOOOOOXOOOXOOOXOO
OXXOOOOXOOOXOOOOOOOOXOXXOOOOXOXOOOOOOXOOOXOXXOOOOOXOOOXXOOOOOOOXXOOXOOOXOOOXOXOXOOOOOXXOXOXOOXOXOXOOX
OXXXOOXXOXOXXOOXOOXOOXXOOOXOOXOXOOOXOXOOOXOXOOOOOOOOXXXOXOOOXXXXXOXOOXOOOOOOOXXOXOXOOOOOOXOOOOOOXOOOO
OXOOOXXOOXXOOOOXOXOXOOOOOOOOOXOOXOOOOOOOOXOOOOXOXOOOXXOOOXXOOOOXOOOXOXOXXOOOOXXXOOXXXXOOOOXOOOOOXXXOO
OXXOOXOOOOOOOOOXOOOXOXOXOXOXOXOOXXOXOXOOOOOXXOOOOOXOXXOOXOOXOXOOXOXOOXOOOOXOXXOOOOOOXOOOOOOOOOOXXOOOO
XOOOXXOXXOOOXOOOOOOOOOOOOOOXOXOXXOOXOOOOOOOOOXOXOOOOXXXOXOOOOXXOXOOOOOOOOOXOOXOOOXOOOOXOOOXXOOOXXOOXX
OOOXOOXOOOOOOOOOOOXOOOOOOOOOOXOXOOOXXOOOOXXXOXXXXOOOOOOOXOOOOOOOOOOOOOXOOXOOOOOOXOOXOXXXOXOXOOOOXOOXX
OOOOOOOXXXOOOXOOOXOOOXOOOOXOOOOXOOOXOOOXOOOXXOOOOOXXOOOOXOOOXOOOOXOOOOXOOOOOOXOOOOOOOOXOOOOOOXOOOOXXO
OXOOOOXOOOXXOXXXOOOXOOOOOOXOOOOXOXOOXOOXXXOXXOOXXOOOOOOOOOOOOXOOOXOXOOOOOXOOOOOOOOOOOOXOOOOOOOOOXOOXO
OOOOXOOOOXXOOOOOOOOOOOXOOOXOXOOOXOOOOXOOOOXXOXOOXOOOOXOOXOOXOOXOXOXXOOOOOXOOOOXOXXOXXXOXOOXOXOOOOOOOO
OOXOOOOOXXOOOOOOOOOOXXOOOOOOXOOXOXOOOOOXOOOOXOOOOOXOOOOXOOXOOOOOOXXOOOOOOOOOXOOOXOOXOOXOXOOOOOXXOOXOO
OOOOXOOOOOOOOXOOOOXXOOXOXOXOOXOOXOOOOXOXXOOOOOOOOOOXOOOOOOOOOOXOOOXOOXOOOOOOXOXXOOXOOOOXXXOOOOOXXOOOO
OOOXOOXOOOOXOXXOXXOXXOOXXOXOOOOXOOOOOOOXXOOOOXOXXOXOOXXOOXOOXOXOOOOOXXXOOOOOOXOOOOXXXOOOOOXXXXXXOOXXO
OOOOOOXOOXOXOOXXOOXXOXOXXXOOOOOXXOXOXXXOOOXXOOXOOOOOXOOOXXOOOOOXXXOOXOXOOOXXOXXXOOXOXXXXOXOOOXOOXOOOO
XXXXXOOOOOXOOXXOOOOXOXOOOOOOOOOOXXOOXXOOOXXOOOOXOOXOXOOOOOOOXXOOXXXXXOOOXXOOXOOOOXOOOOOOXOOOOOOOOOOOO
OOOOOOOXOOOOOOXOOOOXOOOXOXOXXOOXXOXOOOXXOOOOXOOOXXOOXXXOOOXOXXOXXOOXOOOOOXOOOOOOXOOXXXXOXXOOOOXOOOXOX
OXOOXOOXXOXOXXOOXXOXOOOOOOOXOOOOOOXOOOOOOXOOOXOOOOOOOXXOOOXOOOOOOOXXOOXOOOOOXOOXOXOOOOOXOXOOXXOXXOOOO
XOOXOOXOOOXOOOOOOXOXOXXOOOOOOXOOXOXOOOOOXOXOXOOXOOOOOOOOXOXOOOOXOOOXOOOXOOOXOXOOOXXXXOOOXOOOXOXOOXXOO
XOOOXOXOOXXXXXOOOOOOXXOOOXXOOOOXOOOXXXOOOOOOOOOOXOOOXOOOXOOOXOOXOXXXOOOXXOXXOOXXOOOOOOOXOXXOOOOOOXOOO
OOXOOOOXOXOOOOOXOXOOXOOXOOXOXXXOXXOXOOXXOOOOOOOOXOOXOOOXOXOOXOOOOOOOOOOXOOOOOOOOOXOOOOXXOOOOOOXOOXOXO
OOXXOOOOXOXXOOOOOOXOOXXOOOOOOOOXXOOXOOOOOOOOXXXXOOOOXOOOOOXXOXOOOOOXOOXOXXOOXOOOXOOXOXXOOOOXXXOXXOOOO
OOOOOXOOOOOOOXOOOXXOXOXOXXOOXOXXOXXOOXXOOOOXOOOOOOXOOOXOOXXOOOOOOOXOOOOOOOXXOOOXXXOOOXOOOXXOXOOOOOOOO
XOOOOOOOOXOOOXXOXOOOOOXOOOOOXXOOOXOOOOXOOXXOXOOOOOXOXOOOOOOXXOXOXOOOXOOOXOOOXOOOXXOOOOXXXOXXXOOOXOOXO
XOOXOXXXOOOXXXOOOOOOXOOOOXOXOXOXOOOOOOOXOOOOOOOXXXOOOXOXXOOOXOOOXOXOXOOXOOOOOXOXOXOOOOXOOOOOOXOOOOOXO
OOOOOOOOXOOOXOOOOOOOXOOOOOOXOXOXXOOXXOXXOXOOOOOOOOOXOOOOXOOOXXXOOXOXOOXXOOXOOOOOOOOOXOXXXXXOOXXOXOOXO
OOOOOOOOXOOOOXOOOOXOOOOOXXOOOOOXOXOOXOXXXXOOOOOOXXOOOXXOXOOXXOOXOOOOOOXOOOOOXOOXOOOXOOXOOOOOOOOOXOOXO
OXXOOOOOXXOOXOOOOOOOOOOXOOOOOXOOOOOOOXOOOOOOOXOOOOOXOOXXOOOOOXOOXOOXXOXXXOOOOOOOXOOXOOOOXOXOOXOOOXXOO
XXOOXOOOOOOOOOOOOOOXOOXOOOXXXXOOOOOOOXOOOXOOOXOXXOOOOOOOOXOOOXOOXOOOOOXOOOXOOOOOOXXOOOOXOOOOOXOOOOOOO
OXOOOXXXXOOXOOOXOOOXOXXOOOOOOOOXOOXOOXOOOOOOXOOOXOXXOOOOOXXOXOOXOOOOOOOOOXOOXOOOOXXOOXOXOOOOOXOOOXXOO
OXOOOOXOOOOOOOOOOXOOXOOXOXXOOOOXOOOOOOXOOOOOOOOOXXOOOOOOOOOOXXOXOOOOOOXOXOOOOOXXOOOOOXXOOXOXOOOXOXOOO
OXXOOOOOXOXXOXXOXOXOOOOOOXXOOXOOOXOOOOOXOXOOOXOXOOOOXOXXOOOOXOOOOOOOOOOOXOXXXXOOOXOXXOOXOOOOXOOOOOOXX
OOOOOXOOOOOXOOOOOOOXOXOXOOOOXOXOOOXOXOOOOOXOOOOOXOOOOOOOOOOOOXOOXOOOOOOXOOOOOXOOXOOOXOOOXOXOXOXOOOOOX
OOOXOOXOOXXOXXOOOOXOOOOOOXOOOOOXOXXOOOXOOXXXOOXOOOXOOOOOOXOOOOOOOXOOOXXXOXOXXOOXOOOOOOXOOXOOOOXOOOOXO
OOOOXXOOOXOXOOOOOXXOOOXOOOOXXXXXOOOOXOOOOOOOOXOXOOOXXXXXOOOOOOOXOOXOOXOOOOXOOXOOXOOOXOOOXXOXOOOXOOOOO
XOOOOXOOXXXXOXOOXXOOOOOOOXXXOOOOOOOOOOOOOXOOOXOXOOOOOXOOOXXXOOOOOOOXXOOOOXXOOXOXOXXOOXOOOOOXOXOOOOOOO
OOXOOOXOOOOXOXOOXOOXOOOOXOOOOOOOOXOXOOOXOXOOOOOOOOOXOOXXXOOOOOXOXXOOOOXXOOOOOOOOXOOOOOOXOXOXOXOOXOOXO
XXOOOOOXXXOOOOOOOOOOXOOOOXOOOOOOXOXXXOOOOXOOOOXOOXXOOOOOOOOXOOOOOXXOOXOXXOXOOOOXXXOOXOOXOOOOXOOOOXOXO
OOOXOOOOOOXOOXXOOXXXXOOXOOXOXOOXOOOOOOOOOOXOOOOOXXOOOOOOOOOOXXOXOOOOOOOOOXOOXOOOOXXOOXXOOXOOOOOOXOOXX
XOOOOOOOOOOOOOXOOXOOOOOOXOOOXOXOOXOOXXOOXXOOOXOOXXOOOOXOOOOXOOOOXXOOOOOOOOOOOOOXOXOXOOOOOXOOXOOOOXOOO
XOOOOOXOXXOOOOOXOOXOXOOOOOXOOOXOOXXOXOXXOXOOOOOOXOOXOOXOXXOOOOOOXOOOXXOXOOXOOOXOOOOOXOOOOXOOXXOOXXOOX
OXOXOOOOOOOOOOOOOOOOOOOOOOOOOOXOOOXOOOOOXXXOXOXXOXXOOOOOXXOXOXOXOOOXOXXXOXOOOOXXOOOOOXXOXXOOOOOOOOOOX
OOOOOOXOXOXOXOOXOXXOXOOOOOOOOOXXOXXOXOOXOOXOOOOXOOOXOOOXOOOXOOOXXOOOXOOOOOOOOOXOXOOOXOOOOOOOOOOXOOXOX
OOOOXXOOOOXOOOXOOOOOOOOOXOXOOXOOOOOOXOXXXOXXXOXOXOOOOOOOOOXXOXXOXXOOOXOXOXOOOOOOOOOOOOOOOXOXXXXOOOOOX
OOOOOXXOOOOOOOOOOOXXOXOOXOXXOOOXXXOOOOOOOOOXXXXXOOOOXXXOXXXXOOOOOOOXOOOOOOXXOOOOXXXOOOOOXOOXOOOXOXOOO
OXXOOOXOOOXOXOXOOXOOXOXOOOOXXOOOOOXOOXOOOXOXOOOOXOOOOOXXXXXXOOOXOOOXXOXOOOOOOXOOOOXOXOOOOOXOOOOXOOOOO
XOXXOXXXOOXOXOOOOOXOOOOXOOOOOXXXOOOOOOOOXOOXXXOOXOOXOOOXOOOOOXOOOOOOOOOOXOOXOXOOOOOOOXOOOXXXXXOOOXOOO
XOXOOOOXOOOXOOOOXOOXOOXOXOOOXXXOOOXOOOXOOOOOOXOOOOXXOXOOOOOOOOXOOOXXOXXOXOOXOXXOOOXOXOOOOOXOOXOOOOXOO
OOXOXOOOOOOXOXOOOXOOOXOXOOXOXOOXOOOXOOOOOXOOOOOXOOOOXOOXOOOOXOOOXOOXOOOOXOOOXXOOOOXOOOXOXOXOOOXOOOOOO
OOOOOOOOOOOXOOOOOOOOXXXOOOOOXOOOOOXOOXXOOOOOOOXXOXOOXOOOOOOOXXOXXOXOXOOOOOXXOOOOOXXXOOOOOXXOOOOOXOOOO
OXOXOOXXXOOOXOOOOOOXOXOOXOOOOOXOOXXOXXOXOXOXXOOOXXOOOOOXOOOOOXXXOXOOOOOOXOOOOXOOOXOXXOOOOXXOOXXOOXOXX
XOOOXOOOXOOXXOOOOOOOOOOXOXXOXOOOOXXOXOXOOOXOOOOXXXOOXOXXXXOOOOOOXOOOOXOOXOOXXOOOOOOXOXOXOXOXXOXOOOOOO
XXXOXOOOXOXOXOOOOOXOOXXXOOOXOOOXXOOXOOOOXOOOXOOOOOXOOOOOOOOXOOOOXOXOXOXOOOOXXOOOOOXXOOXOXXOXOOOOXOOOX
OXOOOOXXOOOOOOOOOXOOOOXOOOXOOOXOOOXOOOOOOOXOXOOOOOXXOOOOOXOOOOOOOXXOOOXXOXOOOOXXOXXOOOOOOOOOOXOXXXOXO
OOOXOOOOOXXXOXOOOOOOXXOXOOXXOXXOOXOOOXOXOXOOXOXOOOOXOXOOOOOOOXOOOOOOOOXOOOOXXOOXOOXXOXXXOOOOOOXXXOOXO
OOOXOOOXOXOXOXOOXXOOXOOOXOXOOXOOXOOOXXOOOXXOOOXXXOXOOOOOXOXOXXOOOXOOOXXOXXOXOOOXOOXXOOOOOOOOOOOOOOOOO
OOOOOXOOOOXXOOXOOXOOOOXOOOXOOXXXOXOOOOXOXXXOOXOOOOOOXXXOOOOXOOOOXXOOOOOXOOOOXXXOXXXOXOOXOOOXOOOXOOOXO
OOXOOXOOOOOXOOOOOOOOXOOOOXOOOOOOOOOXXOOXOOOOOOOXXXOOOOOOOOOOOOOOOOXOXOXOXOOOXOOOOOOOXOXOOOOOOOXOOXXOO
XOXOOOXXOXOOXOOOOOOOOXOOXOXOOOOOXOOXOOOXOOOOOXXOXXXXOOXOOXXXOXOOOOOXXOOOOXXXOOOOOXOXOXXXOOOOXOXXOOOOO
OOOOXOOOXOXOXOOOXOOOOOOXOOXOOOOOOXOXOXOXOXOXXOOXOOOXXOOOOXOOOXXXOOOOOOOXOOXOXXOXOOOXOOXOXOOOOXOOXXXXX
OOOXXXOXOOOOOXOOOOXOXOXXOXOOOOXOXXXOOOXXXOOOOOOOXXXXOOOOXXOOOXXOOOOOOOXXOOOOOOOOOOOOOXOXOOXXOOXOOXXXO
OOOOXOOOOOXXXOOOXXXOOXOOOXOOOOOXOOOOXOXOXXXXOOOOOOOXOOOOOOOOOOOXOOOXOXOOOOOOOOXXXOOOOOXXXOOOOXOXOXOOO
XOOOXOXOXOOXOOOXOOXOOXXOOOXOOOOOXOOXXXOOOOOOXXXXOXOOOOOXOOOOOOOOOOOOOOOOOOOOOOOOOXXXOXXXOXOOXOXOOOOXO
OXXOOOXOXOOXOOOOOOOOOOOOOOOXOOOOOOOXXOOXOOOOOOOXXXOXOOOXOOOXOXOXOXOOOOXXXOOOXXOOOOOOOOOXOOOOOOXXOXOXO
OOOOOOXOOOOXOOXOOOOOOOOOXXOOXOOOOOOOXOXXOOXXOXOOOOOOXXXOOOOXOXOOOXXXOOOOXOXOOOOXXOOOOXXXOOOOOOOXOOOOO
OXOOOXXOOXOOOOOOOXXOOOOOXXXOOOOXOOOXOXOOXOOXOXXOOOOXOOOOOOOXOOOOXOOXOOOOOXXOOOOOOXOOOOOOOOOXXXOOOOOXO
OOOXOXOOOXOOOOOOOOOOOXXOXOOXXOOOOXXOOXOOOOXOOOOOXOOOOXXXXOXOXXOXXOOOXOOOOOOXOXOOXOOOOOOOOOOOXOOXOOXOO
XXXXXXOOOOOOXXXXOOOXOOOXOXXOOOOXXOOOOOOOXOOOOOXXOXOOXOXOXXXOXXOOXXOXOXXOOXOOXOXOXOXOOOXOOOXOOXOXOOXOO
OXOOOOOOXXOOOOOOOOOXOOOXOOOOXOXXXOXOOOXOOXOXOOOOXOXXXXOOOXXOOXXOXOOOXXOOOOOOOXOOOOOXOOOXXOXOOOOOOXOOO
OOOOXXOXXXXOOXOXOXOOOOOOXOOOXOOOOXOXOXOOOOOOOOOOOOOOXOOOOOXXXOOXXOOXOOXOXOXOXOXOOXOXOOOOOXXOOXOXXOOXO
OOXOXOOOOOOOOOOXOXXOOXOOOOOOXOXOOXOOXOOOXOOXOOXOXOXXXXOOXXOOOOOOXOOOOXOOXXOOOXXXOOOOXOOOOOOXXXOOXOOXO
OXOXXOXOXXXOOXOOXOXOXOOXOOXOOOOXOOOOOOOOOOXOOOOXXOOOOXXXXOOOOOXXXOOOXXOOOXOOOXOXOXXOOXOOXOXOOOXOOXXOO
OOOXOOOXXOOOXXOXOXXOOOOOOOOOOOOXOOXOOXOOOXOOOOXOOOOOOOOXXOXOOOXOOOOOOOOXOOXXOOOOOOOXOOOOOOOXOOOOOOXOO
OOXOXOXOOOXOOXOOOOXOOXXOOXXXOOXOXOOOOXXXOXOOOOOXXXOXOXXOXOXOOOOXOOOOXOOXOOOOOOOOXOOOOXOOOOOOOXOXXOOXX
XXXOXOXOOXOXOOOOOOXOOOXOOOOOOXOOOXOOOOOOXXOOOOOOXOOOOOOXOOXOXXXOOOOOOXOOOOXOXXOOOOXOOXXOOOXXXOOOXXOOX
OXOOXOOOOOOOOOXOOOXOOOOXXOOOOOOOOOXXXOOOOXXXOOOXOOOOXOOXOOOOOOOOOOOXXOOOOOXOXOOOOXOOOOXXOOOOOXXXOOOXO
XOXOXXXOOOOOOXOOOOOOOXOXOXOXXOOXXOOXOXOOXOXXOXXOOOXOOXXOOOOXXOOOOXXOOOOXXXOOOOOOXXXOOXXOOOXOOOOOOXOOX
OOXOXOXOXOOOOOOXOXXOOOOOOOOOOXOXOXOXOXOOOOXXOOOXXOOOXOXXOOXOOXOXXOOOXXXOOOOOOXOOOOXOOXOOOOOXXOOOOOXOX
OXXOOXOXOOOXOOOOOXOOXOOOOOOXXOOOXXXOOOOOOOOXOXOOXOXOXXOXOOXOOOOOXOXXOXXXOXOOXOOOOOOOOOOXOOOOOOOOXOOXX
XOOOOXOOXOOOOOOOOOOOOOOOOOOOXXXXOOXOOOOXOOXOOXOXOXOOOOXOOOOXXOOOOOXXOXXOOOOOOOXOXXXOOXOOOOXOOOOOOXOXO
OOOOOOOOOOOXOOOOOOOXOOOOOOXOXOOOOOXOXOOOOOXOXOOOOXXOOOOOXOOOXXXOXXOOOOOXOOOOOOXOOXOOXOOXOOOOOOOXOXOOO
OOOOOOXOOXOOOOOOOXOOXOXOXOOOOOXOOOOXOXOOOOOOOOXOOXOOOXOOOXOOOOOOOOOOOXXOXOOXOOXXOOOOXXOOOOOOOXOOOOXXO
XOOOOXOXXOOOXOXOXOXOXOOXOOOOOOOOOOOOXOXOOOOOOOOOOOOOOOOOXOOXOOOOOXOOXOOOXOOXOOOOOOOXOXOOOXOXOXOOOOXXO
OOXOXOOXOOOXOOXOOOXOXOOOXXXXXOOOXXXOOXOXOXOOOOOOOXOOXOOOOOXOXOOOOOOOOOOOOOOOXXXOXOOOXOOOXOOOOOXOXXXOX
OOXOOXOOOOOOOOOXXOOOOOOOOOOXXOOOXXOOOOOOOOXOOXXOXOOXOOOOOOOXOOOXOOOOXXOOXOOXOOOOOOOOXXOXXXOOOOXOOXOXX
OOOOOXOOOXOOXOXOOXOOOOOXOOOOOXOXXXXOOOOXOXOXXXOOOXOXXOOOXOXOXOOOOXOOOXOOXXOOOOOXXOOOOOXOOOOOOOOOXXOXO
OOOXOOOXOOOXOXOXOOOOOOOOOOXOOOOOOOXOXOXOOOOOOOXOOOXOOXXXOOOOOXXOXXOOOOXOOOOOXXOXOXXOXOOXOXOOXOOOOXOOO
OXOOOOOOOOOOXOOOXOXOOXOOOOOXXOOXOOXOOOOXOOOOOOOOOOXOXOXXOXOOXOOOOOOOOXOXOOXOOOXOOOOOOOXOXOOOXXOXXOOOO
OOXXOXOOXOXOOXXXOOOXOXOOXOOOOOOXOOOOOOOOOOXOXXXOOOOOOOOOOOOOOOOOOOOXOXXXOXOXOOXOOXOOOXOXXOXOOXXOXXOOO
