OOOOXOXXOOOOXOOOXOOOXOXOOOOOOOOOXXOXOXXOOOOOXOOOXOXOXXOXOOOOXOOOOXOOOXOOOOOOOOOXOOOOOOXOOXOOOOOOXXXOO
OOOXXOOOOOXOOOOOOOOOOOOXXOOOOOOOOOXXOOOXOOOOXOXOOXOXXOOOOOOOOXOOOOOOXXOOOXXOXOOXXOXOOOXOXXOOXOOOOOOXO
XOXOXOXOOXOOOOXOXOOOXOOOOXOOOOXOXOOOXOXOOXOOOOXXXOOOOOOOOOOOOOOOXXXOOXOOXOOOXXOOOOXOOOOOOOOOXOOXXXXOO
XOOOOOOOOOXXXXXOXOOXOOOOOOOOXOOOOOOOOOXXOXOXXOXOOXXOOXOOXOOOOOXXXXOXOOOOOOXOXXXXXOOOOOOOOXXOOOOOOOXOO
OOOOXOXXOXXOOOOOXOOOXXOOXOOOOOXOOXOXOOOOOOOOXOXXXOOOOOXOOOOOXOOOXOOXXOOXXXOOOOOXOOOOOOXOOXXOOXXOOOOOO
XXOOOOXOXOOOOXOOXOOOOOOOXOXOOOOOOOXOXXOOOOOOXOOOXOOOOOOOXOOOOOOXOXXXOOOOOXOOOXXOXXXOOOOOOXXXXOOOOOOXO
OXOXOOXXOXOOOOOOOOXOOXOXOOOOOXOXOOOOOOOOOOOXXXOOXXOOOOXOXXOXOOXOOOOXOOXOXOOOXOXOOXOOOOOOOXOOXOOXOOXOX
OOXOOOOOOOOXXOXXOOOOOOOOOOOOOXOXOOOXOOXOOOXOOXXOXOOOXOXOXOXXOOOOOXXXOXOOOOXOOOOXXXOOOOOOOOXXOOXOXXOOO
OOXOOXOXOXOOOOOOOOOOXOXOOOOOOOOOOOOXXOXOOOOOOOOOOOOOOXOOOXOOOOOOOOOXOOXOXOOOXOOOXOOOOXOXOOOOXXOXOXXOO
OOOOOOOOOOXOOOOXOXOOOOOOOOOOOXOOOXXOXXXOOXXXXOOOOOXOOOXOOOOXOXOOOXOOOOOOOXXOOXOOOOXXOOXOOOOOOXOOOXOOO
OOOOOOOOOXXOOOOOXOOOOOOOXOXOOXOXXOOXXOOOOOOXOOXOOXOOOXOXXOXOOXOOOXOOOOXXOOOOOOXOOXOXOOOOOOXXXOOOOOOOX
OXOXOOOOXXOOOOOOXOOOOXOOOOOOXOOXXXOOXOXXOOOOOOXOXOOOOXOXOOXXOOXOOOXOOXOOXXOOOOXOOOOOOOOXOXOXOXXOXOOOO
OOOXOOXOOOOOXOOOXOOOOOOOOXOXXOXOOOXXOOOOOOOXOOOOOOOXOOOXXXXOOOOOOOXOOOXOOXOOXOOXXOXOOOOOXOOOOXOOOOXOO
OXOOOOOXOOOOOOXXOOOOOOXOOOOOOOXOOOOOOOOXOXOOXOOXOXXOXXXOXOOXOOXOOOOOOOOXOXOXXOOOXOOXOXOXOOXOXOOOOOOXO
OOOOOOOOXOXXXXOOOXXOOOOOXOOOOOOOOOOOOOXXOOOOOOOOOOXOOOOOXOOOXOOXXOXOOXOOOXOXOXOOXOOOOOXXOOOOXXOOOOOOO
OXOXOOOOOXOXOXOXOOOOOXOOOOOOOOOOXOOXOXOOXOOOOOOXOOXOOXOXXXOOXOOXOOOXXOXOOOOOOXXOOOXOOOOOOXOOXOOXOXOOO
OOOXOOXXXXOOXOXOOXXXOXOOOOOXXOXXOOOXOOXOOXOOXXOOOOOOOOOOOOOXOXXXOOOOOOOOXOOOOOOOOOOXXOXOXOOOOOXXOOOOX
XOOOXOXOXOXOOXOOOOOOOOXXOOOXXOOOXXXOOXOOOOOOOOOXXOOOOXOOXXOOOOOOOXOOOOOOXOOOOXXXXOOOOOOOOOXOOOOOOOOXX
OOXOOOOOXOOOXXOOOXOXOOXXOXOOOXXXOOOOOOOOOOOOOXXOOOOOOOXXOOXOXOOXOXOOXOOOOOOXOOXOXXXOOOOOOXOXOXXXOOOXO
OOOOOOOOXOOOOOOXXOXOXXOOXOOOOOOOOOOOOXXXXXXOOXOXOXXXOXOOXOXOOOXOOOXXXXOOXOOXOOOOXXOOOXXOXOOOXOOOOXOOO
OOXOOOXXOOOOOOOXXOOOOOOOXOOOOOXXXOOOOOOOXOXOOOOXOOXOOOOXOXOXOOOOXOOOOXOOOOOXOXOOOOOOOXOOOOOOXOOOXOOXX
OOXXOXXOOOOOXXXXXOOXOOXOOXOXXXOOXOOOXOOXOOOOOXOXOOXXOOOOXOOOOOOOXOXXOOXOOOOOOXOXOOXOOOOOXOOXOXXXOOOOX
OOXOOXXOOXOOOOOXOOOOOOOXXOXOOOOOOOOOOXOOOXOOXOOXXOXOOOOXXXOXXOXXXOOOOOOXOOOOOOOOXXXOOXXXOOOOOXOOOOOXO
OOXOOXXOOXXXOOXXOOOOXXOOXOOXOOOOXOOOOXOXOOOOOOOXOOOXXOOXOOOXOOOOOOXOOOOOXOOXOOXOOOOOXXOOOOOOOOXOOOOOO
XOOOOXOXOOXOXOXOOOOXOOOXOXOXOOOOOOOOOXOOOOOOXOXXOOXXOOXOOOXXXOOOXOOXOOXOOXOOXOOOXXXXXOXXOOOOOOOXXOOOO
XOXOXOOOOXOOOOOOXOOOXXOOXXOXOOXOXXOXOOOOOXXXOXOOOOOXXXOXOOOOOXXXOOOOOOXOOOOOOOXXXXOOXOOOOXOXXOOOOOXOO
XXXOOOOOOOOXOOXOOOXOXOOOOOOOXXOXOOOOOOOOOOXOXXOOOOOXOXXXOOOXXOXOOXXOXOOOOXOXOOOOXOXXXOOOOXXOOXOOOOOXX
XOXOXXXXXXOOXOXOOXOOOOOXOOOXOOOOOOXOOOOOOOXOOOOXXOOOXOOOOOOXOOXOOXOXOOOXOOXOOOOXOOOOOOOXXOXXOXXOXOOOO
XXOOOOOOOXOOOOXXOOOOOOXXOOOOXXOOOXXOOOOXOOXOOXOOXOOOOOXOOOOOXOXOOOOXOOXXXOXOOOOOOOXOXOXOXXOXXXOXOXOOX
OOOOOOXOOOOOXOOOOOOXOOOOXOOXXOOOOXOXOOOOXXXXOOOXOOOOXOXOOOOOXOXOOXOOOXOOOXOXXOOXXOXOOOOOOOOXOOXXXOOOX
XXOXXOXOOOXOOOXXOOXXOOOOOXOOOXXOOOOOOOOOOXOXXXOXOXXOOOXOXXXOXOXXXXOXXOOOOXOXOOOOOXOOOXOOOOOOXOOOXXOXO
OOOOXXXOOXXOOOXOOOOXOXOOOOOOXOOXXOOOXOOXXOOXOXOXXOXXOOOOOOXXXOOOOXOXXOXOOOOOXOOOOXOOOXXXOXXXOXOOOOOOO
OOOOOOXOOOOXOXOOXOOOOOOOOOOOOXOOOOOOOOOOXOXOOOOOXOXOOOOOXOOOOOXOXOOOOOXOOXXOOXOXOOOOOOOOXOOXXXOOOXXXO
OOOXXOOOXOXXOOOOOOOOOOXXOOXXOOXXOOXXOXOXOXOOXXXOOXOOOOOOOOOOOOOOOXOOOOOXOXOOOOXOOOOOOOOOOXOOOOOOOOXOX
XXOXXOXOOXXOXOOXOOOXOOXOOXOXXOXOOXXOOOOOXOOOXOOOOOOOOOOXXOXOOOXOOXOOOXOXOOOOOOOXOOXOXXXOOOOXOOOOOOOOX
XOXOXOOOOOOOOOOXOXXOOOOXOOOOXOOXOOXOOXOOXOOXOXOXOOOOXOOOOOOXOOXOOOOXOOOOOOXOXOOOOOXOXOOXOXXOXOXOXOOXO
OXOXOOOOXOXOXOXOXOOXOXXOOOOOOOOOOXOXOOXOOXOOOXOOOOOOXXOXOOOOOOOOXOOOXXOOOOOXXXOOOXOOOOOOOOOOXOOXOOOOX
OXOOOXOXXOOXXOOOXOOOOXXOOOOXOOOOOOOXOXXXXOOOOOOXXOOOOXOOOOOXOOOOXXOXOXOOOOXOOOOOOOXOOXXOXOOXXXOOOOOOX
OOOXOXXOOXOXXXXOOOOXOXXXOOXOOOOOOOOOOOOOXXXOXOOXXOOOOXOOXOOOOXOOOOXOOOOOXXOOXOOOOOXXOOOOXOOOOXOOOOOOO
XOOOOOOOOOOOOOOOOXOXXOXOOOOOXXOXOOOOOOOOOOOOXOOOOOXOOOOOOOOOXOOOOOXOXXXOOXOOOOOOOOOOXOXXOXOXXOXXOOXOX
OXOOOOOOOXOOOOXOXXXOOOOOXOOOOXOOOOOOOOXXOOOOXOOOOOOOOOOXOOOOXXXOOOOOOOOXOOOOOOXOOOXOXOXXOOOOOOXOXOOOO
OXXXXXOOOXOOOOOOOXXXOOOOOOOXXOOOOOOXOOOOOOOOOOOXOOOOXOXOOOXOOOOOXXXOOOXXXOOOOXXXXXXXOXOOXOOXOOOXOXXOO
OOXXOOXOXXXXXXXOXOXOOOOOOOOOOXOXOXOOOXXOXOOXXXOOOOOOXOOXOOOOOOOOOOOOOOOOXOOOOXOOOOOXOXOOXOXXXOOOOOOXO
OOOXOXOOOOOOXOXOXXXOOXOOOOOOOOOOXOOXOXOOOOOOXXOOOOOXOXXOOXOXXXOXOOOOOXXOXOOXOOOOXXOOOXOOXOXOOOOOOOOOO
OOOOXXXXOOOOOOOOOOOOOXXOOXOXOOOXXOOXXOOOOXOOOOOOOOOOXXOXOOOOOOOOOOOXOOXOOOOOOXOOOOOOOOXXXOOXOOXXOOOOO
XXOOOOOOOXOXOOOXXOOXOXOOOOOOOOOOXOXXOOOXOOOOXOOOOOOOOOXOXOXOOOOOOOXXOXOXOOOXOOXOOOOXOXOOOXOXOOOOXOOOO
OOOOXXOOOOOOOXOXOOOOXOOOOOXOOOOOOOOXOOOXOXOOOOXOOOXOOOOOOOOXOOOOOOOOOXOXOXOXXXXOOOOOXOXXOOXOOOOOXOXXO
XOOOXOOOOXXOOXOXXOXOOXOOOXXOOOXOOOXOXOOOXOOXXOOOOOOOOXXXOOOOOOOOXOOOOOOOOOXXOXOOOOOOOXXOOOOOOOXXOXOOO
XXOOOXOOOOOXOOOOOOOXXXOOOOOOOOOXOOOOOOOOOOOOOOOOOOOOOOXOOOXXOOOOOOOOOOOOOOOOOXOOOOXOOXOOXOXOXXOOXOOXO
XXOOOXOOOOXOOOOOXOOXOXXOXOOXXXOOOOOOOOXXOXXOXOOOOXOXOOOOXOOOOOOOOOOOXXOOOXOXOOOOOOOXOXOXXOXOXOXOOXXXX
XOOOOOOOXOOOOOOOOOOXOOXOXOOOXOXOOOXOOXOOOOXOOOOOOXOOOXOOXOOXXXOXOOXXOOOOOOXOOXXOXOOOOOOXXXXOOOOOOXOOO
OXOOXOOXXXOOXOOOOOOOOOOOOOOXXOOOXXOXOOOXXXXOOOOXOOOXXOOOOOOOXOXOOOOOOOOOOOOOOOOXOXOXXOXOOXXOXXOOOOOOO
OOOOOOOOOXXOOOOOXOXXOXXOOXOXOOXOXOOOOOOXOOOOOOOOXOXOOOXXOOXOOXOXOOXOXOOXXXOOOXXXXXXOOOXXXOXOOOOOXOOOO
XXOOXXOXXOOXOOOOOOXOOOOXOOOOOOXOOXXOOOOOXOOOXOOOOXOOXOOXOOOOOOOXXXXXOOOXOXOXXOXOOOXOOOXXOOOOXOOXXOOOO
OOXOXOOOOOOXOOOOOOOOOOOOOOOXOXOOOOXOXOOOOXOXOOXOOOXOOOXOOOOOOOXOOOXOOOOOXOOXOOOOXOOOOOOXOXOOOOOOOOXOX
XOXXOOOOOXOXOOOOOOOXOOOOOOXXOOXOOOOXOOOXOOOXOOXXXOOOXXOOOOOXXOOXOOXXOOOOXOOOOOXOOOOXXXOOOXOXXOOOOOOOO
OOOOOOOXXOOXXOOOOXOOOOOXOOOOOXOOOXOXOOOOOOOOXOOOOOXOOOOOOOOOOOOOXOOXOOOOOOOOOXOOOXOXOOOXOOOOOXOOOOOOO
OXOXOOOOOXOXOOOOXOOOXXOOXOOOOXXXOOOXOXOOOOOXOOXOXOXOOXOXXXXXOXOOXXOXOOOXOOOOOXOOOXOOOOOOOXXXXXOOXOOXO
OOOXOOOOOOXOOOOXXOOOOXXXOOXOOOOOXOOXOXOOOOOXOOOOOXXXXOOOOXOXOOOXOOXXXOXOOOOOXOOOOOXOXOXOOXOXOOOOOOOOO
OOXOOOXOXXOXOOOXXOOOOOXXOOOOXOXXOOOXXOOXXOOOOOOOOXOOOOOOOXOOOOOOXOXXOXOOXOOOXOOXOOOXOOXOXXOOXXXXOOOOO
XOOOXOOXXOOOOXOOOOOOOXOOXOOOOOOOXOXXOOXXOXOOXOOXXOXOOOOOXXOOOOXOOOOOOOOOXXOOXOOOOOOOXXOOOXOOOXXOOOOOO
XXOOOOOOOOOOOOOXOOOXOOOXXOXXXXXOOXOXOOOXXXXOOXOOOOOOOOOOOOOOXOOOOXOOOOOXXOXXOXXXOOOXXOOOXXOOOOXOOXXOO
OXXOOOXXOOOXOOOOOOOOOOXOXXOOXXXXOOXXOOOXXXOOOXOOOOOXOOOXOXXXOOOOOXOOOXXXOOXOOOXOOXOXOOOOOOXXOOOXOXOXO
OXOXOOOOOOOOXOXOOXXXOOOXOOXXXOOXXOOOXOOXOOOOOXOOOXXOXXXOOOOOOOOOOXXOOXOOXXOOXOOOXXXXOOXOOOOXOOOOOOOOO
OOOOOOOOOOOOOOOOOOOOOOOOOOOXXOOXOXXXOOOXOXXXOOOXOOXOOOOXXOOOXOOXOXXOOOOOXOOOOXOXOOOOOOOOXOXOOXOXXOOOX
XOXOOXOXOXOOOOXOXOOOOXOOOOOOXOOXXXOOOXXOOXOXXXOOOOOXOXOOXOOXOOOOOOXOXXOXOOOXOOOOOOOOOXOOXOOXOXOOOOOOX
OOOOOOXOOXOOOOOXOOOOOXOXOOXXOOXXOOOXOOOOOOOOOOOOOOOOOOOOOOOXOXOOOXOXOOXOOOOOOXOOOOOOXXOXOOXXXOOXXOXOO
OOXOXOOOXOOOOOOOXXOOOOOXXXOOXOXOOOOOXXOOOXOOOOXOXOXOXOXOXOOOOOXOOOOOOXOXOXXOOOOOOXOXOOOOOOXOXXOOXOOOX
OOOOXOOOXOXOOOXOOOOOOOXOOOOXXOOOXOOOOOOXOOOOOOOOOOOOOXXOOXXOOXOOOOXXXOOXOXOOOOXOOOXOXOOOXOOOOOXOOXOOO
OOOOXOOOOOXXXXOOOXOOXXOOOOOOOOXOOXXOXOOOOOOOXXOOOOOOXOXXOXOOOXOXOOOOXOOXXOXOOXOOOOOXXOXXOOXOOOOOOOOOO
XXXOXOOOOOOOXOOOOOOXXXOXOOOOOOOXOOOOXOXOXOOOOOOOOOOXXOXXOOOOOOXOOXOOXOOOXOXOOXXOOOXOXOXOOXOXOOOXOOOXO
OOXOOOOOOXOOOOXXOXOXXOOOXOXOOOOOXOOOXOOOOXOXOXXOOOOXOOOOXOOOXXOOOOOXXXXOOOOOOXOOXOOOOOOOXOOOXXOOXOOOO
OOXOOOOXOXOXOOOOOOOOOOOXOXOOOOOOOXXOOXXOOOOOOOOOOOOOOXOOOOOOOOOOOXXOOOOXOXOOOXXOOOOOXOOOOOXOOOOOOOOXO
OOOOOXXOOXXOXOOOOOOOOOXOOOOOOOXOOOXXOOXOOOXXOOXOXOOXOOOOOOOOOOOOOOXOXOOOOXOXOOOXXXOOXOOOOXOOOXOXOOOXX
OXOOOOOXOOOOXOXOOOOOOOOOXOXXXOOXOXXOXOOXOOXOXOOXOXOOOXOOXOOOXOOOOOOOXXOOOOXXOOXXXOOXOOOOOXOOOOOXOOOOX
OOXOOOOOOOXOOOOOOOXOOXOOOXOOOOXOOXOOOOOOOOOOXXOXOXOOOOOXXOXOOOXXOOOXOXXOOOOOXXOOXOXOXOXOOOOOOOOOOXXOX
OXOXOOXOOOXOOOOOOXOOOOOXOOXOOOOXXOOOOOXOOOXOOXXXXOOOOOXXOOOXOOOOOXOXOOXOOXOOOOXOOXOOOOXOXXOOOOOOOOOOO
OOOXOXXOXOOOXXOXOXOOOXOOXOXOOXXXOOOOOXOXXOOOOXOOOOOOOOOOOXOOOOOOOOOOXOOOOOOXXOOOOOOOOOOXOXOOOOOOOOOXO
XOXOOOOXXOOXOXOOOXOOXOOOXOXXXOOOOXXOOXOOXXOXOOXOOOOOOXOXOXOXOXXOXOXOOXOOOXXOOOOOOOOOXXOOOOOOXXOOOXOOO
OXOXOXOOXXXXXOOOOOOXXOOOOXOOOOXXXOXOOOXOOXXOOOOOOOXXXOOOOXXXOOXOOOOOOOOXOXOOXOOOOOXOXXOOOOOOOXOXOOOOO
OOOOOXOOOOXXXXOOXXOOOOOXOXOXOOXXXOXOXOXOOOXOXOOOXXOOOOOXXOOOOOOXOOOOOOXOXOOOOOOOOXXOOOOOOXXXXXOOOOOOO
XOOXXOOOOXOOXOOOOOXOOOOOXOOOOOOOXOOXOOOOOOOXOXOOOOOXOOXOOXOXOXXXXXOXOXOOOOOOOXXOOOOXOXXOOOOXOXOOXOOOO
OOOXOXOOOOXOXOOXOOOOOOOOOOXXXOOOOXOOOOOOOOOOOOOOOXOOOOOOXXXXXOOOOOOOOOOOOOOOOXOOOXOOOOOOOXOOOOXXXOOXX
XOOOOOOOOXXOOXOXOXXOOXOOOOOXOOOXXXXOOXXOOOXOOOXXOXOOOXOOOXOOOOXOOOOOXOOXXXOOXOXXXOOOXOOOOOOOOOXXOOOOO
OOXXOOXOXOOXXOXOOOOXOOOXOXOXXOXXXXXXOOXXXXOOOOOOOOOOOOOOOXXOOXOOOXOOXXOOOOOXOOOOOOOOOXOXOOOOXOXOXOXOO
OOXOOOXXOOXOOOOXOOOOOOXXOOOOOOOOOXOOXOXXOXOOOOOOOXOOXOOOOOOOXOOXOXXOOXXOOOOOOOOOOOXOOOOXOOOXXOOOOXOOO
XOXXXXOXOOOOOXOOXOXOOOOXOOXXXOOOOOXXXXXOOOOOXOXXOOXXOOOXOXOOOOOOOXOOXOXOXOOOOOOOXXXOOXOOOXOOOOXOXOOOX
OXXXOOOOOOOOOOOOOOOOOOOXOXOXOOOOOXOXOOOOOOXOOOXXXOOXXOXOXOOXOOOXXXOOOOOXOOOOOOXOOOXXOOOOOXOOOOOOOOOOO
OXOXXOOXXOOOOXXOOOXOOXOXOOOOOOXOOXOXXOOXOXOOOOOOOOOXOOOOOOOOXOOOOXOOOXOOOOOXOXOOOXXOOXOOOOOXOXOOOOOOO
OOXOOOOOOOOOXOOOOOOOXOXXOOXXOOOOOOOOXXOOOOOOOOXOOOXXXOOOXXOXOOXOOXOXOOXOXOXOOOOOOXXOOOXXOOXOOOOOOOOOX
OOOOXXOOOXXXOOOOOXOOXOOXXOOOOOOOXOOOOOXOXXOOXOOOOOOOOOOXOXOXXOXOOXOOOOXOXOXXOOOOOOXXXXXOXXXXOXXOOXOOX
OXXXXOOOOOOOOOXOOOOOXXXXXOOOXXOOXOXOOOOXOOOOXOOOOOXXOOOOOOOOOOXXOXOOXXOXOXOOOOXXOOOOOXOOXOOXOOOOOXOOO
OXXXXOOOOOOOOOXOXXXXXOOOXOOOOXOOXXOOOOOOOXOXXOOOOOOOXOOXOOXXOOOOOXOXXOOOOOOOOOXOXOOXXOOOOOOOXXOOXOOOO
XOOOXOOXOOOXOOXXOXOOOOXOOOOOXOXOOOOOOXXOOOOXXXOOXOOOXOXOOXXOOXOXOOOOXXOXOXOOXOOOOOOOOOOOXXOOXOOOOXXOO
OOOOOOOOOXOOOOOXOOXXOOOXOOOXXOOXOOOOXOOXOOOOOOXOOOOOOOOOOOXOOOOOOXOOXOOOOXOXXOOOXOXOXXXOOOOXOOXOOOOOO
XOOOXOOOOXOOOXOOOOOOOXOOOOXXOOOXXOOXXOOXXOOXOOOOOOOOOOXOXOOOOXOXOOOOOXOOOOXOXXXOOOOOOOXOOOOOXOXOXXOXO
OXOOXOOXOOXXOOOXOOXOOOXOOOOXOOOOXOXXOOOOOXOOXOXOOOXXOOXOOOOOXOXXOOOOOXOOOXOOXOXOXXOXOXOOOXOOOXOOXOOOX
XOOXOOOOXOOOXOXXOXOOXOOXXOOOXOOXOXOOXOOOOXXXXOOXOOOOXOOOOOOOXOOOOXOOOXOOOOOOOXOOOOOOOOOOOOOXOOOOOOOOO
OOXOXOXXXOXOOOXOOXXOOXXXOXXOOOOOOOOXOOOOOOOOXXOOXOOXOXOOOOOOOOXXOOXOOOOXXXOOOXOOOOOOXOOOOOOOXOOXOOOXX
OOOXOXXXOOXOOOOOOXOOXOOXOOOXOOOOXXXOXOOOXXXOXOOOOOOOXOOOOXOXOOOXOOOOOOOOXOOOXOOXXOOOXXOOXOOOXOOOXXOOO
OOXOXXXOXXXXOOOXOOXXOOOOOOOOXOOXOXOXOOXOOOOOXOOXOOOOOXOOOXOXXXXOOOOOOXOOOOOOXXOOOOOOOXXXXXOOOXOOOOOOO
