OOOOOOOXOXOOOOOOOOOOOOOXOOOOXXOOOOOOOOOXOXOOXOXXXOOOOOOXOOOOOOOOOOXXOOOXOOOXOOOOOOOXXOOOOXOOOXXOOOOOX
OOOOOOOOOOOOOXOOOOOXXOOOXOXOOOOOOOOOOOXOOXOXOOOOOOXOOXOOOOOXXXXXXXOXXXOOOOXOOXOOXXOXOOXOXXOXOOOOOOOOX
OXOOXOOOOXXOOXOXOOOOOOOOOOXXXXXXXXOXOOXOOOOOOOOOOXXXXOXOOOOOOOXOOOOXOXXOOOOXXOOOOOOXOOOOOOOOXXOOOOOXO
OOOXOOXXOOOXOXOOXOOOXOOOOXOXOOOOXOOOXOOOOXOOOOOXOOXXXOOXXOOOOOOXXXOOOOOXXOXOOOXXOXOOOOXOOXOOOOOXOOOXO
XOOOXOOOXOXOOXOXOXXOOXOOOOOOXOOOOOOXXOOOOOXOOOOOXXOOOOOOOXOXOXOXXOOOXXOXOXOOOOOOXOOOOOOXOOOOOXOOOOOXX
OOOXXOXOXXOXXOXXXXOXXOOOOXOOOXXOXOXXOOOXOXXOOOXOOOOXOXOOOOOOXOOXXOOOOXXOXOOOOXOOOOXOXOOXXOXOOOOOXOOXO
OOXOOXXOXOOOOOXOXOOOOOXOOOXXOXOOOXOOOOOOOOOOOXOOOOXOXOOOXXOOOOOOOOOOOOOXOOOOXXXXXOOOOOOXXOOXOOOOOXXOO
OXOXXXOXOOOOXOXOOOXOXOOOXXOOOOOOOOOOXOOOOOXOOOXOOOOOOOOOOOOOOXOXOOOOXXOOOOXOOOOXOXOOXXXXOXOXOOOOXXOOO
OOOOOOOOOXOXXXOOXXOOXXOOOXOOOOOOXXOOXXOOOOXOOOOOXOXOXOOOOOOXOOOOOOOOOXOOOOOXXOXXOXXOXXOOOOOOXOXOOOOOO
OOOXXOOOOXXOOXOOOXOXXOOXXXOOXXXXXOOOXOOOOOOOXOXOXXXXXOXOOXOOXOOOXOOXXXOOXOXOOOXOXOOXOXOXOXXOOOOXXXOOX
OXOXOOXXOXOOOOOOXOXOXOOOOOOOOOOOOOOOOXXOOXOOOOOXOOXOXOOOOOOXOXOXOOOOXOOXOOOOXXOOOOXOOOOXXOXOXOOOOXXXO
XOXOOOOOOXXOOOXOXOOXOOOOOXOOOOOXOOXXOOXOOOOOOOXOOOOOOXOOOOOOOXOXOOOOOXXXXOXOOOOOOXXXXOOOOOOOOOOOOXXOO
OOOOOOOXXOOOOOXOOOOXOOOOOOOOOOOOXOOOOOXOXOOXXOOXOOOXOXOOOOOXXXXXXOOOOOOXXOOXXOOXOOXXOOXOOOOOOXOOOOXXO
OOXOOOXOOXOXOXOOOXOXOOOOOXOXOXOOOOOOOOOOOXOOOOOOXOXOXOOOOOXOOOOOOOOXXOXOOOXXOOOXOOXOOOOXOOOXXOXOXOOOO
OOOOOXOXOXOOOOOOOOOOXXOXOXOXOOOOOXOXOXOOOXOOOOXOXOOOOOOXOXOXOXOXOOXXXOOXXOOOXXXXOXXOXXXOOOOOOOOXOXOOO
OOOOOOOXOXOOOOOOOOOXOOOOXOOOOOOOOOXOXOOOOOOXOOOXOXOOXOOOOXOXXXXOOXXOOOOOOXOOXOOOOOOOOOOOOXOXOXOOOXOOO
OOOOOXOOOOOOOXOOOOXXXOOOOOOOOOXOOOXXOXOOOOOOOXOOOOOOXXOOXOOOOOOOXOOXOOOXOXOOOXOOOOOXOOOOXOOOOOOOOOOXO
OOXOOXOOOXXOOXXOOXOXOOXOOOOXOXXXOOOOOXOOOOOOOOXXOOOXXXXOXOOOXXOOOXOOXOXXOXOOOOOOOOOXOOXXOXOOOOOOOOXOX
OOOOOOOOOOOOOOOXOOOOOXOOOOXXOXOXOOOOOOXOOOOOOOOOOXOOOOOOXXXOXOOXOOOOOOOXOOOXOOXOOOXOOXOXOXOOOXXOOOOOO
OOXOXOOOOOOOXOXOOOOOOOOOXOOXOOOOXOOXOXOOOXOOXOXOOOOXOXOOOOOOOXOOXOXOXOOOXXOOOOXOOOOOXXOOOOOOOOOXOXOXX
OOXXOOOOOXOOXOOOXOOXOXOOOXOXOOOXOXXOOOOXOOOOOXXOOXOOOOOOOXXOOOXOOOOOXOXXXOOXOOXOXOXXOOOOOOOXOOOOOXXOO
XOOOOXOXXOOOOOOXOOXOOXXOOXXOXXOXOOOOOOOOOOOOOOOOOOOOOOOOXXXOOOXXOXXXXOXOOXOOOXOOOXOOXOOOXOOOOOXOOXOXX
OOXXOXXXOOOXXXXOOXOXOOOOOOOOOOXOOXOXXXOOOXOOOOOOOOOOOOOOXOOOOOXOOXOOXXOOOOXOXOOOOOOXOOXOXOOXXOOOOOOOO
OOXOOXOOXOOXOXOOXOOOOOOOOOXOOOOOXXOOXOXOOOXOOOXXOOOOXOOXOXOXXXXOXXOOXOXOOXXOOXXXOXOOOXOOXOOOOOXOOXOOX
OXXOOOXOOXOOOXXXOOOOOXOXOOOOOXOXOXOOXXOOOXOOOXOOOXOOOOOOOOXOOOOXOXOOOOXOXOOXOOXXXOOOOXOOXXOXOOOOXXOOO
XXXXXOOOOOOXXOXXOOOOXOOXOOOXOOOXOOXOOOOOOOOXOOXOXOOXOOXOOOOOOOOOOOOOOOOOOOOXOOXOOOOXOOOXOOOOOXOXOOXXO
OOOOOXOOOOOOXXXXOOOOOOXOOXOOOOOOXOOOOOOOOOOOOOOOOXOOOOOOXOOOOXOXOXOOXOOOXOXOOOOOXOOOOXOOOOXOOOOXXXOOO
OXXOOOXOOOOXOOOXXOOOOOXOXOOOOOXOOXXXOOXXOOOOOXXOOOOOOXOOOXXOOXXOXOOOOOXOXOOOXXOOXXOXXOXOOOOOOOXOOXOOO
XXOXOOOXOXOOOOOXOOOOOOOOXXOOOXXXOOOOOOOOOOOXXOXOOOXOXXOOOXOOXOXXXOOOOXOOOOOXOOOXXOOOOOOXOXOOOOOOXOOOX
XXOXOOOOXXXOOOOXOOOOOXOOOXOXXOOOOOXOOOOOOOXOOOOOXXOOOOXOOOOOXOOOXOOOXXOXXOOOOOXOOOOXXOOXOOOOXOXOOOOOO
OOOXOOOOOXOOOXOOOOOOOXOOXXOOXOOOOOOOXXXXXOXXOXXOOOXOOOXOOOOOOOOXXOXOOXXOOOXXXOOOOXOOOXOOXOOOOXOOXOOOO
OXOOOXOOOXXXOOXXOOOXXXXOOXOXOXOOOXXOXOOOOOOOXOXXOOOOOOXOOXOOXOXOXOOOOOOOOOOOOOOOOXOOOOOXXXOXXOOOOOOOO
XOOXOOXOOXOOXXOXOXOOOOOXOOOOXXOOOOOOOXOOXOXXOXOXOOXXXOOOXOOXOXOOOOOOXOXOXXOOOOOOXOOXOXOXOXOOXOXOOXOXO
OOOOOOOOOOOOOOOOOOOOOXOOOXOOOOOXOXXOOOOOOOXOOOOOOXOOXOOOOOOOOOOOXXOXXOOOXXXOXXOXOXOXOOXXXOXOXOOOOOOOX
XXXXOXOOXXXOOXXOXXOOXOOOOOOOOOOOXXOOXOXOOOXOXXXOXOOOOXOOOXXOOOOXOXOOOXOXOXOOOXXOOOOXOOOOXXOOOOXOOOOXX
OXXOOXXXOOOXOXXXOOOXXOXOOXOOOOOOOOXOOOOOXXOOXXXOOXXXOXXOXXXOOOXOOXOXXXOOXOOOXOOOOOOOOXOOOXXXOOXOOOXOO
OOOXOOXXOOXOOXXOOOOOOOXOOOOOOOOOOOOXOOOXOOXXOOOOOOOOOXOXOOXXOOOOOOOOOOOOOOOOXXOXOOOOOOOOOXXOOOOXOXOXX
OOOOOOXOXXOOOOXOOXOXXOXOOOOOXXOOXOOXOOOXOOXOOXOOOOOXOOXXOOOOOOOOOXOOOOXXXXOOOOOOOOOOOXOOOOOOOOXOOOOXO
OOOOOOXOXOOOXOOOOOXXOOOOOOOOOOOOOOOOOXOOOXOXOXOOXOOOOOOOOOXOOXOXOOOXOOOXXOOXOOOOOXOXOOXOOOOXOXOXOOXXX
OOOXXOOOOOOXXOOXOOXXXXOOOOOOXOOOOOXOXOOXOOXOOOXXOXOOOXOXXOXXOXXXOXOOXXXOXOXOOOOOOOOOOOOOOOOOXXXOOOXXO
OXOOXOOOOOXOXOXOOOOOOXXXOOOOXXOOOOOOOOOOXOOXOXOXOOOOXXXOXOOOOXOOOOOOOOOOXXOXOXOOXXOOOOXOOOOOOXXOXOOOO
OXXOOOOOOXOOXOOXOOXOOOOOOOOOOXOXXXOOXOXOOOXOOOXOOXXXOOOXXOXOOXOOOOXOOXOXOOXOOOOOXXOOXOOOOOOOOOXXOOXXX
XOXOOOOOXOXOOOOOOXXOOXOXOOXOOXOOOOXOXOOOXOXXOOOOOOOXOOXOOOOOXXOOOOOOOOXOXXXOXXOXOOOXXOXXOXXOXXOOOOXOO
OOXOOOOOXXOXOOOOXOOXOOOXOOOOOXOOOOOOXOOOOOOXXOOOXOOOOOXOXOOOXXOOXOOOOOXOOOOOOOOOOOOOOOOOXXOXOOXOXOOXO
OOOXXOXXOXOXOOXOOOOOXOOXOOXOXOXOOXOXOOXOOXOOOOOXOOXOXOXOXOXOOOOOXOOXOOOOXOOXXOXOOXOXOXOOXOOOOOOOXXXOO
XOOOOOXXOXOOXOOXOOOOOOOOOOOOXOOOXOOOOXOOXOOOXOOOOOOOOOOOOXOOOOOXOXXOOOOOOOOOOOOXOOOOOOOXOOXOOOOXOOXOO
OOOOOOOOOOOOOXOOOOOOOXOXOOXOOXOOOOXXOXXOOOOOOXXOOOOOXXOOOOOOOOOOXXOXOXXOXXOOOOOOOOOOOOOOOOOOOOOOOOOOO
OOOOOXOOOOOOOOOXOXOXXOOOXOOOOXXOOXOOOOOXOOOOOXOOOXOOOXOOOXXOXXXXOOOXOOOOOOOXOOXOOXOOOOOOOOXOOOXOOOOOO
OOOXXOXOOXOOOOOOOOOXOOOOOOXXOOOXXOOOXOXOOXOOOOOXOXOXOOOXXOOXXOOOXOOOOXOOOOOOXOOOOOOOXOXOXXOXXOOOOXOOO
XOOOOXOOOOOOXXOXOOOOOOOOXOOOOOOOOOOOXOXOXXXXXOOOOOOOXXOXXOXXOOOXOOXOXXXOOXOOOOOOOXOOXOXXOOXXXOOOXOXOO
OOOOOOOXOOOOXXOXXOOOXOXXOXXOOXXOOOOOXOOOOXXXOXOOOXXOOOOOXXXOOXOOOOXOOOOXOOXXXOXOOOOOOOXXOOOOXOXXXXOOO
XOXXOOOOOOOOOOOXOOOOOOOOOOXOOXXOOXOXXOXXOXXOOXXOOOOOOXXOOXOOOOXOXXXOOXXOOOXOOXXOOOOOOOOXOXOOXOOOOOOXX
XXOOXOXXOOOOOOOXOOXOXXOOXXOOXXOXOOOOXOOOXOOXOXOXOXOOOXOOXOOOOOOXOXXXOOOOOXOOOXOOXOOOOXOOOOOXOOOXOXOOO
OOOOOOOOXOXOOOOOOXOXOOOOOOXOOOOOXXOOXOXXOOXOOXOXXOOOOOOOOXOOXOOOOOOOOOOOOXOOOOOOOXOOOOOOOOOOOXOXOXOXX
OXOXOXOOOOOXOOXOXOXOOOOXOOXOXXXOXOOOXOOOOOOOOOOOOOOOXOOXOOOOOOXOOOXOOOOOOXOOOOOOOXXOOOXOOOOOXOOOOXOXO
XOOOXOOOOXOOOXOOOXXXOOOOOOOOOOOOOOOXOOOXOOXXOOOOOOOOOXOXOOOXXOXOXXXOOOXXOOOOXXOXOXXXOOOOOOOXOOXOOOOOO
XXOOXXOOOOXOXXOOOOXOOOXOOOOXOXXOOOOOOXOOOXXXOXOOXOOOXOOOOOOOXOOXXOOOOOOOOXOXOOOOOXOXOOOOXOOXXOOXOOOOO
XOOOXOOOOOXOXXXOXXOOXOXOXOXOOXXOXXOOOOOXOOXOOOOOXOOOXOOXXOOOOOOXXOXXXOOOOXOOOOXOOXOXOOOOXXXOXXOOOOOXX
OOXXOXOXOOOOXOOOOOXXXOOOOOOXOOOOOOXXOOXOOOOXOXOOOOXXOOOOOXOOXOOXXOXOOXOOOOOXXXOXOXOOOXOOOOOXOOXXOOXOO
OOXXOOXXXOOXOOOOOOOOOOOXOOOOXOOOOXOXOOOOXOXOOXOOXXXOXXXOXXOOOOOXOXOOOOXXXXOOOOXOXOOOOXOOXXOXOXOOOXXOO
XOOOOXXXOOOXXXXOOOOOXOOXXXOOXXOOOOXXXOOOXXOOOXOOOOOXXXOXXOOOOXXXOOOOXOOOOOXOOXOOXOXXOXOOXOOOXOXOOOXOO
XOOXOOOOOOXOOOXXOOOOOXOOXOOOXXXOOOOOOOOOOOOXXOOOOXOOXOOOXXXOOXXXXOOOOOOOXOOXOOOOOOOOOOOOOXOXXOOXXOOOO
OOXOOOOXOOOOXOXOXOOOXOOOOXOOOOOOOXXXOOOXOOXXOXOOOOOOOXOOXOOXOOOOXOXOOOOOXOOOOXOOXOXOOOOXXOOOOOOOXOOOO
OOOXOOOOOOOOOOOXOXOXOOOXOOOOXOXOOOOOXOOOOXOOOOOOXOXXXXOXOOOXOXOOOOXOOXXOXOXOXOOOXOOOOOOXXOOOOXOXXOOXX
OOXOXXOOOOOOXOXXOOOOXOOOOOOXXXOOOOXXOOOOOOOOOXXOXOOOOOXOOOOXOXOOXXOXOOOOOOXXOXXOXOXXOOOXXOOXXXOOOXOOX
OOOXXOOXOOOOOOXOXXOOOOOOOXXOOOOOXOXOOOOXOOXOOOOOOOOXXOOOOOXXXXOOOOXOOOOOXOOOXOOOOOOXXOOOOOXOOOOOXOXXO
OOOXOXXXOOOOXOXOOOXOXOOOOOOOOOOXOOOOOOOXXOXOOXOOOOOOXXXXOOOOOOOXXOOOOXXXOOOXOOOXOXOOOOXOOOOOXXOXXXOOX
XOXOOOXXOOOOOOXOOOOOXOOOOOXXOOOOOOXOOOOOOOOOOOOXOXOOXOOXOOOOOXOXXOXOOOOOOXOXOXXOXXXOXOOOOOOOOXXOOOOXX
OOXXOOOOXOXOOOOXOOOOOOOOXOOOOXOOOOOXXOOOXOOOOOOXOXXXOXXXXXOOXOOOOOOOOOOXOOOOOOOOOOXOOXOOOXOOOOXOOOOOX
OOOOOOOXXOOOOOOOOOOOOOOOOOOOXOXOXOOXXOOXOOOOOOXOXOXOOOOOOOOOOOOOOOXOOOXXOOOOXOOXOXOXOOXXOOOOOOXOXOOOO
OOOXOOOOOXXOOXOXXOOXOOOOOOOXOXOOOOXXOXOXXOOOOOXOOOOOOXOOXXOOOOXOOOXOOOOOOXOXOXXXOOXOOOXXXOOOOOOXXXOXO
XOOXXXOOXXOOXOOXOOXOOOOXXXOOOOOXOXXOXXOXOOXOXOOXOOOXOXXOOXOXOXOOXOXOXXOOOOXOOOOOOOOOOXXOOOOOOOOXXXOOX
OXOOOOXXOOXXOOXOXOOOXXXOOOXOXXXOOOOOXOOXOXOOXOOOXXOOOOOOXOOOXOXOXXOXXOOOOOOXXXXOOOOXXOOOOOOXOXXXOXXOO
XOXOOXOOOOOXOOXOOXOOOOXOXOOOOOOOXXOXOXOOOOOOOOOOOXOXOOOXOXXXOOXOOXOOXOOOOXOOXOOOOOXXXOOOOXOOOXOOOOOOO
XXOOOOXOOOOXOOOXOOOOOXXOOXOOOOOXXXXXOOOOOOOOOXOOOXXOXOXOXOXOOOOOOXOXOOOOOOOOOOXOOOOXOOOXOXOOOOXOOXXOO
OOOXOOOOXXXXOOOOOXXOOOXXOXOXOXXOXOOOOXOOOXOXOXOXOOOXXOOOOOOXOOOOOOOXXXOOOOOOXOOXXXOOOOXXOOOOXXOXOOOOO
OOXOXOOXXOOOOXOOXXXOOOXXXOOXOOOXXOOXOOOOXOXOXXOOOOXOOOOOOXXOXOOXXXXOXXXOOOOOXOOOOOXOXOOOXOOOOXOOOOOXO
OOXOOOOXXOXXOOOOOXOOXOOOOOXXOOOOOOXOXXOOOOOXXOOXOXOOOXOOOOXOOOOOOOXXOXOOOOOOOXXXOOXOXOOXOOOXXXXOOOOOO
OOOOXXOOOXOOOOXOXOOXOOOOXXOOOOXOOXXOOOOOOOOOOOOOOXOOOXOXOXXXXXXOOOOOOOOOXOOOOOOOOOXOOOOOOOXOXXXOXOOOX
OOOOOOOOOXOOOOOOXOOOOOXXOOOOXOOOOOOOOOOOOXOOOXXXXXOOOOOOOXOXOOXXXXOXOXXOXOOOOOXOOOOXOOOOOXOXOXOOXXOXX
OXOXOXOOXOXOOOOOOOOXXOXOOOXOOOOOOOOOOXOXOXXXOXOOOXOOOOOXOXOOOOOOXXXOOXOXXOOOOXXOOOXOOXOOOOOOXOOOOOOOX
OOXXOOOOXOOOOXOOOOXOXOXOOOOXXOOOOXXXOXOOOOOXOXOOXOOOOOOXOOXOOOOXOOOOOXOOXOXOXOOOOOOOOOOOOOXOXOOOXOOOX
XOOOOOXXOXOOOOOXOOXOOOOOXXOOXXXXOOOOXOOXXOXXXOXOOOXOOOOOXXOOOXOOOOOOOOOOOOOXOOOOXXOOOOOOOXOOOOXXXXXOO
OXOOXXOXOOXOOOOOOOOOOOOXOOOOOOOOOOOOOXXXOOOXOOXXOOXOXOOOXOOOOOXOOOXOXOXOOOOOOOXOXOOXXOXOXOOOOOOOOXOOO
OOOOOXXXOOOXOOOXOXOOXOXOOXOOOOOXOXOOOOXXXOOXOOOOOOOOXXOOOOXOOOXOOOOOXXOOOXOOOOOOXOOOXOXXXOOOXXOOOXXXO
OOXXOOOOOXOOOOOOOOOOOOOOOOOOOOOXOXOXOXOOXOOOXOXXXXXOOOOXOOXOOXOOOOOOOOOOXXOOOOOOOOOXOOOXOXOXOOOOOOOXO
OXOOXXOOXXOOOOOOOOOOOXOOOOXOXOOOXOOOXXOOXXOXOXOOOOOXOXXOOXOXOOOOOOOOOXOXXOOOOOXXOXOXOOOOOOOXXOOOXOOOO
OOOOOOOOOOXOOOOOOOOOOOOOOOOOOXXOXXXOOXOXOOXOOOXXOOOOOXXXXXXXXOOXOOOXOOOOXOXXXOXXOOOXXOOXOOXXXOOOOOXOX
OOOXOOOOXOOXOOXOOOOOOOOXOOOOOOOXOXOOXXXOOOXXOOOOOOOOOOOOOOOOOOXXXOOOOOOXXXXOXOOXOOOOOXOOOOOXOXOOOXOOX
XOOOOOXOXOOXOOOXXXXOXXOXOOOOXXOOXOXOOOOOXOOOOOOOXXXXOOOOXOOXOOOXOOOOXOXOOXOOOOXOOOXOOOOOXXXOXOXOOOOOO
OXOOOXOOOOOXOXXXOXOXOOOXOOOOOOOXOOOOOOOOOOOOXOOOOOXOOXOXOOOOOOOOOXOOXOOOOOXOOOOOOOOXOXXOOXXOOOOOXOOOO
OOOOOOXXXOOOOOOOOOOOOXOOOOOOXXXOOOXOOOOOOOOOOOOOOOOXOOOXOXOXOXOOOXOOOXXOOOOXOOXOOOXOOOXXXXOOOXOOOOXXO
XOOOXXOOXOOOXOOOOOOOXOOOOOOOOOOXOOXOXOXOOOXXOOOOXXOOOXXOXOOOOXXOOXXOXXOXXXOOXOXOXXOXOOXOOOOOOOOOOXXOO
OOOXOXXOXOOOXOXOOOOOOOOOOOXXOXOOOXXXXOXOOXOOXOOOOOOXOOOOOOOOOOOXXXOOXXOOOOXOOOOOOOOOXOOOOOXXOXOXOXOOX
OXOOOXOOOOOXOOOOXOOOOXOOOXXOXXXOXOOXOOXXXOOOOOOOOOOXOOOXOOOXOOXXOOOOOXXOOOXOOOOOOOXXXOOXOXOXOXOOXOOOO
OOXOOOOOOOOOOOOOXOOOXOXXOOOOXOXOOOXOOXOOOOXOXOOXOXOXOOOXOOXOOOOOOOOOOOOOOXXOOXOOOOOOOOOXOOXOOXXXOOOOO
OOOXOXXOXXXOOOOOOOOXOOOOOOXOOOOXOOOOOXOOOOXOOOOOOXOOOOOXXOOOOOOOOXXOOXOOOOOXXOOOOOOOOOOXOOXOOOXXXOOXX
OOOXOOOOOOOOOOXXOOOOOOXXOXOOXOOXOOOXOOOOXOOOOXOOOOOOOOOOXXOOOOXXXOOOOOOOXOOOOOOXOOOXXOXXXOOXXOXXOXOXO
XOOXOOXOOOOOOOXOOOOXOOOOOOOOOOOOOOXOOOOXOOOOOOXXOOXOXOOXOOXOOOXXOOOOXOOOOOOOOOOOOOOOOOOXXXXOOOOOXOXXX
OOXXOOOOXXXXXOOOOOXOOOOXOOOXOOOOOXXOXOXOOOXOOXXOOOOOOOXOOXOOXOOOOXXOOOXOOOOOOOXXOOOOOXXXXXOOXOOOOOXOO
OOOOOOXOOOOOOOOOXOOOOOXOOXOOXOOOOOOOXOOXXXOOOOOOXXOOOOOXOXOOOOXOOOOOXXOOOOOXOXOXXXOOXOOOOOOOXOOXOXXXO
