OOOXOOOOOXOOOOOOOXOXOOOXXOOOXOOOXOOXOOXOOOXOOOOOXXOOOOXXOOXXXOOOOOOOXXOOOOOOXOOXOOXOOOXOXOXOXXOOOOXXX
OOOOOOOOOOXOXXOXOXOXOOOOOOOOOOXOOXOOXOOOXOOXXOOXOOOXOOXOOOOOXOOOOOOOXOXOOXOOOOOOOOOOOXOOOXOXOOOXOOXOX
OOOOOXOOXOXOOXXOOXOOOOOOOOOOOOOOOOOOOOXXXOXOOXOOXOOOOOOOOOOOXOOOOOOOOOOXOOOOOOXOOXOOXOOXOXOOOOXXOXOOO
OOXOOOXXXOXXOOOOXXOOXOXOOOXOOOXOOOOOOOOXOXOXOOXOOOXOOXOOOOOOOOOOOOXOOOXOOOXXOOOXOOOOOOXOOOOOOOOXOOOOO
OOOOXOOXOOOXOOOOOOOOXOXOXXXOOOOOOXOXOOOXOOOXXOXOOXOOOOOXXXOOOOXOOOOXXOXOXOOOXOOOOOOXXOOOXOXOOOOOOOOXX
XOOXOXOOXOOXOXOOOOOOOOOOXOOOOOOOOOOOOXOOOOOXOOXOOOOOOXXOOXXOOOXOOOOOOOOOOXOXXXOOOOXOOOOOOXOOOOOOOXOOO
XXOOOXOOOOOOOXXXOOOXOOOOXOOXOOOXXOXXOOOOOOOXOOOOOXXXOOOOOOXOOOOXOXOXXOXOXOOOOXXOXXXOOXOOXOOOOXOXXXOXX
OXXXXOOXXOOOOOXOOOOOXOXXOXOOOOXOOOOXXOOOOXOOOOXOXOOXXXXOOOOOOXOOOXXXXOOOXXXOXOOXOOXXOOOXOXOOXOOOXOXXX
XOOOXXOOXOOOOOOOOXOOOXOOXOOXXOOXOOOOXXOOOOOOOXOOXOXXOXOOOOOOOXOOOOOOOXOXXOXXOOXOXOXOOOOOOOOOOXOXOOOOO
OXOOXOOOXOOOOXOOXOOOOOOOXOOXOOXXOOOOOXOOXXOOOOOOXOOOOOOOOOOXOXOOOXOOOOXOOOXXXXOXOOOXOOOXOOOOOOOOOOOOO
XXXOOOOOOOOXOXXOXOOXXOXOOXXOXXOOXOOOOOOOOOOOOOOOXOXOOXOOOOOXOOOOOOOOXOOOOOXOXXOOOOOOOOXOOOOOOOOOXOOOX
OOOOOOOOXOOOOOOXXOOOXOXXXOOOOOXOOOOOOOXOXOOXOOOOOOXXOXXOOOXOOOOXXOOXOXOXOXXOOOOXOXOOOOOOOOOOXXOXOXOXO
OOOXOXOXXOOXXXOOOOXOXXOXXOOOOOOOOXXOOOOOXOOOOOOXOOOOOXXOOOOOOOOOOXXOOOOXXOOOOXXOXOXOOOOOOXOXOOOOOOOXO
XXOOXOOOOOXOOXOXOOOOXOOOOXOOXXOXOOOOOOOOOOOOOOXOOOXOOOOXXXXOOOOXXOOOOXXXXOOOOXOOOXOOXOOOOOOOOOOOXOOOO
OOOOOXXOOOOXXOOXXOOOOOOOOOOXOOOOOOXOXOXOXXOOOOXOXXXOXXOOXOOOOXOXOXOOOOOXXXXOOOOOOOOOXOOXXOOXXOOXXOXOX
XOOOOXOOOXXXOOOOXOXOOOOOXOXOOOOOXOXXOXOOXXOOOOXXOOOOOOXXOOXOOXXOOXOXOXOXXOXOXOXXXOOOOOOOOXXXOOOXXOOOO
XXOOOOOOOXOXOOOXXXOOXOXXOOOXOOOXOOOXXOXOXXOOXOXXOOOOOOXOOOOOOOXOXXXOOXXOXOOOOOXXOOXXOXOOOOOOOOXOOOOXO
XXOOOOOOOOXOOOOOOOOXOOOXXOXOOOOOXXXXOOOXXOOXOOOOOXOXOXOOOXOOXXOOOXXOOOOXOOOOOOOXOOXOXOOXOOOXXOXOXOOOO
OOOXOXOXXOOOXOOOXOOXOOXXXOXXOOOOOXOOOOOOOOXXXOXOOXXXXOOXXOXXOOXXXXOXOXXOXOXXOOOXXOOOOOOOOXXOOXOOXOXOO
XXOXXOOXOOOOXXXXXOOOOOOXXOOOXOXOOOXXOXOXOOOOOXXOOOOOXOOOOXXXOOOOOXXOOXXOOXOXXOOOOOOOXOXXXOOXOXXXOOXOX
OXXOOOOOOXOOOXXOOOOOOOOOOXOOOOOXOOOOOOOXXOXOOXOOOOXOOOOOOXXOOOOOOXXOOOXXOXOOOXOOXOOOOOOOOXOOOXOXOXXOO
OOOOOOOOOOOOOXOOOXOOOXXOOOXOOXOOXOOOXXXOXOXXXXOXOXOOOXOXOOOOOXOOOOXOOOXOXXXOOOOXOOXOXXOXOOOOOOOOXOOOX
XOOXOOOOOXOOOOXOOOOOOOOOOXOOOOOOOXOXOOOOOXOXOOOXOOOXOOOXOOOOXXOOXOOOXOOOXOOXOOOOXOXOXOXOOOOOOXOOOOOOO
OXXOXXOXOXXOXOXOXOXXOOOXOOOOOOOOXXOOOOXOOOOOXXXOXOXXXOOOXXXOOOOXXXOOOOOOXOXOOXXOOOOOOOOOOOOOOOOOXXOOO
XOOXOXOOOOOOXOOOXOOOOOOXOOOOOOOOOOXOOXOOOXOXOXOOOOOOOOXXOOOOOXXXOOOOXXXOOOOOOOOOOOXXOOOOXXOXOOXOXOOOO
XXOOXOXOOOXXOXOOOXOOOOOXOOXOOOOOOOXOOOOXOOOOXOOOXOOOOOOOXOXOOOXOOXOOXOXXOOOOOXXXXOOXOOXXOOXXXOOOXOOXO
OOOOOXOOOOOOOOOXOOOOXOOOOXOXOOXOXXXOOXOOOXXOOOOOOOOOXOXXOXXOOOOXOXOOXOXXXOOOOOOOOOOXOOOOOOOOOXXXXXOOO
XOXXXOOOXXOOXOXOOOXOOOOXOXOOXOOXXOXXXOXOOOOOOXOOOXOXXXXOOOOOOOOOOOOXOOOXOOOXOXXOOOOXXOOXXOXXXOOOOOOOO
XOOOOOOOOOXOXXOOOOOXOOOOOOOOOOOOXXOOOXOXOXOOOOXOXOOOOXOOOOOOXOOOOOXOOXOXOOOOOOXOOXOOOOOOOOOOOOOOXOOOO
OOOXOOXXOOOOOXOOOXXOOOXOOXOOOXOOOOOOXOXOOOOOOOXOXXOXOOXOXOOOXOOOOOOXOOOOXOXOXOXOOXOOOOXOOOOXOOOOOXXOO
XOOXOXOOOOOOOOXOOOOOOXOOOOOOOOXOOOOXOOOXOOXOOOOOOOXOOOOXOOOXXOXOOOOOXXXXOOOXOOOOOXOXOOOXOOOOXXOXOOOXX
OOOOOXXOOOXOOOOOOXOOOOOOXOOOOOOXXOOXXXOOOOOOXOXOXXOOXOXOOOXOOXOXOXOOOOXOOOOXOXOOXOOOOOOOOXXOOXOOOOOOO
OXOXOXXOOOXOOOOOOOOOXOOOXOOOOOXOOOOOOOOOXOXOOOOOOOOXOOOOOOOOXOOOXOXXXOOOOOOOXXOXOXXXOXOOXOOXOOXOXXXOO
OOOXOXXOOOXOXXOOXOOXXOXXXOOOXXOXXOOOXXOOXOOXXXOXOOXOXOXOOOOOXOOOOXOOXOOOOOOOXOOOOXOOOOXXOXXXXOOOXOOOO
OXOXOXOOXOOXXOOOOXOOOOOXOOOXXOXOOOOOOOOXOXOOOXXOOXXOOOOOOOOOXOXOOOXXOOOOXOOOOOOOOOOXOOXOOOOOOXXOXXOOO
XOXXXOOXOOXXOXXXOXOXXXXOOOXOOOOOOXOOOXOXXOOOOOOOOXXOXOOXXXXOOXOXOXOOXOOXXOOXOOOOOOOOOOOOXOXOOXXOXXXOO
XOOXOOXOXOOXOOXXXOOOOOXOOXXXXXOOOOOOOOOXXXOOXXXXXOXOOXXOOOOXXOXOOOOXOOOOOXOOOXOOOOXOOXOXXOOOOOXOOXOXO
XOOXXOXOOOOOOOOXOOOOOOOXOOOXOXXOOOXOOXOOOOXOXOOOXXOOXXOOOOOOOXXOOXXXOXOXOXXOOOXXOOOOOOOXOOOOOXOOOXXOO
OXOXXXOOOOXOOOOXXXOOOXOOOXOOXOXOOOOXOXXOOOOOOXOOOOOOOOXXOXOOXOXOOXOOOXOOXOOOOOOOOXOXOOOXOOOXOOOOXOOOO
XOOOOOXXXOOXOXOOOOOOOOOOOOOOOOOXOOOOXOXOOXOOOOXXOOOOOOOOOOOOXOOOOXOOOXOOXOOOOXOOXXOOXOOOOXOXXOXXOXXOO
XOXXOOXXOXXXOOOOOOOOXOOOOXOOOOXOXXOOOOXXXXOOOOXOOXXOXOOXOOOOXOOXOOOXOOOXOOOOOXXOOOOOOOOXOOOXOOXOOOOOO
OXOOXXXXOOOXOOXXOOOOOOXOOXOOOOXOOXXOOOOOOOXOOOOOOOOXOXOXXXXOOOXOOOOOXXXXXXOXOOOXOXXOOXOOXOOXXOOOOOOOX
OOOOOOXOOOOOOOOOOOOOOOOOOOOXOOXXOOXOXXOOXOOOOOOOXOXXOOOOOOXOOOOOOOOOOXOXXXOOXXOOOOOOOOOXOXXOOXXXOXOOO
XXOXOOOXOXOOXOXOOOOXOOOOOOOXXOOOXOOXOOOXOOOOOOXXOOOOOOOXOXOXXXOOOOOOOOOOOOXOOOOXOXOXOOOXOOOOOXOOOOOOO
OOOOOOOOOOOXOOOOOOOOOOOXOOXOOOOXOOXOOOXXOOOOXOOOXXOOOOOOOXXOOOOXXOXOXOOOXOOOXOOOXXOOOOXOXOOOXXOOOOXXO
OOOOOXOOOOOOOOXOOOOOOOOOXOOOOOOOOXOXOXOXOOOOOXXOOOOOOXOXOOXOXOOOOOOOOOOXOOOXOOXOOXOOOOOXOOOOOOOOXXOXO
XXOXOOOXOOOOXOOOOOOXOXOOXXXOOXOOOOOOOOOOOOOOOOXOXOOOOXOXOXOOOOOOOOOOOXOOOXOOXOXOXOOOOXOOXOOXOOOXXOXXO
OOOOOOOOOOXXOOOOOOOOOXOXOXXOXOXOXOOOOXOOOOOOOOOOOOOOOOXOOOOOXOOOOOOOXOOOOXOOOOXOXXOOOOXXXOXXOOOOOOOOX
OOXOOOOOXOOOOOXXOOOOOOOXOXOOOXXOXOOOOOOXOOXOOOOOXOXOOOOXXOOOXOOOXXXOOOOXOOOOOOOOOXOXOXOOOOXOOOXOOXOXO
OOOXOOOOOOXXOOOXOOOOOOXOOOOOOOOOXOOXOXOXOOOXOXOOOXOOOXXXOOXOOOOOXOOOOOOOOOXOXOOOOXXOXOXOOOOXOXOOOXXOO
OXOXXOOXOXXXXXOOXXOOOXXOXOOOXOOOOOXXXXOOOOOOOOXOOOOXOOXXXXXOOOOOOOXOOOOXOOXOOOXOXXOXOOOXOOXXXXOOOOXOX
OOOXOOOOOXXOOOOXXOXXOXOOXXOOOXXOXXOXOOOOOOOOOXOOOXOOXXOXOXOOOOOOOXOOOXXOOXOXOXOOOXOOOOXXOOOXOOXOXOOXO
XOOXOOOOOXOOOXOXOOOXOXOXOOOXOOXOOOOOXOOOXXXOXXOOOXXOXOOXOXOOOOXXXXOXXOXOOOOOOOOOOOXOOOOXOOOXXXOOOXXOO
OOOOXOXXOOOOOXXOXOOOOOXOOOOOOOOXOXOOOOOXOOXXOOXOXXXOXXOOOOXXOOOOOOXXXOOOOXOOOXOXOXOOOXXOOOOOOOXOOOOXX
OXXOXOOOOXXOOOOOXOOOOXOXOOXOOOXOOOOXOOOOOOOXXOOOOOXOOOOOOOOXXOXOXOOOXOOOOOXOOOXOOOOOXOOOOOOOOXOXXOXOO
XOOOOXOOOOOOOOOXOOOOOOOXOOOOOOXXOOOXXOOXOXXOOOOOOXXXOOOOOOOXXOXXXOOXXOXOOOOOOXOOXOOXXOXOOXXOOOOOOXXOO
XOOOOOOXOOXXXOOOOXOOOXOOOOOOOXOOOXOOXXXOOOOOOOOXXXOXOOOXOXOOXOOXOOOXXOXOOXOXOOOOXOOOXOXOOOOOXOOOOOOOX
OOOOOOXOXOXOXOOOOOOOOXOOOOOOOOOOOXXOOOOOXOOOOOOXOOOOOOOXOOXOOOOXOOOXOOOOOOOOOOOOOXOOOOOXOOXOXOOOOOXXO
OXXOXOOOXOXXOXXOOOXOOXXOOOXOOOOXOXOXXXOOXXOOOOXXXOOXXOOOXOOOOOOXXXOOOOXOXOOOOOOOOXOOOOXXOXOOOXXOOXOOX
OOOOXOOOOOXOOOOOXXXOOOOOXXOOOOXOXOXXXXOOXXXXOOOOXXOOOOOOOOXXXXXXOXOOXOOOOOOOOOOOOOOXOOXOOOOOOXXXXXOOO
XOXOOOOOOOOOOOXOOOOOXXXXOOOOOXXOOOXOOXOOOOXOOOOOOOOOOOXOOOOOOXOOOOOOOXOOXOOOOXOOXXOOXOOXXXOOOXOOXOOOO
OOOOXOOOOOOOOOXOXOOOOOOXOOOOOOXOXOXOOOXOXOXOOOOXOXOOXOOXOOOOXOOOOOXOOOXXOXXXXOOOOXOXOOXXOXXOXOOOXOOOO
OOXOOXXOOOXXOOXOXOOXOXOOOOXOOOXOOOOOOXXOOOXOXOXXXXOOXOOOOOXXOOOXOOOOOXXXXOOOOOOXOOOXOOOOOXOOXOXOOXXOO
OOOOXOOOOOOOXXXOXOXOOXOOOOOOOOOXXOOXXXOOOOOOOOOOOOOOOOOXOOOXXOOOOOXXXXOOOOOOOOOXOOOOXOOXOOXOOOOOOOXOO
OOOOOOXXOOOOOOOXXOOOOOXOOOOXXOOXOOOXXXOXOOOOXOOOOOOOOOXXXOXXOXOOOOXXXOOOOXOOOOOOXXOOOOOXOOXXOOOOOXXOX
XXXXXXOOOXOXXOOOOOOOOOXOOOXXOOOOXXOOXOOOXOOOXXXOOOXOXOXOXXOOOOOOOOXXOOOOOOXXOOXOOOXXXXXXOOXOXOOOXOOOO
XOOOOOOOOXOOXOXOXOOXOOOOOOXXXOOOOOOOOOOOOXOOXXOOOOOOOOXOOOOXOOXOOXOOOOOOOOOOXOXOOOOXOXOOOOOOOOOOOOOOO
OXXXOXOXXOXXXOXOOOOXOXOOOXOXOOOOXOOOOOXXOXOOOXOXXOXXXOXXOOOXOOOOXOOXOOOOOOOXOOXXOOOOOOOOOOOXXOOXOXOXO
OOOXXXXXOOOOXXOOOXXXOOOXOOOOXOOOOOOXOOOOOXOXOXXXOOXOOOOXOOOXOXOXOOXOXXOOXOXXXXOOXOXOXOOXOOOOOXOXXXOXX
OOOOOOOXXXOOOOOXXOOOOXOXOXOOOXXOOOOOXOXOXOOOOXXXOOOXOOOOOOXXOXOOOOOXOOOOXXOOXXXOOOOXXOXOOOXOXOOOOOOOO
XXOOOXOOOXXOXOOOXOOXXXOOOOOOOOXOXXXOXOXOXOOOOOOOOOXOOOOXOOXOXXOXOXOOOOOOXXOXXOXOOXOOOOOOXOXOOOOOXOOOX
OXOOXXOOOOOOOOXXOOOOOOOXOOOOOOOOXOOOOXOOOXXOOXOOXOOOOOXOOOOOOOXOXOOXXOOXXOOOXOOOOOOOOOOOOXXXOOXXOXOXX
XOOOXXXOXOXXXOOOXXXOOOOXOOOOOOXOOOOOOOOXXOOOOOXOOOOOOOOXOOOOXXOOOXOOOXXOOOOOOOOXOXOOXOOOXOOOOOOXXOXXO
XOXOOXXOXOXOXOOOOOXOOXXOOOOOXXOXOOOOOOXOOOOOOXOOOOOOOOOOXOOXXOOOXOXOXOOXXOXOXOXOOOXOOXOOOOOOOOOOOOOXX
OOXXXOXOOOOXOOOOOOOOOOOOOXOOOOOOOXOOOOXOOXOXOOOXXOOXOOOOOOOOOOOOXOXOOXOOOXOOOOXOOOXOXXXOOOOXOOOOOOOOO
XOOOOOXOXOXOOOOOXOOOXOOXOOOOXXOXOXOOOXOOOXOOOOOOOXOOOOOOOOXXOOXOXXXOOOOOOOOOOXOOOXOOOOOXXOXOOXOOXOOXX
OOXOXXOOOXOOXXOXOOOXOOOOXXOXOOOOXOOXOOXOOOXOXXOOOOOOOOOOOOOOOXOXXOOXXOXXOOOOOOXXOOOXOOOOXOOOOOOOOOXOO
OOOOOOOOOOOOOOOOXOXXOXOOOOXXOXOOOOOXOOOXOOOOOXOOOOXOXXOXXXXOOOOOXOOOOXOOOOOOOOOXOOXOOOOOOOOXOXOOXXOXO
OOXXOOXXXOXXOOOOOOOOXOOOOOOXOOXOOOXXXOXOOOXOOOOOOXOOOOXOOOOOOXOOOOOOOOXOOOOOOXOOOOXXOXOXOXOOOXOOOOOOO
OOOOXOOOOOOXOOOOXOOOXOOOOOXOXOXXOOOOXOOOOOOOXOOOOOXXXOXXXOOXOOXXOOXOOOXXXOXOOOXOOOXXXOXOOOXOOOOXOOOXO
XXOOOOXXOOXOXXOXOOOOOXOOXOOXOOOOOOXXOOXOOXOOXXOOXXOOOXOXXOOOOOOOOXOOXOXOOOOOOOXXXOXXOXXOOOOXOXXXXOOXX
OOOOOXXOXOXXXOOXOXXOXOOOOOOOOOOOOOXOXOXOOXOOOOXOXOXOXXOOOXOOXXXOOXOOOOOOOOXOOOXOOOXOOOOOOOOOOOOOXOOOO
OOOXXOOOOOXXXXOXXXOOXXOOOXXXOXOOXOXOOXOXXOXOOOOOOOXXOOOXOOXOXOOOOOOOOXXOXXOOXOOOXOXOXXOXOOOOXOOOOOOOX
XOXXXOOOXOOOOXOXOOOXOOOXOXOOOOOOOOXOXOXXOOOOOOXOOOOXOOXOOOOOXOOXXXOOOXXXOOXXXXOOOOOXOOXXOXXOOXOXOOOOO
OOXXOOOOOOOOXOOXOXOOOXXXOOXXXOOOOOOOXXOOOXOXXOOXXOOXOOOOOOOOOOOOOOOOXOOXOOXOOOXOOOOOOOXXXOOXOOOXOXOOO
OOXXOOOXOXOXXOXOOOOOXXXOOOOXOOOOXOXOOOXOOOOXXOOXOOXXOOOXOOOXXOOOXOOXXXXOOOOXOOOOOOOXXOOOOOOOXOOXXOXOO
OOOOOXOOXOOOXXOOXOXXOOOOOXOOOOXOOOOOOOXOXOOOOOXOXOOOOOXOXXOOOXOXOOXOXOOOOXXXOOOOOOOOOOOOXOOOXOOOOXXOO
XOOOOOXOOXXOOOXOXOOOOOOOXOOOOOOOXOOOOXOOXOOOOOXXOXXOXOXOOOOOXOOOOOXXOOOOOXOXOOOXOXOOOOOXOOOXOXOOXOXOO
OOOXOOXOXXOOOOOOXXOOXOOXXOXXXOXOOOOXXOOXOXOOOXOOOOOXOOOXXXOOOXOOOOOOOOXOXOXOOOOOOXXOXOXXOOOOXXXXXOOOO
OXXXXXOXXOOOOOOOXOOXXOXOOOOOOXXOOOOOXOXOOOOOOOOXXOOOOOOXXOOXXOOXOOOOXOXOXOXOOOOXOOXOOXOOOOOOOXOOOOOOX
OOXOXOOOOOOXOOOOOOOOOXOOXOOOXOOOOOOOXOXOOOOOOOXOOOOOOOXOXXOXOOXXXXXOXOOOOOXOXOOXXXOXOOOOOOOOOOOOOOXOO
OXXXOXOOOOOOOXOOXOOXXOXXXXOOXXOOOXOXOOOXXXXOOOOOOXOOXOOOOOOOOOXOOXXOXOOXOOXOOXOXXOOOOOOOXOOOOOOXXOOOO
OOXXOOOOOXOOOXXOOXOXOXXOXOOOOXOOOOOXOXOOOOOXOOOOXOOOXXOOXXOOXXXXXOOOXOOOOOXXOXXOOOOOXXOXXOOOXXOOOOOXO
OOOXOOOXOXXXXOOOOOOXOXOOXOXOXOOOOOXOOOOXOOOXOOOOOOOOXXXOXXOOXOOOOXOXXOXOXXOXOOXOXOXOOOOOOXOXOOOOXOXOO
OOOOOOOXXXXOOOXXOOOOXOOXXOXOXOXXOOOOOOXOOOOXOOOOOOOOXOXXOOXOOOOOOOOOXOOXOOXOOOOOOOOOOOOOOXOOXOOOOOOOO
XOOOOOOOOOOXOOXOXXOOOOOOXXOOOOXOOOOOXXOOOOOOOXOOOOOOOOOOOXOOOOXOOOXXXOXOOXOXOOOXXXXXOOOOOOOOOXOXOXOOO
OXOXOXOOOOXOXOXXOOXOXOOOOOOOOOOOOOOOOOXXXOOXOOOXXOOOXOOOXOOOOOOOOXXOOXOOOXOOOXOOOXOXOOOOOXOXOOXXOOXXX
OOOOOOOOXXXOXOOOOOXOOOOXOXXOOXOXOXOOOOXOOOOOOOXXOOOOOXOOXOOOOOOOXOOXXXXOXXOOOOXOOXXOOXOOXOXXOXOXOOOXO
OOOOXOOOXOOOOOOOXOXOOOOOOXOOXOXXOOOOXOOOOXOOXOXXOOXOOXOOXOOOOOOXOOOOOXOOOOOOOXOXOOXOOXOXOXOOOOOXXXXXO
XOOOOXOOOOOOOOOOOXXOOOXXOXOOOOOOOOOXOXOOXXOOOXXOXOXXXOXOOOOOXOOOOOOOOOOXXOOXOOOXOXOOOOOOOOOOOOXOOXXOO
XOOOOOOOOOOOOOOXXOXOOXXXXOOOOOOXOOXXXOXXXOOXXXOOXOXOXOOOOXXOOXOOOOOXOOXOOOOOOOOOOXXXOOOXXXOOOOXOOOXOX
