OOOOOOOXOOXOXOOXOXOXXOOOOXOOXOOOOOOOOOOOXXOOOXOXOOXOOOOOOOOXOOXXOOXOOOOOXXOOOXOXOOOXOXOOOXOOOOXOOOOXO
XOOXOXOOOXOOOOOXOOXXOOOOXOOOOOOOXOOOXOXXXOXOOXOOOOXXOXOOOXOOOXXOXOOOOXOOOXOOXOOOOOOOOOXOOXOXOOOOOOOXO
OOOXOOOXOOOOOOOXOXOXOOOOOOOOOXOOXOOOOXXOOXOOOOXOOOOOOOXOOOXXXXOOOOOXOXOOOOOOOOOOOXXXOOOXOOOOOXOOOOOOX
OXOOOOOOOOOOOOOXOOOOOXXOXXXOXOOOXOOXXOOXOOOOOOOXXOOXOXOOOOOOXOXOOOOOOOOXXXOXXOOOOOOOOXOOOOOOXXOXXOOXX
OOOOOOOOOOOOOXXOOXXXOOOOXXOOOOOXOOXOOOOOOXOOOOOXOXOXOXOXOXOOOOOXOOOOOXOXOOOOOOXXOOXOOOXXOOXOOXOOOOOXO
XXOOOOOOOOOXOOOOOOOOOOOXOOOXXOOOOXXOOOXOXOOOXOOXXXOXOXXOXXOOOXOOXXXOXOXOOOXXOXXXOXXOXXXXOOOOOXOXOXXOX
XXOOOOOOOOOOOOOXXOXOXOOOOOOOXXXOOOOOOOXOXOOXOOOXOXOOXOOOOOOOXOXXOOXOOXXOXOXOOOOOXOXOOOOOOXOOOOXXOOOXO
OOOXOXXOXOOOXOOOOOXOXOXOXOOXOOXXOXOOXXOOXOOOOOOOOOOOOXOOOXXXOXXXOXOXXOOOOOXXOXXOOXOXXOOOXOOOXOOXOOOOO
OOOXOOOOOOXOOOOOOOOOOOXXOOOOXOOOXOOOOOXXXOOOOOOOOXXXOXOOXXXOOOXXXXXOOOXOXXOOOOXOXXOOOOXOOXOXXOOOOOOXO
OOXOOOXOOOXOXOOOXOXOXOOOOOXOXOOOOXXXOOOOOOOOOOOXXOOOOOXXXXXOXOOXOOOOOOOOOOXOOOXOOOOOXXOOXOOOXOOOOOOXX
OOOOOOXOXXOXOOXOOXOOOOOOOOOOOOOOOXOOOOOOXOOXOOXOOOXOOOOOXOOOOOXOXOXOOOOOOXOOOOOOOOXOOOOXXOOOXOXOOXOOX
OOOOOOXXXOOXOOOOXXOXXOOXOOXOOOOOOOOOOOXXOXOOOOXOOOXOXOOOOOOXOOOOOXOOOOOOOXOOXOXOOOXOOOOXOXXXOOOOXXXOO
OOOOXOOXOXOOOOOOXXXOOOXXXOXOOOOOOOOOOOXOOXOOOXXXOOOXOOOOOOXXOXOOOXOOOXOOOXXOOXOXOOOOXOOOOOOOOXXOOXOOO
OOXOOOOXOXOOXOXOXOXXXOXXOOOXOOOXOOOOOOXOXOOOOOOOOOXOOXXXOOXXXOOOXOOOOOOOOXOXOOXOOXOXXOOXXOOXOXXOXOOXX
OOOXOOOOOOOOOXOOOXOOOOOXOXOXOXOXOOOOOOXXXXOOXOOOXOOOOOXOOOXOOXOXOOXOOXXXOOOXOOOXOOOOXXXXOXOOOXOXOOXXX
OXOOXOOXXXOOOOOXXXOXXOOXOOOOOOXOOOOOOOOXXOOOOOOOXOXXOOOOXXXXOXXOXOOXOOOOXOOOXOXOOXXXOOXXXOOOXXOXXOOXX
OOOOXXOXXOOXOOXOOOOXOOOXOOOOOOXOXOOOXOXOOOOOOOOOOOXOXOOOOXXOOOXOOXOXOOXOXOXXXOOXOXOOOXXOOOOOXOOXOOOOX
OOXOOOOOOOOOOXXXOOOOXOXOOOOXOOOXOOOOOXXOOOOXOOOOOOXOOOOOXOXXOXOOOOOOOOXOOOOOOOOOOOOOOOOOOOXOOOXOXOXXO
OOOXXOXOOOOXOOOOXXOOOOXOOOOXXOXOXOOOOOOOOXOOOOOOOOOOXOOOOOOOXOOOOOXOXOOOOOXOXXOXOOOOXOOXOOOOXXXOOXOOX
OOOOOOOOOXOOXOOOOOOXOOOOOOOOOOXXXOOXOXXOOXOOXOOXOOOOOOXOOOOOOXOOXOOXOOOOXOOOOOOOOOOXXOOXOOOXOOOOXOOOO
XXOOOOOOOOOXOXOOOOOOOXXOOOOOOOOXOXOOXXOOOXOOXOXOOOOXOOOXOXOOXOOOOOOOXOOOXOOXXOOOOXOXOXOOOXOOOXOXXOOOX
OXOOOOOOOOXOOOOOOOOOOOOOOXXXOOXOOOOXXOOOXOOXOXOXXOOXOOOOOXXOOXOOOOOOOXXOOOOOXOOOOOXXXXXOXOOOXOXXXXOOO
OOOXOOOOOOOOOOXOOXOOXOXXOOOXOOOOOOOOOXOOOXXOOXOOOXOXOOOXXOXOOOXOOOOXXOOXOOOOOOOOOOOXOOXXXOOXOOXOOOXXX
XXOOOOOOOOOOOXXXOOOOOXOXOOOXOXXXOXOXXXOOOOXOOOXOXXXXOOXOOOOXOOXXOXOOOOOOXXOOOOOOOOOOXOOOOOOOOOOOOOOOO
OOXOOOOOOOOOOOOOOOOOXOOOOOOOOOOOOOOXOXXOOOXXXOOOXOOOOOOXOOOXOOOXXOXOXOOXXXOOXXOXOXXXOOOOOOXXOOOXOOOOX
XXOOOXOOOXXXXXOOXOOOXXOXOXOXXXXOOXOOOOXOOOOOOOOXOXOXOOOOXOOOOOXOOXOOOXXOOOOOOXOXXXXXOOOXXOXXXXXOOOOOO
OOOXOXXXXXOOOOXOXOOOOOOOXXOOXOOXOOOOOXOXOXOOXOOOOOXOOOOXXOOXXXOXOXXXOOOXOOOOXOOOOOXOOOOOOOOOOXOXOXOXO
OXXOOXOOXOOXOOOOOOXOOOOXOXXOOXOXOOOOOOOXOOOOOXXXOXOOXXOOOOOXOXOOXXXOXXOOOOXOOOXOXOOOOOOOOXXOXOOXXOXOO
OOOOOXOOOXXXXOOOOOXOOOXXOXOXOXOOXOOOOOXOOXXOOXOOOOOXOOOOXOOOOOOOOOOXOXXOOXXOOXOOXOXOOOOXOOXOOOXOOOOXO
OXXXOOOXOOXOOOOOOXOXOOOOOOOXOOOOXOOOOOOXOOOOOOOOOXXXOOXXOXOXOXOOOOOXOOXXOOOXOXXXOOOOOOOXOOOOXOOOOOXOX
OOOXOXOOOOXOXOOXOXXOOXXOOOXXOOXOXXOOOOXOOOOOXOOXOOXXXOXOOOOOOOOOOOOOOOXXXOXXOOXXOOXXOOXOOXOOOOOOOOOXX
OXOOOOXOOOOOXOOOOXOOOXOXOOOOOOOOOOOOXOXOOOOOXXOXXOXXOOOXXXXOOOXOOXOOOXXOOXOXOOOXOXOXOXOOOXXOOOOOOOOOO
XXXOOOOXOOOOXOXOXOOOOXOOOOOOOXOXOOXOOOOXOOOOOXOOOOOOOOOOOOXOXXOOXOOXOOXOXOXOXOOOOOOOOXXOOOOOOOXOOOOXO
OOOXOOOOOOXOXOOOXOXOOOXOOXOOOOOOOOOOOOOXOOOXXXOOOOOOXXXXXOOOOXOXXXXOXOOOXOOOOOOOXOOOOOOOOOOOXXOOOOOOX
XXXOOXOOXXOOOOXXOXXOOOOOOOOOXOOOOXOOXOOXOOOOOOOOOOOOOOXOOOXOOXXOOOOXOOOOOXXOOOXOOOXXXOOOOOOOOXOXOOOXO
OOOOOOOOXOOOOXOOOOOOOOOOOOOOOXOOOXOOOOOOOOOOOOOOXOOOOOOXOOOXOOXOXOOOOOOOOOOOOOOOOXOXOXOOOOXOOOOXXXOXX
OOXXOOOOOOXOXXXOOXXOOOOXOOOOXXXOOOOOOXOOOOOOOOOOXOOOOOOOOOOOXXOOOOXOOOXXOOOOXOOOOXOOOOXOXOOXOOOOOXOOO
XXOOOOOOOOOXXXOOOOOOXXOOOOOOOOOOOOOOXOXOOXOOOOXOOXXOXXOOOOXOXXOXOOOOOXXOOOOXOOOXOXOOOOOXOOOOOOOOXXOOO
OOOOOOXOOXOOOXXOXXOOOOOOXOOOOOXXOOOOOXOOXOOOXOOXOXOOOOXXXOOOOOOOOXOOOOOXXOOOXXOOXOOOOOOOOOOOOOOOOXXOO
OOOOXOXXOOOXOOOOOOXOOXOOXOOXXOXOOOOOOXOOOOXXOOOOOXXOOXXXOOOOOOXXOOOOOOOXOXOXOOXXXOOXXOOXOOOOOOOOOOXOO
OXOXOOXOOOOOOOOXXOXOXXOOOOXOOOOOOXOOXOOXXOOOOOOXXOOOOXXOOOXOXOXOXXXOXOOOOOOOOXOOOOOXXOOOOXXOXXOXOXXXO
OOOOOOXOOOXOOOOXXOOOOXOXOOOXXOOOOXOOOXOOXOOOOOXXOOOXXXOOOOOXOOOOOXOXOOOXOOOXOOOXOOOOOOOXOOOOXOOOOXOXO
OOOOOXOOOOXOXOOOOOOOOOOXXOOOOXOOOOOOOXXOXOOXXXXOXOOOOXXOXOOXXOOOOOOOOOOOOXOOXOOXOOOOOXOXOOOOOOOOOOOOO
OOOOOOOOXXOOOXOOOOOXOOOOOOOXXXXOOOXOXOOOOXXOOOXOOXOOOXXOOOXOXXOOOOXOOOXOOOOOOOOOXOOOXOXOOOOOXOXOXXOOX
XXOOOOOOOOXOOOOOOXOOXOOOXOOOOOOOOOOOOXXOOOOXOOOXXOXOXXOOOOXXOOXOOXOOOXXXOOOOXXOOOOOXOOOOOXOXXXOXOOOOO
OOOXOOOOXOOXOOOOOOXXXOXOOOOOOOOOOXXOXOXOOOOXXXXOOOOXOXXOXOOXOOXOOXOOOOOOOOOOOOOXOOOOOOOOOOXXXXXXXXOOO
OOOOXXOOOOXOXOOOXOOXXOXOOOOOXXXOOOOOXOOOOOXXOXOOOXOOOOOXOOOOXOOXOOXXOXOOXOOOOOOOOOOOXOOXOOOOOXOXXXOXO
OXXOXOOXXOOOOOOXOOOOXOXXOXOOXOOOXXXOOOOOXOXOXOOOOXOOOXXOOOOOOXOOOOXOXOOOOXOOOXOXOXOXOOOXXOXOOOOOOOOXO
XXOXXOOOOOOOXOOXOOOOXOOXOOOXOOXOOOXOOXOOOOOOXXXOXOXOXOXXOOOOOOOOOOOOOOXOOOOOXOOOXOOOXXXOXOOOOOOOOXOOX
XXOOOOXOXOOXOOOOXXOOOXOOOXOOXOOXOXOXOOOOXOXXOOOOOOOXOXOOXXOOOXOOXOXXOOOOOOOOXOXXXOOXXOOOOXOOOOOOOOOOO
OOOOOXXXOOOOXOOOOOOOXOXXOXOXOXOOXOOOXOXOOOXOOOOXOOOOOOOOXOXOXOOOOOXOOOOOXOOOOXOOOXXXXOOOXOOXXXOOOOXXO
XXOOOOOOOOXOOOOOOXOXXOOOOOXOOOOOOXOOOXOOXOXXXOOXOXOOOOOOXOOOOOOXOOOOOOOXOOOXOOOOOOOXOOOOXXXOOOXXOXXXO
OXOOXXOOXOOXOOOOOXOOXOOOXOXOXOOOXOXOOOOOXOXOOOOXXOXOXOOXOXOOXXOOOOXXXOOOXOXOOOOXOOOXXOOOXOOOOXOXOOOOX
XOOOOOXXOOOOOOOOOXOOOOXXXOOOOXOOOOXOOOOOOOXOXOXXXOXOOOXOXOXOXOOOXOOOXOOOOOOXOOXXXOXOOOOXOOXOOXOOOOOOX
OOOOOOOOXXOOXOOOOXXOXOOOXOOOXOOOOOXOOOOXXXOOOOOOXXOOOOOXOXOOOOXOOXOOOOOOOOOOOXOOOOOXOOOOOXXXXOOOXXOOO
OXOOXOOOOXOXXXOOOOOOOXOXOXXXOOXOXXOOOOOOOOOXXXXXOXXOOOOXXOOOOOXOOXOOXXXXOOOXXXOXXXOOOXOOOOXOOOOOOOXOO
OOOOXOOXXOOXXOOXXOOOOOOOOOOOXOXXOOXOXOOXOXOOOXOOXOOOXOOOOOXOOOOXXOOOXXOOXOOOOXXOOOXXOXOOXOOOOOOOOOOXO
OOOOOOOXOXXOOOOXOXOXXOOOOXOOOXOOOXXOOOXXOOOOXXOXOOOOOOOOOOOOOOOOOOOOOOOOXXXOOOOOXXXOXOOOXOXOXXOXOOXOX
OOOOXOXOXOOOOOXOXOOOOOXOOXOOXXOXOXOXXOXOXOOXOXOOXXOOXOXOOOXXOOOOOOOOOXXOXOOOXOOOOOXXXXXOXOXXXOOOOXXXO
OXXOOOXOOOOOOOXOOOOOOOOXXOOOOOOXOOXXOOOOXOXOXXXOXOOOOXXXOXOXOOXOOOOXOXOXOOOOXOOOOOXOXOXOOXOOOOXXOOOOO
OXXOXXOXOOOOOXOOOOOXOOXOOOOXXOOOOXXOOOOOOOOXXXOOOOOOXOXOOOXXOOXXOOOOXXOOOOOOOOOOXXXOXOOXOOOXOOOXOOOOO
OXOOOOOOOOOOOOOXOXXOXOOXXOOOOOXOOOOOOXOOOOOOOOOOXXXOOOOOOXOOOOOOOXOXXXXOOOXXOXOOOOOOXXOOXOOOOXOOOXOOX
OOOXXOXXOOOXOOOXOOOXOOOXOOOXOOOOOOXOOOOXOXXXOOOXOOOOOOOOXOXXXOXOXOOXOOOOXOOOOXOOOXXOXOOOXXOOOOOOOXOXO
OOOOXXXOXOOOOOOOXOOXXOXXOOOOOOXXOXXOOOOOOOXXOOXOOOOOXOXOOOOXOOOXOOOXXXOOXOXOOXXOOOOOOOOOOOOXOXOOOXOOO
XOOOOOXOOOXOOOXXXXOOOOOOOOOOXOOXOOXXOOOXOXOOXOOOXOOXOOOOOOXOOOOXOOXOOOOXOOOOXOXOOOXXOOXOXOXOOXOOXXOOX
XXXOXOOOXXOOOOXXOXOOXXOXXOOOOXOXXOXOOOXOXXXXXXOOOXOXOXOXOOXOXXOOXXXOOOOOOOOXOOOOOOOXOOOOOXXOXOOXOOXXO
OOOOOOOXXOOOXOXOXOOXOOOOOOOXOXXOXOXXXXOOOOOOOXXXOOOOOOOXOXOOOXOOOXOOXOXOOOOXOOOOOOOOXXOOOXOXOOOOXOOOO
OXOOOOOOXOXXOOOOOXXOXOXOOOOOXXOOXOXOOOOOOOOOXOOOOOOXOOOOOOOOXOXXOOXOOOOXOXOOXOOOOOOOOOOXOOXOOOOOOOOOO
XXOOOOOXOOOOXOXOOOOOOXOXXOXOOOOXOOXXOOOOOOOXOXOOOOOOXOXOXXOOOOXOXOXOXOOOXOOOOOOOOOOXOOOOOOOOOXOXOXOOO
OXOOOOXOXOOOOXOXOOOOOOXOOXOOOOOXOOOOXOOXOOXOXOXOXOXXOXOOOOOOXXOOXOOXOOXXXOOOOOOXOOOOOOOOXXOOXOOOOOOOO
OXXOXOOXXXOXOXOXXOOOOOXOOOOOOXXOOXXXOXOXXOOXXOXOOOXOOXOXOXXXOOOOOOOOXXOXXOOOXOXOOOOOOXOOXXOOOXOOOOOOO
OXOXOOOOOXOOOOOOXXXOOOXOOOOOOXOOOXOXOOOOOOXOOOOOXOOOXOOOXOXOOOXOOOOOOOOOXOOOXOXOOOXXXOXXXOXOOOOOXXOXX
OXOOXOOOOXXOXXXOXOXOOOOOOXOOOOOOOXOOOOXOOOOOOOOOOOXOOXOXXOOXOOXOOOOOXOOXOOOXOXXOXXXXOXOOXOOOXOXOOXOOX
OOXXOOOOOOOXXXXXXOOOOXOOXOXOOXOOXOXXOOXOOXOOXXOXOOOOOOOOOOXOOOXXOOOOXOOOXOOXOOXXOXOOXOXOOOOOOOXXOOOOX
XOXOXOXXOOOOOOOOOXOOXOOOOOOOXXOXXOXOOOOOOOOOOXOOOXXXOOOOOXXXXOXOOOXOOOXOOOOOOOXOOXOOOOXOXOXOXXXOOOXOX
OXOOOOOOOXOOXOOOXXOOXOOOXOOOXOOOOOXOOOOXOXXOXOOOOXOOOXXOXOOOOOOXOXXXOXOXOOOXOOXXOXOOOOOXOOOOOOOOOOOOO
OXOOOOXOOOOOXOOOOOXOOOOOOOOOOOXOOOOXOOOOOXOOOXOOOOXOXOOOOXOXOOOOOXOOOOXOOXOXOOOXOOOXOXOOXOXXOOOXOOOXO
OOOXOOXXOOXOXOOOOOOOOOXOOOOOOOOOOXXXXOOOXOXXOOOOOOOXXXXOOOOOOOOXOXOOOOOXOOXOOXXXOOXOOXXOXXXOOXXXOXOXO
OXOOOXOOOOXOXOOOOOOOOOXOOXOOOOOOOOXOXOOOOOOOOOOOXXXOOXOXXOXOOOOOOOOXOXXOOXOOOXOXOXOXOXOXOOOXXOOOOXOOO
OXOOOOOXXOXXOOXOXOOXOOOXOXXOOOOOOOOOOOXOOOOOXXOOXOOOOOXXOXOOOXOOOOOOXOOOOXOXOOOOOOXOOOOOOXOOOXXOOOOXO
OOXOOXOOXOOOOOOXOOOOOOOOXOXOXOXOXOOOOOOXOXOOOXOOOOOOOXOOXXOOXOOOXOOOOOOOOXXOOXXOXOXOOXOOOOOOXOOOXOOXX
OOXXOOXXOXOXXXXXOOOOOOXOXOOOXOOOOOOOOOXOOXOOXOXOOOXXOXOXOOOOOOXOOOOXXXOXXOOOOOOOOOOOOXXOXXOOOOOOOXOOO
OOXOXOOXXOOOOOOOOOXOOXOXOOXOOXOXOOOOOOOXOOXXOXOOXOOOOOOXXOOXXOOOOXOOOOOXOOOOXXXOOOOOOOOOOOXOOOXOOXOOO
XOXXXOOOOOOOXOOOXOOOOOOOOOXXOOOOXOOXOOOOOXOOXOOOOOOOOOOOOOOOOXOOXOXXXXOXOOOOXOOOOXXOXXOXOOXOOOXOOOXOX
OOOOOXOOOOOOXOOOOOOXXOOOOOOOOOOXOOOXOOOOOOXOOOOXOXOOOOOXXOXOXOOOOOOOOOOOOOXXXOOOXOXXOXOXOOOOXOOXXOXOO
XOXOXOOXXOOOXOXOXXOOOOOOXOOOOXOOOXOOOOOXOOOOOOOOOOOOOOOXOXXXOOOOOXOOOXXXXXXOOOOOOOOXOXOOOOXXOOOXOOXOO
XXOOXOOOOOXXXOXOOXXOXOOOXOOOXOOXOOOOOOOOOOOOOOOOXOOOOOOOXXOOOOOOXXOOOOOXXOXXOOOXOOXOOXOOXOXOXOXOOOXXO
OOOXOOXOOOOOXXXOOOOXXXOXOOXOXOOXOOOOOOXOOOOOXOOOOOXXXXOOOOOXOOOOOOXXXXOOOOXOOOOXOOOOXOOOXXOOOOOOOOOXX
OOOOOOOOOOOXXXOOOXOOOXXOOOOXOXOOXOXOOOXXOOXOOXOXOOOOXOOOOXOXXXXOXOOOOOXOXXOOOOXOOOOOOOXXOOOOOXOOOOOXO
XOXOOOOOOXXXOOXXOOOXOXOOOOOOOOOOOOOOXOOOOOOXOOXOOXOOOXOXOXOOOOOOOOXOOOOOXOOOOOOOXXOOOOOOOOOOOOXOOOOOO
OXOXXOXXOOXOXOOOOOOXOOOOOXOOOOOOOOOOOOOOOOOOXOOOOOOOOOOOOOOOXOXXXOOXXOXOOXXOOXOOOOOOOOOXOOXXOOXXXXXOO
XOOXOOOXXOOOOOXOOOOXXOXOXOOOOOOOOXOOXOOOOXOOOOOOXOOXOXOOOOOXOXXOOOOOOOOOOXOXOOXXOOOOOOOOOOOXXOXOOXOOX
OOOXXOOXOOXOXOOXOOXOXXOXOOOOOXOOOOOOOOOXXXOOOOOOXOOOOOOOOXOXOXOOOXXOOOOOOOOXOOXOOOXOOOOXOXXXXOOOXXOOO
XXXOOOXOXXXOXOOOOOXOOXOOOOOOOOOOOOOOOOOOXXOXOXOOOXXOOOOOOXOOOXOXXXOOOOOXOXOOOOOOOOOOOOOOXOOOOOOXOOXOO
OOOOOOOOOXXOOXXOOOOOOOOOXOXXXOOOXOOXOOOOOOXOOXOOOOOOOXOXXOXXOOOOOOXOOOOOOOOOOOOOXOOOXOXXOOOOOXOXXXOOX
OOOOXOOOOOOXOXOOOXXOOOXOOXOOXXOOOOOOOOOOOOXXOOOOOXOXOOXOOOXXOXOOOXOOOOOOXOOXOOOOOOOOOOOXOXOOOOOXOOOXX
OOOXXOOOOOOOXOOOXOXXOXOOOXOOOOOOXOXOXXOOOOOOXOOOOOOOOXXOXXOOOOOXOOOXOOOOXOOOOOXXXOXOOOOXXOOOOOOOXXOXX
OOOOOXOXOOOOXOOOOOXOXXOOXOOXOOXXXOXXOOOOOXOOXOOXOXOOOOXXOOXXXOXXOOOOOOOOOXXOXOXXOOXOOOXOXXOOXOOOXOXOO
XXOXOXOOXXXOOOOOOOOOXOOOOXOOOOOOOOOXOXOXOOXOOOOOOXXOXOXOOOOOOOOOOXXOOOOOOOOOOOOOXOOOXOOOXOXOOXOOOOOOO
OOXOOOOXOOOOOOOXOOXXXXOXOOOXOOXXXOOXOOOXXXOXOOXXXOXOXOXXOOXOOOOXOOOOXXXOXXOXOOOOOOOOOOOOOOOXXOOXOOOOX
XOOXOOOXXXXOXXXXOOOXOXOXOOOOOOOOXOOXOOXXXOOOOOOXOOXOOOOOOOOXOOOOOOOOXOXOOOOXOOOOOOOOOOOXOOOOOOOXXXXOX
