OXOOOOOOOXOXOXXOXOOOOOOOOOXOOXOOOOOXOOOOXXOOOXOOOOOOOOOXOOXOXOXOOOOXXXOOOOXOOOXOOOOXXOXOOOOOOXOXOOXOO
OOOOOXXXOOXOXOOOOXOXOXOXOOOOOOOOOXXXXXOXOOXOOOXOOOXOXOOOXOOOOOXXOXXOOXOOOOXOOOOOOOOOOOXOOOOOOOOOXOXXO
OOOOOOOXOOOOOOOOOOXOOOOOXXOOOOOOXOOXXXXXOOXOOOXXXOOOOOOOOOXXOOXOXOOOOXOOOXOOOOOOOXXOXXOXOOOXXOXOOOOOX
OOXXOXOOOOXOOOXOOXOOXOOXXOOXOOOOXXOXXOXOOOOOOOOOOOOXXOOOOOOXXOOOOOOOOOOOOOXOXXOOOXOOOOXOOOXXXOOOOOOOO
OXOOXXOOOXOOXOXXOOXOOOOOOOOOOOOXOXXXXOXOOOXXOOOOOOOOOOOXOOXOOOOOXOXOOOXXXOOOXOOXOOXXOOOOOXXOXOOOOXXOO
XOOOOOOOOOXOOXOOOXXOOOOXOOOOOOOOOOXOXOOOOOXOOOOOOXOOOXOOOOOOXXOOXOOOOOOOOOOOXOXOOOXOXOXOOOOXXOXXOOXOX
XOOOXXOOOOXOXOOOOXOOXXXOOOOOOXOOOOXOOOOOXXXOOOOOOXOOXOOOOXOOOXOOXOXOXXOOOOOOXOOXOOOOOOOXOOOXOOXOOOOOO
OOOOOOOOXOOOOOOXXOOOOOOOXXXOOOOOXXOOXOOOOOOOOOXOOOOOXOOOOOOOXOOOOOOXOXOOOXXXOOOOOXXXXOOOOOOOXXXXOOOOO
OOOOOOXXXXXOXOOOOXXXXOOXXOOOXOOOOOOXOXOOOOOXOOOXOXOXOXXOXOOOXXOXOXXOOOOOOOOOXOOXOXOOOOXXOOOOOXOOOOXOO
OXOXOXOOXOOOOOOOXOOOXOOXXOOXOOOXOOOOOOOOOXXOOOOOOXOOXOOXOOOXOOOOOOOXOOOXOOOOOOXOOXOXXXOOOXOXXOOXOOOOO
OOOXOOXXOXOXXXOOOOOXOXXOOXOOOOOXOOOOOOOOOOOXOOOOXOOOOOXOOXXOOOOXOXOOOOOOOOOOOOOOOOOOOXXOOOOOOXOOOOOXO
OOOOXOOXXOOOOXOOXOOXXOOOXOOXOOOOOOOXOXOXXXOOOOOXOOOOOOOOXXOOOOOOOOOOOXOXOOOOXOOOOXXOOXOOXXXOOXOOOXOOO
XOOOOOOOXOOXOXXXOOOXXOXXOXOOOXXOOOXOOOOOOXXOOXOOOOOOOOOXOXXOOOOOXOOXXOXXOOOOXOXOXOOXOXOOOOXOOOOOXOOOO
OOOXXOOOOXOOXXOOOOOXXOXXOXXXXOXOOOOOOXOOXXXOXXXOOOXOOOOXXOOOOOOOOOOOOXOOXXOOOOXOOOOOOXXOOOOOOOOOXXOOX
XXOXOOOOOOOXOOXOOXOXXXOOOXOOXXOXOOOXXOXOOXOXOOOXOOOOOOXOOOOOOOOXOXOXXOOXOOOOOOOOOOOOOOOOOOOOXOOXOXXXO
OXOXOOOOOOOXXOOOXOXOOXOOOXOOXOXOOXOOOOOXXOXOOOOOOOOOOXOXOXXOOXOOOOXXXXOXOOOOOOOOOXOOXOOOOOXOOXXXXOOOO
OXOOOOXOOOOXOOOOOOXOOXXXXOOOXOOXXXOOXOXOOOOXOOXXXOXOXXOXOOXOOXXXXOXOOOOOOOXOOOOOXOOOXXOOXOXXXOXOOOXOO
OOXXXXOOOXOOOOOXXXXOOOOXXXXXXOOOOOOOOOXOXXXOOOOXOOOOOOOXXXOXOOOOOXOOXOOOOOOOOOOXOOOOOOOOXOOOOXOOXXOOO
OOOOOOOXXXOOOXOXOOXOXOXOOOOXOXXOOOOXOXOXXOOXOOXOOOOXOOOOOOXXXXOXXOXOOXOXXOXXOOOOXXOXOXOOOXOXOOOXOXOXX
OXXOOOOXXOXOOOOXXXXXOXOXXOXXOXOXOOOXXOOXOOOOXOXOXOOOOOXOOOOOOXXOOOOOOOOOOXOOOOXOOOOOXXOOOOOOOXXOOXOOO
OOOXOOOOOOXOOOOXOOOOXOOOOOOXOOOOOXOXXXXOOOXXOOOOOOOOOOOOXXOOOXOXOOOXOOOOXXOOOOOOOXXOOOXOXOOXOXOOOOOOO
OOXOXXXOOOOOXOXOOXOOXOOOXXXXOOOXOXOOOOOOOXOOXXOXOOOOXOXOOXOOOXOOOXXXOXXOOOOXOXOOXOOOXXOXOOXOXXXOOOXOX
OOOXXOXOXOOXOOXOOOXOXXOXXOOOOXOXOOXOOOOOXOOOOOXOOXXOOOOOOOXOOOOOOXXOXOOOOXOXOOXXXOOOOOOXOXOOOXOOXXXOX
OXOXXOOXOOOXOXOOOOOOXOOOOOOOXOOOOOXXXXOXOOOXOOOOOOOOXXXOOOOOXOOXOOOOOXOOOXOOXXXOOOOXOXOOOXOOOOXXOXOXO
OXOOXXOXXOOXOOOOOOOOXOOXXOOXOXOXOOOOOOOOOOOOXOXOXOOOXOOOOOOXOOOOXOOXOOOOOOOOOXXOOXOOOOOOOXOOOOOXOOOOX
OXOOXXXXOOOOOOOOOOXXXOOXOXOXOOOOOOOOOOOOOOOOXXXOXOOOXXXOOOOOOOOXOOOOOXOOOOOXOOOOOXOOOOXOXXOXOOOOOOOOO
OOOXOXOOOXOOXOOXXXXXOOOOXXOOOOOXOOOOXXXXOOOXXXOOOOOXOXOOOOOOOXXOOOOXXOOOOOOXXOOOOXOOOXOOXOOOOOOOOOXOO
OOOOOXOXOOOOXOXOOOXOOOOOOXXOXOXXXXOOOXOXOOOOXXOOOOXXOOOXOXOOOOOOXOOXOOOOOXOOOOXOOOOXOOOOXXOXXOOOXXXXO
XOOOOOXOOXOXXXOOOXOOOOOOOOOOXOOOOOOOOOOXXXOXOOOOXOXXOXXXOOOOXOOOOXOOOOXOXOOXOOOOOOXOOOOOXOXOXOOXOOOOO
XOOXOXOOOOOOOOXOXOOOOXOXOXOOOXXXOOOXXOXXOXOXOOXOOXOOOXXOOOOOOXOOOOXXOOOXXOXXOOOOOOXXOOOOOOXXOOOOXXOOX
OOXXOOOOOOXXXOOOOOOXOXOXXXXXOXOOOOOOOOOOOXOOOXXXOXOOOOOXOOOOOOOOOXOXOOXXXOOOOOOOOOOOOOXOOXXXOOOOOOOXX
XOOOOOOOXOXXXOOOOXOOOOOOOXOXOOOXOOOOXOXOOXXOOOOOOOOOOXOOOOXXOXXXOOXOOOOXXOOXXOXXXOOXOOOOOOXOXOOOOOOOX
XOOOXOXXOOOOOOXXOOOOXOOOOOXXOXOOOOOOOXXOXOOOOXXOOOOOXXXOOOOOOXOXOOOOOOXOXXXXXOOOOOXOOOOXXOOXOXOXXOOOX
XOOXOXOOOOXXOOXOOOOXOOOOOXOOOXOOOOXOOOOXOXXOXOXOOOOOOOOXOOOOXXOXOOOXOOOOXOOOOOOOXXOXOOOOOOXOXOOOOXOOX
XXOOXXOXOOOOOOXXOOOOXOOOOXXXOOOOXOOXOOOXOOXOOOXOXOOXOXXOOOOOOOXOOXXOXOOOOOOOOOOXOOXOOOXOOXOXOOXOOXOOO
OOOOOOXOOOOOXOXOOOOOXXOOOOOOOXOXOOOOOXXOOXXOXOXXOOXOOXXOOOOOOOOOOXOOXXOXOXOOOOOOXOXOOOOOOOXXOOXOOOOXO
OXOXOXXOOOOOOOOOOOXOOXOXOOOOOOXOOXXOXOOOOOOOOOOXOOXXOOOOOOOOOOXXOXXOXXXOOOOOXXOXOOXXOOOOXOXOOOOOOOXOO
XXOOOOOOOOOXXXOXXOOOOOOOOOOXOOOOOXOOXOXOOOXXXOOOOOOOOOXXOOOOOOOXOOXOOOOOOXOOOXOOOOOOOOXOOOOXOOOOOOXOO
OOOOXOOOOOOOXXXOXOOOOOOOOXOOXOOXOOOOOOXOOOOOXOOOOXOOOXOOOXOOXOXOOOOXOOXXXOXXXOOXOOOXOXOOXXOXOOXOXXOOX
XXOOOOOXOOOXOOOOOOOXXOOOOOXXOOOOOXOOXOXXXOOOOOOOOXOOOOOOXXXOOOXOOOXXXOOOOOOXOOXOOXOXXOOXOOXOXOOOXOOOX
OOOOOOOXOXOOOXOOOXXXOOXOXOOOXOOXOOOOOOOOOXOXOXOXOOOOOOXOOOOXOXXOXXOOXOOOXOXOOOXXOOOOOXOOXXOOOOOOXXOOO
OOOOOOXXXOOOOOOXOXOOOOOOOXOOOXOXXOOOOXXXOOXOOXOOXXXXXXOOOOOOOXOOOOOOOOXXOOOOXOOOOOOOXXOOOXOXOOXOOXXOX
OXOOXXOOOXXOXOOOOOXOOXOOOOOOOOOOXOOOOOOXXXOXOXOOOOOOOOXOOOOOOOOXOOOXOOXOXXXXOOOOOOXOXOXOXOOOOOXXXOXOX
OOOOOOOXXOOOXOXXXXXOXOOOXOOOXOOOOOOOOOXOOOXOXXOOOOOOOOOOXOXOOOOOOOXOXXOXOXOOOXOXOOOXOOOXXXOOOOOOOOXOX
OXOOOXOOOOXOOOXXOOOXXXOXXXOXOOXOXOOOOOXOOXXOOXOOOXOXOOOOOOXOOOOOOOOOOOOOOXOXOOOOOOXXOOOXXXOXXXOOOOOXO
OOXOOOOXOOOOOXOOOXOOOXOOOOXOOOXOOOXOOOXOOXOOXOOOXXOOOXXOOOOOOOOOOXOOOOXOOOXXOOOXOOOXOXOOXXXXOOOOXXOXX
OOOOOOOOOXOOXOOOOOOOXOXXXOXOOOXOOOOXOOOOOOOOOOOOXOOOOXXOOOOOXOOOOOOXOOOXOOOOXXOOOXXOOXXOXXOOOXXOXXOXO
OOXOOOOOOOOXOOOXXXOOOOOOXXOOOOOOOXOOOOOOOOOXXOOOOOOXXOOOOOXXOOOOOOOXOOOXOXOOOOOXOOOOOOOOOOOOOXXOOXOOO
OOOOXOOOOXOXOXOOOOXOOXOXXOXOOOXOXOOOOOOOXXOOOOOXXXXOOOOOOXOXOXOOXOOOOOOOXOOXOOOXXXXOXOXOXXOOOXOOOOOOO
OOOOXOXXOOXOOOOOOOXXOOOOOXOOXOOOOOOOOXOXOOOOXXOOXOOOOOOOOXXXOOOXOOXOOXOOOXOOOOXOOOOOOOXOOOXXXOOOXOOOO
OOXOOOOXOOXXXOOOXOXOXOOOOOOOOOOOOOXOOOXXOXXOXOXOOOOOOOOXOOOOOXOOOXOOXOOXOOOOXOOOOOOOOOOXXOOOOOOXXXOOO
XOOOOOXXOOOOOOXXOXOXOXOXOOXXOXXXOOOOOOOOOOOOOXOOOOOXOOXOXOOXXOOXXOOOOOXXOOOOOOXOXOOOOOXXOOOOOOXOOOOXO
OOOOOOXXOOOOOOXOXXOOOXOOXOXOOOOXXXOOOXOOOOXOOOXOOOOOOXXXOXXOOXOOXOOOOXOXOOOXOOOOXXOOOXOOOOOXXOOOXXOOO
OOOXOOOOOOXOXXXOOXXOXXXOOOOOOXOXOOOOOXOOOXOOOOOXOOOOXOOOXOOOOXXOOXXOXXOOOOXOOXOOOXOXOOOXOXOOXOOOOXOXO
XOOOOOOOOOOOOXOOOOOOXXOOOOOOOOOOOXOXOOOXOOXXOOOXOOOOOOXOXXOOOOXXXOOOXOOOOOOOXXOOOOOOOOOOOOOOOOOOXOXOO
XOOXXOOOOOOOOOOOOOXOOOXXOOOOOOOOOOOXXXOOOOOOOXOOOXXXOXXOXXXXOOOOXOXXXOOXOXOXOOOOOXOOOOOOOOOOOXOXXOOOX
OXOOOXXOOOXOOXXOXOOOOOOOOXOOXXOXOOOXOOOXOXOOOOOXOOOOOOOXOXOOXOOOOOOOXOXOXXOXOOXOOXOOOOXOOOOOXXOXXXXOO
OOXOXOXOXOOOOOOOXOOOOOOOOXOOXXOOXOXOXXOOOOOOXOXXOOOOOXOOOOXXXOOOOOOXOOOOOXOOOXXXXOOOOXOOOXOOOXXXXXOXO
OXOXOOOOXXOOOXXXOOOOOOOXOOXXXOOOOOOOOOXXOXOOXOOXXXOOOOOOOOXOOXOOXXOOXXXXOXOOOXOXXOOXOOOOOOXXOOXOOXOOO
OOOOXOOXXOOOOXXOOXOOXOOXOXOXOXXOOOOOOOXOXOOXOXXOOOOOOXOXOOXXXXOXXXOOXOXOOOOOOOOXOOOOOOOOOOOOOOOOOXOOO
OOOOXOOXOXOOXOOOOOXXOOOXOOOOOXOXXOOXOOOOOOOOOXOOOOXOXXXXOOOOOXOOXOOOXXXOXOOXOXOXOXXXOOOOXOOXXOOOOXOXO
OOOOOXXOXOXOXOOOXXOXOOXXXOOOOOOOOOOOOXOOOOOOOOXXOOOXXOOXOOXXXOOXOXOOOOOOOOOOXOOOXOXOOOOOXOXOOOOOOOOXO
OOOOOOXOXOOOXOXOOOOOOOOOOOOXOXXOXXOOOXOXOOOOXOOXXOOOOXOXOOOXXOOOXXXOOOXOXXXXOOOOXXOOOOOOOOOXOOXOXOOOO
OOOOOXXOOOXOOOOOOXOXOOOOXOOOOOOOXOOXOOOXXOOOXOXOOXOOXOOXOOOXXOOXXOXOXOOXOXXOXXXOXOOXOOOOOXOOOOOOXXOOO
OXOOOOXXOOXXOXOOOXXXOOXOOOOOOOXOOOOOOXOOOOOOXXOOXXOOOOOXOOXXOOOOOOXOOXOXOXOOOOOOXOXOOOOXOXXOXOOOOOOOX
OOOOOOOXOXXXOXXOOOXOOOOXOOOXOOOXOOOXOOOOOOOXOOOOOOOOXOOOOOOOOOOOOOOXOOOXOXOXOOXXOOOOXOXXOOXOOOOXXXOOO
OXXOOXOOXOXOOOOOOXOOOOOOXOOXOXXOOOXOXOXXXXOOOOOOOXXXOOXOOXOOOOXOOOOXXOOOXOOOXOXOOXOOOXOOOOOOXXXOOOOOX
OOXOOOOOOOOOOOOXOOOXOOOOOOXOOOOXXOXXOXXOOOOOOOOXXOOXOXOOOOOOOOOOOOXOOOOXXXOXXOOOOOXOOOOOXOOOOOOOOOOOX
OOXOXOOOOOOOOOOOOOOOOOOXOOOOOOXOOOXXOOXOOOOXXXOXOOXXXOOXXOXOOOOOOXOXOXOOOXXOOOXXXOOXOXOXOOOOOOOOXXOXO
XXOOOOXOOXXOOOXOXOOOXOOOOOXXOOOOXOOOOOOOOOOXOXOOOOOOOXOXXXXXOXOOOOXOXOOOOXOOXOOOOXXOXOOOXXOXOOOXOXOOO
OXOOOOXOXOXOOOOXOXOXOXXXOOOOOXOXOOOOOXXOXOXOOOXXOOOOOOXOOOOOOOXOOOXOXXOOXOOOOOOOOXOOOOXOOOOOOXOOOOOOO
XOXOXOOXXOXOOOXOXOOXOOOXOOXOXXXXXXOOOOOOXOOOOOXXOOOOOOOOOOOXXOOXXXOXOXXOXOXOOXOOOXOOOOXOOXXOXOOOXOOOO
OOOXXOXOXOOOOOOOXOXOOOXOOOOXOXXXXOOOOXOXOOOOOXOOOXOXXOOOOOOOXOOXXXOOOOOOOOOXOOOOOXOOOOOOOXXXOOXXXXOXX
OOOOOOOXOOOOOOOOOOXOOOOOXXXOOXOOXOXOOOOOOXXXXXOOOXXXOOOOOOOXXOOOOOOOOXXOOOOOOXOOOOOOXOXOXOOXXOXOOOOOO
OOXOOXOXXOXOOOOOOOOOOOOOOOOXOXOOOOXOOXOOOXOXOOOOOXXOXOOOXOOXXOOOOOOXOOXOOOOOOOOOXOXOOOXOXOXOOOXOOOOOO
OOOXOOOXXOOOOOOOXOOOXXOOOXOOOXOOOOOOOOOXXOOXXOOOOXXOOOOOOOOXOXOOXOOOXOXOOOOXOOOXOOXOOOOOXOOOXOOOXXOOO
OOOOOXXOOOXXOXXXOOOXXOOOOOOOXXXOOOOXOOXOXOXOOXOXOXOXOOOOOOXOOOXXXOOOXOXOXOOOOOOOXOOOOOXOOXOOXOOOXXXXX
OOOXXOOOXXXOXOOXXOOOXXOXXOOOOOOXOOOOOOOXXXOXOXOXOOOOOOOOOXOXXOOOOOOOOXXXXOXOOXOXOXXOOOOOOOXOOOOOOOXOO
XOOOXXOOOOOOOOOOOOOXOOXOOOXXOOOOOOOXOOXOOOOOOOOXOXOXOOXXXXOXOXXOOOOOOXOOOOOOXOOOXXXOOXOXXOOOXXOOOOOOX
OOOOOOOOOXOOXOOOOOOOOXXXOOXOOOOOOOOOOOOOXOOOXOOOOXOOXOOOOXOXXOXOOOOOXXOOXOXOOOOOOOXXXOOXOOOOOOOOOOXOO
OOOXOOOOOOOOOOXXOXOOOOOXOOOOOOOOOOXOOOXXXOXOXOOOOOXOXOOOOOOOOXOOXOXXOXOOOXOOOOOXXOOOOXXOOOOOOOOOXOXOO
XOOOXXOXOOXOOXOOXOXOOXOXOOOOXXOXOOOXOXOOOOOOOOOOOOXXOOOOOOOOOXXOOXOOOOOOOOXXOXOOXOOOXOOOOOXXXXXXOOOXX
OOOOOOOOOXOOOOXXOXOOOOXXXOXXXOOOXOOOXOOOOOOXOOXXOOOOOOOOOOOOXOXOXOOXXOXOOOXOXOOOOOOXXOOOXXOOOOXXOOXXO
OOXOOOXOOOOOOOXXXOXOOXOOOOXOOOXOXXOOOOXOXOOOXOXOXOXOXOOOXXOOXOOXOXOOOXOOOXOOOXXOXOXXOOOOXOOOOOOXXXOOX
OOOOOXOOOOOOOOOOOXXOXOOXOOXXXOOOOXXOXXOOOOOXOOOOOOOOOOOXOOXOXOXOXOXOXXXXOOXXOOOOXOOXOOOOOOOOOOOOOOOXX
OOXOOXXXXOOXOOOOOOXOOOOOOXOXXOXOOXXOOOXOXXXXXOOXOOOOOOOOOOXOOOOXOOXOXOOXOOXOOOOXOOOOOOXOOOOXOXXXOXOOX
OOOOXOOOOOXXOOXOOOOOXOXOXOOOXXXOOOOOOXOOOOOOOOOOOXOOOOOOOOOOXXXOOOOXXOOXXOOOXOOOOXOOOOOOXOOOOOOXOXOOX
OOOOOXOXOOOOOXXOXOXXOOOOOOOXXXOOOXOOOXOOOXOXOOXOXXOOXOOOOXXOOOXOOXOXXOOXXOXOOXOOOXOOOOOOXOOXOOOOOOOOO
XXOOOXOOXXOOOXOOXOOOOXOOOXXOOXXOOOXXOOXOOOOXXXXOOXOOOOOXXXXOOOXOXOXXOOOOOXOOXOOOXOXOOXXOOXOXXOOXOOOOO
OOXOOOOXOXXOOOOOXXOOXOOOOOOXXXOOOXOOOOXXOOOOOXXXXOOXOOOOOOOOOOOOOXOOOOOXOOXXXOXXXOOXXOOXOOOOOOOOXOOOO
OOOOXXOOOOOOOOOOXOOOOOOOOOOOOXXOXOOOXOOOOXOXOXOOOOOOOXOOOOOOXOOXOOOXOXOXOXOOOOXOOOOXOXXOOOOOXOOOOOOOX
OOXOOOOXOOXOOOOOOXOOXXOOOXOXXOXOOXOOXOXOOXOXOOOOXOXOXXOOOXOXXOOXOOOOOXOOOOXOOXOOOXOOXOOXOOXXOXOOOOOOO
OXOXOOOXXOOOOXXXOXOOOOOOXOOOOOOOOXOOOOOOXOOOOOXOXOOOOOXXOOXOOXOOOOOXOOOOXOOXOXXOOOOOXOOXXOOOOOXOOOOOO
OOOOXOOOOOOOXXOXOOOXXOXOOOXXOOXOOOXXOOOOOXOOOOXOOXOXOXOOXOOXOOOOXOXOOOXOOOOOOOXXOXOOOXOOXOXOXOOOXOXOO
OOOOOOOXOOOOXXOXOXOXOOOOOOOOOOOOOOXOOOOOOXOXOOOOXOXOOOOOXOXOXOXOOXOXXXOOOOOOOOXOOOOOXOOOOXOOOOOXXXOXX
OOXOXOXOXOOOXXOXXOOOOOOXXOOOOOOOOOOOOOXOXOOXOOOXOOXOOOOOXXXXOOXOXOOOOOOOOXOOOOXXOXXOXOOOOXXOOOOXOOXXO
OOOXOOOOOOOOOOXOOOOXOOOXXOOOOOOOOOOOOXOOOXXXXOXXOOOOOOOOXOOOXXXXOOXOOOOOXOXXOOXOOXOXXOXOOOOOOOOOOXXOO
OXOOOXXOXOOOOXOOOOXOOOOOXOXXOOOOXXOOOOOXXXOOOXOOOOXXOOOOXOOOXOOXXOOOXOXOXOXOOOXOOXOOOOOOOXXOOOOXOXOOO
XOXXXXXXOXOXXOOOOOOOOXOOXOXOOOOOXXXOOOXOOXOXOOXOOOXXOOOOOOOOOOOOOOXOOXXOOXOOOXOOOOOOOXXXXOOOOOOOOOOOO
OXOOOXOXXXOOOOOXOOOXOOOOOOOOOOOXOOOOOXOOOOOOOOXXOOXOOOOOOXOOOOOXOOXXOXXXXXOOXOOOOOOOOOOXOOXXOXXOXOXOX
OOOOXXXXOOXOXOXOXOOOXOXOOOXOOOXOXXOOOXOOXOOOOOOXXXXOOOOOOOOOOOXXOXOXXXXXOXOXOOOOOXOOOOXXXOOOOOOXOOOOO
