OXOOOXOOOOOOXOOXOOXXOOXXXOOXOXXOOOOXOXOOOOOXOOXOOXOOOOXXOOXXOOOOXOOXOOOXOXOXXOOOOOOOOOXXOOOOOOOXOOOXX
OOOOOXOOOXOOOOXXXOOOXOOOXXOXOOXOXXOOXXOOXOOOOXOOOOXOXOXOOOOXOOOOXXXXOOXOOXOXOOOOXOOOOOOOOOOOXOXXXXOOO
OOOXOOOOXOOOOOOOOOOOOXXXOXOOOXXOOOOOXXOOOOOOOOOOXOXXOOXOOXXOXOOOOXXXOOOXXOOOXOOOXOOOOOXOOXOOXOOXOOXOO
OOOOOOXXXXXOOOXXXOOXXXOOOOXXXOOXOXXOXOXOXOOOOOXXOOXOOXXOOOOOXOXXOOOOOOOOOXXOOOOOXOXXOOOOOOOXOOOOOOOXO
OOOXXOOXXXXOOOOOOXOOOOOOXOXXOOOOOOOOXXXOOOXXOOOOOOOXXXOOOOOOOOOOOXOXXOOOXOOOXOXOOOOOXOOOXOOOOOXXOOOOX
OXOOOXOOXOOOXOOOOXOOOOOOOOOOOOOOOOXXOXOOOXXOXOOXOOXXXOOOXOOXXOOXXOOXOOOOOOOOXOOOOXXXOXOXOOOOOOOOOOOOX
OXOOOOOOXOOXOOOOOXXXXXOXOOOXOOOXOOOOOXOOOOXOXXXOXOXOOOOOXOOXOXOXOOOXOXOOOOOOXOOOOOXOOXOOOOOOOOOOOOOXO
OOOXOOXOOOOXOOOXOXOOOOOOOOOOXOXOXOOXOXOXOOOOOOOOOXOOOOOOOOXOXOOXOOOXOXXXXOOOOOOOOOOOXOXXXOOOXXOOXXOOO
XOXOOOOXOOOOXOOXOOXOXXOXOXOXXOXOXOOOOOOOXXOOOXXXXOXXOOOOXXOOOOOOXXOOOXOOOOXOOOOXOXOXOXXOXOOXOOOXXXOOX
OXOOXOOXOOOOOOOOOXOOOOXOXOOOOOOOOXOOXOXOOXOOXOOOXXOOXXOOXOOXOOOOOOXOOXOOOOXXXOOOXXOOOOXXOOOOOOXOOXXOO
XXOOOXOXOOOOXOOOXOOXXOXOXXXOOOOOOXOOOOOXXOXOXOOOXXOXXOXOOXXOOOOOOXXXOOXOOXXOXOOXOXXXXOXOXOOOOOOOOOOOO
OOOOOOOOOOOOOOOOOOOOXXXOOOOXOXOOXXXXXOXOOOOOOOOOOXOOXOOXXXOOOOXOXOOXOOXXOOOOOOOXOOOXOOOOOXOOXOOOXOOOO
OOOXXXOXOOOXOOOXOOXXOOOOOXOXOXOOXOXOOOOOOOXOXOXOOOXOXOXXOOOXXXOOOOOOOOOOOOOOOOOXOOOOOOOOOXOXOXOOXXOOX
OXOXOOOXOXOXOXXOOOOOOXOOOXOOOOOXOXOOXXOOXXOOOOOOOOOOOXXOOOOOOOOOXXOOOOOXOOXOOOOXOOOOXXXOXOOXOXOOXOOOO
XOOXXXXXXOOOOOOOOXOXOOXOOOOXOOOOOOOOOOOOOOXOXOOOOXXOXOOOXOOOOOOOOOOOOOOXOOOOXOXOXOXOOOXOOOXOOXOOXOXOX
OOOXOXOOOXXXOOOXXOOOXOOOXXOOOOOOOOXXXXOOOOOXOXXXOXXOXOOOOXXOOOOOOOXOOOOXOOOXOOOXXOOOOOOOOOOOOOOXOOOXO
OOXOOOOOXOXOOOOXOXOOOOXOOOXOOXXXXXOXOOOOOOOOXXOXOOOOOOOXOXOOOOXOOOOOXOOXOOOOOXOOXOOOXOOOOOXOOOOXOXOOO
XOOXXOXOOOOOOXOOOOOOOOOXXOXOOOOXXXOOOXXOOXOOOXXOOOXOOOXOOXOOXOOOOOXOXOXOXOOOXOOOOOOOOOOOXOOOOXOOOOXOX
OOOOOOXOOXOOOOOOOXXXOOOXOXOOOXOOOOOOXXOOXOOXOOOOXXOOOXOOOOOOOOXOXXOXOOOOOOOOOOOXOOOOXOOOXXXOXOOOOOOXO
OOOOOOXXXXOXOOOXOXOXOOXOXXOXOOXOXOOOXOOOOOOOOOOOOXOOXOOXOOXOOOOOOXOOOXXOXOXOOOOOOOXOOOOOXOOOOOOXOXXXO
XOOXOOOOOXOOXOXOXOOOXOOOOXXOXXXOXOOXOXOOOOOOXOOOOOXOOOXOOXXXXOOOOOOOXOXOOOXOXOXOOOOOXOOOOOOXXXXOOXOOX
OOXOXOOXOOOOOOOOOOOOOOOOOXOOOOOXOOOOOOOXXOXOOOOXXOOOOOOOOOOOOOXOXOOXOXXOOOOOOXOOOOOXXOOOOOOOOOXOOOXXO
XOXOOOOXOOOXOOOXOOOOOOXOOOOOXXXOOOOOOOOOOOOXOOXOOOOXOOXOOOOOOOXXOOXOOOOOOOOXXXOXXXOOOOXOOOOOOOOOOOXXO
OOOOOOOOXXOXXXOOOXOOOXXOOXOXOXOOOXXOXOOXXOOOXOOOOOOXOOXOOOXOOOXXXOXOOXOOOOXOXOXOXXOXOOOOXXOXXOOOOOXOO
OOOOOOOOXOOXOOOOOOOXOOOOOXOOOOOOXOOOXOOOOOOXOOOXOXOOOOXOOOOOOXOOOOOOOOXOOOXOOOOOOOXOXOOOXXOOXOOOXOOXO
OOOXXXOOOOOXOXOXXOOXOOOOOOOOXOOOOOOXOOOXOXOOXOOOXOOOXXXOOXOOOOXXXOXOOOXOOXXOXXXOOOOXOXXOOOOOXXOOOXOXO
OXOOXOOOOOOOXOOOOOOOOXOOOOOOOOOOOOXXXXXOXXXXOOXOXOXXOXOOOOXOOXOOOOXOOOOOOXOOOOXXXOOOXOXOOOOXOOOOOOXOX
XOOXXOOOXOXOOOOXOOXOOOOXXXXXXXOOOOXOOXOXOXOOOOXOOOOXXXOXOOOOOOOXOOOOOOXXOOOOOXOXOOOOOOOXOXXOXOOXOOOOO
OXOOOXOOXOXXOOOXOOXXOOOOOOOOOOOXOOOXOXOXOOOOXXOXOOOXOOOOOOXXOOXXOXOXOOOOOOXOOOXOXXOOOOOOXOXOOXOOOOOOO
XOXXOOXOXOXXOOOXOXXXOOOOOOOOOOXOOOOOXOOOOOXOOOOOOOOOOOXOXXXXOOXOXOXOXOOOOOXXOOXXXOOOOOXOOOXOOOOXOOOXX
OOXOOXOXXXOXOOXOOXXOOOXXOXOXXOOXOOXOXOOOOOOOOOXOXOOOOOOOOOOOXXOOXOOOOOOXOXOOXOOOXOOOXOOXOXXXOOXOXXOOO
XOOOOOOXXXXOOOXOOOOOOXOXOOOXOXOXOOOXOOOXXOXXOOOOOOOOOOOOOOOXXOOOXXOOOOOOOXOOXOOOOXOOOOOOOXOXOOXOOXOOX
OOOXOXOXXOOOOOOOOOOOOXOOOXXOOOOOOXOOOOXXOXXOOOOXXOOXXXXXOOXOOXXOOOOOXOOXOOXOOOOOOOOXOOOXOOOXOXXOOOOOO
OOXOOOOOOOOOOOOXXOXOXOOXOXOOOOOXXOOOXOOXOOOOOOXOOOOOOOOXOOOXOXXXXOOXOOOOOXXOOOOOXXXOXXOXXXOOOOOOXOOOO
OOXOOXOOOXOOOXOOXXOOOOOOXXXXOOXOOOOXOOXOOXOOOOXOOOOOXOOXXOXOOXXOOOOXOOOXOOOXOOOOOXXXOOOOOXOXOOXOXOOXX
OOOOOOOOOOOXOOOXXXOOOOXXOXXOOXOOXOOOOXOOOOXXOOOOOOXOOOXOXOXOOXOOXXXOOXOXXOOOOXOOOOOXOOXXXXOOOOOOOOOOX
OXOOOXOOOOXOOXOXOOXOOOXXXOOXXOXXOOOXOOOOOOXOOOOOOXOOXOOOOOXXOOOOXOOOXOOOOOXOOXOOXOOXXOOXOOOXXOXXOOXXX
OOXOOOOXOXOOOOXXOOXXOXXXXOOOXOOOXOXOOOOOXOOXOOXOOOOOXXXOOOOXOOXOOXOXOOXOOOXOOOXOOOOXXXXXOOOOOOXOOOXOO
XOOOOOOOOOOOOOOOXOXOOOXOXOOXXOOXOXXOOOOOOXOOXXOOOXOXOOOXOOOOOOOOOOOOOOOOOOXOOXOOXXOXXOOOOOOOXOOOOXOOX
OOOOOOXOXOXOXOXXOXOOOOOOOOOOXOOOOOOOOOOOXOOXOOXXOXOXOOXOOOOOXOOOOOXOXOOOXOXXOOOXOOXOXOOOXXOOOOOXOOOOX
OXXOOXOOOXOOOXOOXXOOOOOOOXOOOOOOOXXXOXOXXOXOXOOOOOOXOOXOOXXOOOOOOOOOXXOXOXXOOXOOXXOOOOOOOXOOOOOOOOOOO
XOXXOOOOOOOXXOXOXOOOXOOOOXOOOOOOOOOXOXOXOOOXOOOOOOXOOOXXXOOOOOOOOOXXOOOXOOOOXXOOOOOOOOXOOOXOXXOOXOOXO
OXXOXXXOOOOOOXOXXOOOOXXXOOOOOOOXXOOXOXXOOOOOXOXXOOOOOOOXOXOXOOXXOOOXOOXOOOOOOOXOOXXOXXOXOXOOOOOOOOOXX
OXXOOXOOOOOOXOOXOOOOOOOOOOXXXOOOOXXXOOOOOOOOXOOOXOOOXXXOOOXOXOXOOXOOOOXOOOOOOOOXXOOXOXOXXOXOOXOOXOOXO
OXOOOOOXOOXOOXOOOOOXOOXXOOXOOOXOOOXOOXOOOOOOOOOOOXOOOOXXOOOOXXXOOOOOOXXOOXXOXOOXXOOOOOXOOOXXXOXOOOXOO
OXOOOXXOOOXXOOOXOOXOOOOOOOOOXOOOXOOXXOOOOXXXXXOOOOOOOXXOOOOOOOOOOOOOOOOOOOXXOOOOOOOOXXOOOOOOOOOOXXOOO
OOOOOOXOOOOOXOXOOXXOOOOOOOOXXOOOXXOOOXXOXOOOOOOOOOOOOOOXOOOOOOXOOOOOOXXOOXXOOOOOOXOOOOXOXXOOOOXXXOXXO
OOOOOXOOOOXOXXOXXOOOXOOXXXOOOXXOOOXOOOOOXOOOOOOXXOOOOOXXXOXOOOXOXOOOXOXOOOOXOXXXXOOOOOXXOXOOOOXOXXOOO
OOOXXOOOOOXOXOOXXOXOOOOOXOOOOOOOXOOOXXXOOOOOOOXXOOOOXOOOOOOOXOOOXOOOOXOOOOOXOOOOXXOOOOXOXOXOXXOXOXOOO
XOOOOXOOOOOOOXOOOOOOOOOOOOOOOOOXXOXOXXOXOXOOOOOOOXOXOOOOXOXXOOOOOXXOXOXOOOOOOOOOXOOXOXOOOOXOOOOOOXOXO
OOXOXOXOOXOXOOOOXXXXOOOOOOXOOOOXOOOOOOOOXOOOXOOOXOOXOXOOOXOXOOOOXXOXOOXOOXOXOOXOXOOXOOXOOOOOOXOOOOXOO
OOOXOXOXXOOXOOOOOOOXOXOOXOOOOOOOOOXOXXXOXOOOXXOOOOOXOOOXOOOOOOOOOOXOOOOOOOOOXOOOOXOXOXXOXOXXOOOOOOOOX
OOOOOOXOXOOOOXOOXOXOOOXXOXOOOXOXOXOOOOXOOOOXOXOOOOOXXXOXXOOOXOOOOOOXOOXXOOXOOXOXXXXOOOOOXOOOXOOXOOOOO
OOOOXXXOOOXOOOXXOOOXXOOOOOXXXXOOOXXOOXOOOOOOOOOOXXOOOOOOXOXOXXOXOXOXOOXXOOOOOOXOOOXXXXXXXOOXOXXOOOOXO
OXXXOOOOOOOOOOOOOOXOOOXOXOOOOOOOOOOXOXOXOOXXOXOOXOXOOOOOOXOOXOOOOOOOOOXXOOXOOOOXOOOOOOXOOOOOOOOOOOXOX
OOOOOOOOOXOOXXXXXOXOXOXOXOOOOOOXOOOXXOOOOOOOXXXOOXXXXOOOOOOXOOOOOOXOOXOOXOOOXOOOXXXOOXOXOXOOXXOOXXOXO
OOOOOOOXOOXOOOOOOXOOOOOOOOXXOOXOXXOOOXXXXOOOOOOOOOOOOXOOXOOOOXXOOXXOXXXOXXXOXOOOOOXOOOOOOOXOXXOOOOOXO
OOOOOOOOOOOOOXOOOXXOOOOXOXXOXOOOXXOXXOOOXOXOOOOOOOOOOOOOOOOXXXOOOOOOOOOOOOXOOOOOOXXOOOOXXOOOOXOOOOOOX
OOXXOXXXOOXOOOOOXOOXOXOOXOXXXOOOXOXOXOOOXOOOOOOXOXOOOOOOXOOOOOXOOOXOXOOOXXOOOXOOXOOOXOOXXXOXOXXOOOXOX
OOOOXXOOOOXOOXXXOXOXOOXOXOOXOXOXOOXOXOOOXOOOOOXOXOXXOXOXXOXOXXOXOXXXOOXOOXOXOOOOOOOOXXXOXOOOOOOOOXOXO
OOXOOXOXOOOOOOOXOOOOOOOXOOOOOOOXOOXOOOOXOOOOOOOOXOOOOOXXOOOOOXOXOOOOOXOXXOXXXOOOOOOXOXOXOOXOOOOOXOOOO
OOXOXOXXOXXOOOOOXOXOOXOOOOXOXXOOOOXOOXOOXOOXXOOOOOXXXXXOXOXOOXXXXOXOOOOXOOOOXXXOOXOOOOOXXXXXOOOOOXOXX
XOXOOOOXOXOOOOOXXOOOOXOOOOOOOOOXOOXOXOXOOOXOOOOOOXOXOOOXOOOOOXOXOOXOOOOOOXOOOXOOOOOXXXXOXXOOXOOOOOOOO
XOOXXOOOXXXXOXXOOOXXOOOOXOOOOOOXXOXOOOXXOOOOOXOOOXOOOOOXOXOOXOXOOOOOXOOXOXOOOOOOXOOXOXXOOOOOOXXOXXOOO
XOOOOOOOOXXOOOOOXXXOOOOOOOOOOXOOOXOOOOXOOOOOXOOOOOOOXXXOOOXXOOOXOOOOXXOOOOOOOXOXOOOOOOOOOOXXOOOXOOOXO
OOXOOOOXOOXXOOOOOXOOOXXOOOOXOOOOXOOOXOOOOOOOXOOOOXOOOOOOOXXOOXXOOOXOXOOOOXOOXOOOOXOXOOOXOOOXXXOOOXOOO
OOOOOOXXOOXXOOXXXOOOOOOOXXOOXOOOOOXOOOOOOOXXOXOOOOOOOOOXOXOOOOOXOXOXOXOOOOOOOOOOXXXOOOOOOOOOOOOOOXXOX
OOOOXXOOXOXOOOOOOOOOOOOOXOOXOOXOOXOOOOOOOOOOXOOOOOOOOXXOOOXOXOOOOOOOXOOOOOOOOOXXOOXXOOOOOOXOXOOXOOXXO
OXOXXOXOOOOOOXXXXOXXOOOOXXOOOOXOOOXOOOOOXOOOOOXOOOOOXOOOOOOXXOOOOOOOOXXOOXXOOOXOXXXOOOOOXXOOXOOXXOOXX
OXOXOXXXOOXXOOOXOOOOOOOOOXXOOOOOOOOOOOOOXXOOOOOOOOOOOOOOXXXXXOXOOOOOXOXOXXOXOOOXOXXOOXOXOOXOOOOXOOOOX
OOXXOXOOOOOOXOXOXXOOXOOXOOXOXOOOOXOOOOOXOOOXOXOXXOOOOOOXOXXOOOOXOXOXOOXOXOXOOOOOOOOXXOOXOOOOOXOXOOXOO
OOOOOOOOOOOOOXXOOXOOOOOOOXOOXOOXOOOOOOXOXOXOXOXOOOOXOOOOOOXXOOOOXOOXOOOOOXOOOOOOXOOOXOOOOXOOOOOOXXOXX
OOOXOXXOOOOXXOOXOXOXOOXOOOOXOOOOXOXOOXOOOXXXXXXOOOOOOXOXXXOOOOOOXOOOOOOOOOXOXOOOOOOXOOOOOOOOOOOOXOOXX
OXOXXXOOXOOXOXXOOOOXXOOOOOOOOOOOOXXOOOOOOOOOOOOOOOXOOOOXXOXXXXXOOOXOXOXOOOXXOXXXOOOOOOOOXOOOOOOXXOOOO
OOXOOOOXOOXOOOOXOXOOOOOXOXXOXOXOOOOXXOOOOXOXOOOOXOOOOOOOOOOOXOOOOOXOOOOXOOOXOOOOXOXOOOXOOOOXOXXOOOOXO
OXOOOOOXXOOXOXOXOOOOOXOOOOOXXOOOOOXXOOOOOOOXOXXOOOOXXXOXOXXOOXXOOXOOOOXOOXOXXOOOOOXXOXOOOOOOXOOOOOOOO
OOXOOOOOOOXOOOOOOXOOXOOXOOXOOXXOOOOXXXOOXXOOOOOOXOOXOOXOOOXOOOOXOOXOOOXOXXOXOOOOOXXOOOOOOOOOOOXOOOOOO
OXOOOOOOOOOOOOOOXOXXOXXXOOXOXXXOOXOOOXOOXOOOOOXOOXXOOOOOOOOOXOXOXOOOOOOOOXXXXOOOXXXOOOXOOOOOOOXXOOXXO
XOXOOOXOXOOOOXXXOOXOXOXXOOXXOOOXOOXOOOOOXOXXOXXOXOXXXXOOOXOXXOXOXOXOOOOOOOOOXOXOOOOOXOOOXOOOOXXXOXOOO
XXXOOOXXOOOOXOOOOOOOOOOXOOOXOOOXOXOOOOOXOXOOOXOOOOXOXOOOOOXOXOXXXOOXOXOXOOXOOXXXXOOOOOOOXXOXOOOXOOXXO
OXXOOOXOOXOOXOOXXOOOOOOOOOXOOXOOOOOOOXOXOOOOXOOOOOOXXXXOOXOXXXOXOOOXOXOOXXOOOOXOXOXXOXOXOOOOXXXXOXOXO
OOOOOOOXOXXXOOXOOXXOOOXXXOOOXOOXXOOOOOOOXOXXOXOXOOOOXXXXOXOXOOOXOOXOOOXXOOOOXOOOOOOXOOOOOOXOXOXOOOOOX
OOXOOOXXOOOOXOXOOOOXOOXXOOOOXOOXOOOXOOOXOXOOOOXXOOOOOOOOOOOOXOXOXOOXOOXOXOXOXOXXOOXXXOOOOOOOXXXXXXXXX
XOOXOXOOOXOOXOOOOOXXXOOXOXXOXXOXOOXXOXXXOOOOOOXOOOOXXOXOOXOOOOOOOOXOOXOOXXOXXOOXOOOOXOOXOXOOOOOOXOOOO
OOOOOOXOXOOXXOOOXOOXOXXOOOOOXOXOOOXOOOXOOOOOOOOXOOOOOXOOOOOOOOXXOOOXXOOOXOOOOOOOOOOOXXXOOOOOXOOOXOOOO
OXXOOOXOXXXOXXOOOXOOXOOXXXOXXXOXOOOXOXXXOOXXOOOOOOXOOOXOXOOXOOOOOOXOXXOOOOOOOXOOOOOOOOOOXXOXXOOXXXOOO
OXOOOOOOOOXOXOXOOOOOOXOOOOOOOOOOOXOOOOOOOXOOOXOOOOOOOOOOOOOOOOOOOOOOOXOOOOOXOXOOOOXXXOOOOOOOOOOOOOXOO
XOXOOXOXOXXXOOXOOXOOOOXOXXOXXOOOXOOOOOOOOOOOOOOXOOXXXXXOOOXXOOOOXOOOOXOXOOXOOOXXXXOXXOOOXOOOOXOOXOOOO
OXOOOOOXOOXOOOXOXOOOOOOXOOOXXOXXOOOXOXOOOOOOXOOOXXOXXOOOOOOXXOOXOOXOXOOXOXXOOXOOOOOOOXOOOXOOOOXOOOOOX
OXXOOXXOXOXOXXOOOXXXOXOXOOOXOOOXOXOOXXOOOXOOXOXOOXXXOXXOOOOXOOOOOXOOOOOXXXOOOOOOOXOOXOOXOOXXOOOOOXOOO
OOOXOOXOOXOXXXOOXOOOOOOXOOXOOOOOOXOOOOOXOOOOXXOOOOXOXOOOOOXOXXOXXOOXOOOOXXXOOXXOXOXXOXOOOOOOXOOOOXXOO
OXOXOXOOOOOOOOOOOOXXOXOOXXOOOOXOOXOOXXXOOOOOOXOXOOOXXXOOOOXOXOXOOOOXOOOOOXOOOXXOOOOOOOXXOXOOXOXOXXOOO
OOOOXOOOOXOOOOOXXOOOXOOOOOOOOOXOOOOXOOXOXOOOOOOXOOOOOOOOXOOOOXOOXOXOOXXOXOXXOXXXOXOXXOOOOOOOOXOOXXOXO
XOOOOOOOOXOOOOOOXXOOOOOXOXXOOOOOXOXOOOXXOOOOOOOOXOOOOXOOOXOOOOOOOOOXOOXXOOOOOOOOOOXXOXOXXOOOXXXOXOXOO
XXOOOOOXOOOXOOXOXOOXOOOOOXOOOOOOXXOXOOOOXXXOOOOOOOOOXOOXOOXOOXOXOOOOXOOOOOOOOXOXXOOOOOOOOOOOXXOOXOOXO
XOOOOXOOOOXOXOOOOOXOXOOXXOOOOOXXOXOOXOOXXOOOOOXOXOXXOOOOOXXXOOXXXXXOOOOXOOOOOXOXOXOOXOOXOOOOXOOOOOOOO
OOOXXXXOOOXOXOOXXXXOXOOOOOOOXXXOXXOOXOXXOOOOXXOOOOOXOXXXOXXXOXOXOOXOXOOOXXOOOXXXXOOXOOOOOXOOOOOXOOOXO
OOOOXOOXXXOOXXOOXOXOOXOXOOOOOOOOOOXXXOXXOXOOOOOOOOOOOXOOOOOOOXOOXXOOOOOOOOOOXOOOXXOOOOOOOOOOOXOOOXXOX
OOOXOXOXXOOOXOXOOXOOOXXXOXOXOOOXXXOXOOOOXOXOOOOXOOOXOOXXOOXOXXXOOOXOOXOOOOOOXOOXOXOOOXOOOOOOOOOOOOOXO
OXXXOOXOOOOOOOOOOXOOOOOOXXXOOOXOOOOOOOOOOXOXOXXOOOXOXXOOOXOOOOOXXXOOOOOOXOXXOOOOXXXOOOOOXOOOXXXOOXXXO
OXOOOOOOOOOOXOXXXOOOOOXXOOXOOOOOXOOOXXOOOOXOXXOOXOXOOOOXOOOOXXOOOXOOXXXOOXOOOOOOXXXXOOOOXOXOOOOOOOOOX
