OOOXXXOXOXOOXOXOOOXOXXOOOOOOXOOXOOXOOOOOXOOXOOXOXOOXOOOOOOXOOOOOOOOXOXOXOOOOOXOOOXOXOOOOXXXXOOOOOOOOX
XOXXXOOOOXXXOOOOOOOOOOXOOOOOXXOOOOOOOOXOOXXOOOOOXOOXOOOOOOOOOOOOOOOOOOOXOOOOOOXOOXOOXXOXXOOXXOXOOOOXX
XXXOOOOOOXOOOOOOOOOOXXOOOOXXOXXOOOOXOOOOXOXXXOXXOXXXOXOXOOOOOOOOOOOXOOOXOOOXXOOXOOOOOOXOXOOOOOXOOXOOO
OOXOOXOOOOXOOXOOXOOOOXXOOOOOXOOXOXOOXXXOXXOOOOXOOOOOXOXOOOXOOOOOOOOOOOOOOXXXOOOOOOOOOOOOOOXOOOOOOOOOX
XOOXOOOOOOXOOOOOOOXOOOOOOOOOXOOOOXOOOOOXOOOXXXXXOXXOXXOOOXXOXOOOOOOOOOOOOXOXXXOOOOOOOOOXOOOXXOOOOOXOO
OOXXOOOOOOOOXXOOOOXXOOXOOOOOOOXOOOOOOXOXOOXXOOOXOOOOOOOXOOXXOOOOOOOXOOXXOXXOOOOXOOXOOXXXOOOOOXOOOOOOX
XOOOXOXXOOOOOOOOOOOOXOOOOXOOOXOOXXXOXXXOOXOXOOXOXOXOXOOOXOOOXOOXXOXOOXOOXXOOOOOOOXOXXOOOXOOXOOOOOXOOO
OOOOOOOOOOXOOOOOXOOOOOXOOXOOOXXXOOOOOOOOOOOXXOOOOOOOOXOOXOXXOXOXOOOXOXOOOOXXOOXXXOOXOXOOOXXOXXOXOOOOO
OXOOXOXOXXXOOXOXOOOXXOOOOOOOOXOOOOOOOXOXOOOOOOOOOOOOOOXXXOOOOOOOOOXXOOXXXOOOOXXOOXOXOOOXXOOOOOXOOXOOO
XXOOXOOXXXOOXXOOOOXXOXOOXOXOXXXOOOOOOXOOOOOOOOOOXOOXOOOXOOOOOOOXXOOXXOOXOOOOOXXXXXOOXOOOXOXOOOXXOOOOX
XOXOXOOOOOOXOOXOXOOXOOXOOXOOOOOXOXOXOXOOOXOOOXOOOOOOOOOOOOXXOXOXXOOOOOXXOOOXOOXOOOXXOOXOOXOOOOXOOXXOX
XOOOXOOOXOOOOOXOXOOOOXXXOOXOOXOXOOOOOOOXXXOXOOXOOXOOOOOOXOOXOOOOOOOXOOOOOOOOOOOXXOXOOXOXOOOOOOOXXOXOO
XOXOXOXOXOOOXXOOOOOOOOOOOOOOXXXOXOOOXOOOOXXXOOOOXXOOOOXOXXXOOOXOXOXOOOOOOOOOOXOOOOXOXOOOOOXOOOXXOOOOX
XOOOOXOXOOOXOXXOOOXOOOOOOOXXXOOOXOOOOXOXXXOXOOOXOXOXOOOOOXOOOXXOOXOOXOXXOOOXOOOXXOXOXOOXOOOOOOOXOOOOO
OXXOOXOXOOOXOOOXOXOXOOOXOOOOOOOOOOXOOOOOOXOOOXOXXOOOXOOOXOOOOOOXOOOOOXOOOOOOOXOOOOOOOXXOOOOOXOOOOXXOO
OXXOOOOOOOOOOOXOXOOOXOXOOOOOOOOXXXOOOOOXXOXXOOXOOXOOOOOXXOOXOOOXOXOOOOOXOOOXOOOOOOOOOOXXOOOOOOOOOOXXX
XOOOXOXXXOOOOOXOOXOOOXOOOOOOXXOOOOOXXXOXOOOOOOOOOOXOXOOOOOOXOXOXXOOOXOOOXOXOXXOOOOOOXOOOOOOXOXOOOXXOO
OXOXXXOOOOOXOXOXOOXXOOOXXXOOOOOOOOXOOOOXOOOOOXOOXXOOOOOOOOOOOXXOOXOOXXOOOXOXOXOOOOOOOOOXOOOOOOXOOOOOO
OOOXOOXOOOOXOOOOOOOXXOOXOOOXOOXOOOOOOOXOOOOOOXOOOXOOOXOOXXOOXOOXOOOOOOXOOXXOOOOOOOOOOXOOOOOOOOOOOOOOO
OOOOOOOOOOOOOOOXOXOOOOOOXOOOXOOOOOOOXOOOXXOXOOXOOOOOOOOOOOOOXOXOXOXOOOOOOOOXOXXOOXOOOOOXOXOOOOOXOOOOX
XXXOOOOOOOOOOOXOOXOXOOXOXOXOXOXOXOOOOOOOXOXXOOOOXOOOOOOOOXOOOXOOXXOOXOOXOOXOXOXOOOOOXXOOOXOXOXXOXXOOO
OXOOXOOOOOOOOXXOOOOOOOOOXOOXXXXXOOXXOOXOXXOOOOOOOOOOOXXXOXOXOOXOOOOXXOXXOOOOOOOOXOOOOOXXOOOOXOOOOXOXO
XOOOOOOXXOOOOOOXXOOXOOOXOXOXOXXOXXXOOXXXOOXOOXOOOOOOOOXXOOXOXOOOXOXOXXOXOOXXOOOOOOOOOOOOOOXOOXOOOOXXX
XOXOXOOXOOXXOXXOOXXOOXOOOOOOOXOOOXOXOOXXXOOXOOOOOXOXXXOOOXOOXOXOOOOXOXXOOOOOOOXOXXOXXOXXXOOOXXXOOOOXO
OOOOOOXXXOOOOXOOXOOOOXOOXXXOOOOXOOXXOOOXOXXXOOOXOXOOOOOXOOOOOXOOXXXOOXXOOXOXOOXOOOOXOXOXXOOOOXOXOOXOX
OOXOOOOOXOOOOXOOOOOOOOXOOOOOXOXXOXXOOXXXOXOXOOOOOXOOOOOOXOXXOXOXOXOOXOOXOXXOOOXOOXOOXOOOOOOXXXXOOXOOO
OOXOXXOXOOXOXOOOOOOXOOOOOXOOOXXOOOOOOOOOXOOOXXOOXOOOXOXOXOOOXOXOOOOOXOXOXOXOOOXXXXXXXXXOOOXOOOOXOXOOO
OOXOOOXOOOXOOOXOOOXOOOXOXXOOOXXOXOXOXOXOXOOXOOOOOOOOOOOXXOOOOOXOXOOOOOXOOOOXOXOOXXOOXOXOXOOXOOOXOOOOO
OOOOXOOXXOXOXXXXOOXOOOOOOOXOOOOOXOOOOOXOXOOOXXOXXXOXOOXXXOOOOOOXXOOOOOXOXOOOXOOOXXOXXOOOXOOOXXOOOOXXO
OOOOOXOXOOOOOOOOOOOXOOXOOOXOXOOOOOXOOOXOXOOOOOXXXOOXOXOOOXXOOOXOXOOOOOOOOXOOOOXOOOOOOOOOOOOOOOOOOOOOX
OXOOOOOXOOOXOOXOXXOXOOOOOOOXOOXOOXXOXOOOOOOXOXXOOOOOOOXOOOOOOXOOOXOXOOOOOXOOXOXXOOXOXOOOXXOOOOXOXOOXX
OXOOOOOOOOOOOXXOOOOOXOXOOOOOOOOXOOXXOOXOOXOOOOOXXXOOXXOOOOXXOOXXOOXOXOOOOOXOOOOXXOOOOOOXOXOOOOXXXOOXX
OOOOOOOOOOXOOOOOOXOOOOXXXXOOOOOOOXXOOOOOOOXOOOOOXOOXOOXXOOOXXOOXOOOOOXXOXOXOOOOOOOXOOOOOXOXOXOOXXOOOO
OXOOOOXOXOOXOXOOOOOOXOOXXXXOOXXXOOOXOOOXOOOOOXOOOOXXOOOXOOOOXXXXOOOOOXOOOOOOXXXOXOOXOOOOOXOXOOXOOOOOO
OOXOXOOOXOXOXOXOOXOOXOOXXOOXXOXXXOOOOXOXOOOXOXOOOOOOOOXOOOOOXOXOOOOXOXOOOOOOOOOXOOOOXOOOOXXOXXOOOOOOO
OOOOOOOOXXOOOOXOOOOXXXXOOXOXXXXOOOOOOOOOOOOXXXOXOOOOXOOOOXOOXOOOXOOXOXOXOOOOOOOXXOOOXXOOXOOOOOXOOOOOO
OOOOOOOOXXOOXOOOOXOOXOOOOOOXOXXOOOOXOXOOOOOXOXOOOOOOXXXOOOOOOOOOXXOXXOXOXXXOOOOOXOOOOXXOOOOOOOOXOXXOO
OOOOXOOXOOOOOXXOOOOXOXOXOXOOOXXOOXXOXOXOOOOOOOOXXOOOOOOOOOOOXOOOXOOOOXOOXOOOXOOOOOOOOOOOOOOOOOOXXOXXX
OOOXOOOOOXOOOOOOOXOXOOOXXOOOOXOOOXOXOXOOXOOXOOOOOOOXXOOXOOXXOOOXOXOOOOOOXOOOOXOOOOXOXXXXOXOOXXOOOXXOO
OOOOOOOOOOXXOXOXOXXOOOOXOXOOOOOOOOOXOOXOOXOOOXOXOOOXOXOOOOOOXOXOOOOOOOOXOOOOOOXOOOOXOOOOOXOOOOOXXXOOO
XOOOOOOOXXXOOXOOOOOOOOOOOOXXOOOXOOOOOOOXOXXOOOXXXOOOOXXOXOOOOXOXOOXXXXOXOOOOOOOXOOOOOOOOXOXXXXOOOXOOO
XOOXOOOOOXXOXXOOOXOOOOOOOXOXXOOOXXOOOOXOOOOOOOXOOOXOOOXOXOOXXOOOOOXOXOOOXOOXXOXOOOOOOXOOOXOOXXOOOXOOO
XOOOOOOXOXOOOOXXXOOOOXXOXOOXOXXXXOOOXXXXXXOXXXXOOXXOOOOOOOOOXOOOXOOOOXOXXOOOOOOXOXOOOOOOXOOOOXOOXXOOX
OOOOOXOOOXOOOOXOXXOOOXXXOOOOXOOOXOOXOOOOXOXXOXOOOOOOXXXOOOXOOXOOOOOOXXOOOXXXOOOXOOOXOOOOOOOOXOOXOOOXO
OOOOOXOOXOOOOXOOOOOXOOOOOOOOOOOXOXOOOXXOOOOXXOOOOXOOXOXXXXOOOXOOOOOOOXOOOXOXOOXOOOXOXOOOOOOOXOOOOOOXO
OOOOOOOOOOOXOOOOOOOOOOOOOOXOOOOOOXXOOOXOOXOOOOXOOOOXXOOXOOOOOOOOOOXOOOOOOXXOOOOOOOOOXOXXXXOOOOOOOOOOO
OXOOOXXOXOXOXOXOXOOOOOOXXOXOXOOXXOOOXXOXOOXOOOOOOOOOXOOOXOOOOOOXOOXOOXXXOOXOOOOOOOOOOOOOOOXOOXXOOOOXO
OOXOOOOOOOXXXXOOOXXOOOXOXXXXOXOOOXXOXXOOXOOOXXOOXOXXOOXOOOOOOXOOOOXXXOOOOOOXOOXXOXXXXOXOOOXXOOOOXOOOO
XXXXOXOOOXOXOOOOXXOOOXOOOOOOOOOOOOOOOOOXOOOOOOXOOOXXXOOXOOOOXOXOXOXOOXOOOOXXOOXOXXOOOXOXOOOOOOOOXOOXX
OOOXXOOOXOOOOOOOOOOOXOOXOOOOOOOOXXOOXOOXOOXOOOOXOXOOXOXOOXOOOOOXOOOOXOXOXOOOOXOOXXOOXOOOOOXOOXOOOOXOX
XOOOOOXOOOOOXOXOOOOOOXOXOXXOOXOXOXOOOXXOOXXOXXOOOXOOOOOOOOOOOOOOXOXOOOOXXOXOOOOOXXOXXXOOOOOOOXOOOOOOX
XOOOXOOOOOOXOOXOOOXOOOOXOXOOXOXXOOOXOXXOOXOOOOXOXOOXOXOXOOOOOOOOXOXOOOXOXOOOXOOOOOOXOOOOOOOXXOOXOOOOO
OOOXOOOOXOOXOXOOOXXOOXXOOXXOOXXXOOOXXXOXOOOXOOOXOXXXOOXOOXOOOOOOOOOXOOOOXXXOOOXXOOXOOOXOOOOOXOOOOOXXO
XOXOOOOOXOXOOOOXXOXOOXOXOOOOOOXXOXOOOXOXOXOXOXXOOOOOOOOOXOOOXOXOXXOXOXOOOOOXOXOOOOXOOXOOOOOOOOOOOOOOO
XXOXXOXOXXXXOXOOOOOXOOOOOOOOOOOOOOOOXXXOOXOOOOOOOOXXOOOOOXOOXXOOOOOOXXXOOOOOOXOOOXOXOOOOOOOOOXOOOOXOX
OOOOXOOXOXOOOOXXOOXOOOOOOXOOOOOOOOXOOXOOOXOOXOXXOOOOXOXOOXXOOOOXOXOOOOOOOXOOOXXOOOXOXOOOOOXOOOOOXOOOO
OOXOOOOOOXOOOOOOOOOOOOOXOOOOOXOOOXOXOOXOOOOXOOOOXXOOXOXOXOOXXOXOOOXOOXOOOXOXOOOOOOOXOXOOOOOOXXOXXOOOX
OOOOXXXOOOOOOOOOOOOOOXOXXOOOXXOOOXOOOOXOOOXOOXXXOXXXOOOOXOXOOXOXOOXOOXXOXOXOOOOOXOXOXOOOOOOOOOOOOXOXO
OOXOXXOOXOXOOOOOXOOOXXOXOOXOXOOXXOXOOOOOOOOOXOXOOOOOOOOXOOOOXXXOXXOOOOOOOOOOOXOOOXOOOOOXXOXOOOXOXOOXO
OOOOXXXOOOOOXOOOOOOXXXOOOOXOOXOOXOOOOOOOOXXOXOXXXOOOXOXOOXOOOXOOOOOOOOOOOOXOOOXXOOOOXOOOXOOXXOOOOXOOO
OOOOOOXOXOOOOXOXXOOXOXOOOXXXXXXOOOOOOOOOOOOOOXOOOXOXXOOOOOXOOOOOOOXOXOXXXOOOOOXOOOXXOOOOOOOOOXOOOXXXO
OOOXOXOOOXOXOOOXOOXOOOXOOOOXOOOOOOXXOOXOOOOOOOOOOOOOXXXXXOXOOOOOOOXXOXXOOXOOOOOXXOXOOXOXXXOOOXOOOOXOX
OOOOOOXOXOXOOXXOXOOOXOOXXXOXXOOOOOOXOXOXOOOOOXOOOXOOXOOOOOOOXOOOOOXOOOOOOOXOOOOOOOOXOOXOXOXOOOOOOOOOO
OXOOOXOOOOOOOOXOOXOOOXOOXOOOOOOOOOOXOXOOXOXOXOOOXXXOXOOXOOOOOOOOXOXOOXOOOOXXOXOOOOOOOXOOOXOOXOOOXXOOX
OOOOOXOOOOOOOOOXXOOXOOXOXXOOXOXOOOXOXOXOOXXOXOOOOOOXXXOOOOOXXXOOXOOXOXOXOXXOOOOXOOXXOOOXXOOOOOOOOOOXO
OOXOOOOOOXOXXXOXXOOXOOOOOOOOOXXOOOOXOOXOXOOOOOXOOXOXOOOXOXOXOOOOOOOOXOOOXXXXOOOXXOOOOOOOOOOOOOOOXOOOO
XOOXOOXOOOOOXOOOOOOOOOXOXOOOOXOOOOXXXXOXXOOOOXXOOOXXOOXXXXOXOXOOXOOXOOOXOXOOOXOOOOXOOOOOXOOOOXOOOXXOO
OOOXOOOOXOOOOOOOOOOOOOXOOOOOOOXOOOXXOXOOXOOOXOOXOXOOOOXXOXXXOXOOOOOOXOOOXXOOXOOOOXOOXOOXOXXOOXXOXOOOX
XOOOOXXOXOOOOOOOXOXXOOOOOOOOOOXOOOOXXOOOOOOXOXOOOOOXOOOOOOXXXOXOOOOXOOOOOXOOXXOOOOOOOXOOXXXOOXOXXOXXO
OOOXOOOXXOOOXOXOOXOOXOXOXXOOOXOOOXXOXOOOOOXOOOOOOXOXOOOOOXOXOOOXOXOOOXOXOOOOXOOOXOOOXXOOXOOOOOOOOOXOX
XOOOOOOOXOOOOOOOOXOOOOOOOOOOOOXOXXXOOXOOXOOOOOOOXOOOXOOOOOOXOOOOOOOOOOOOOOOXOXXOOOOXOXXOOXOXOOOXXOOXX
OOOOXOOXOOOOXXXOOOXOXOOOOOOOXOOOXXOXXXOXXOOOOOXXOOOOXOOOOXXXXOXOOOOOOOOOOOOOOXOXXXOOOOXXOXOXOXOOOXOOO
OOOXOOOOOXOOOOOXOXOXOOOOXOOOOOXOOOXOOOOOOXOXOOOOOOOOXXXXOOXOOOXXOXOOOXOOOXXOOOOOOXOOXOXOXOOXOOXOXOOOO
OOOXXOXOOXOOXOOOOXOOXOOOOOOXXXXOXOXXOOOXOXOOOOOXOOXOOOOOOXXOXOOOXOXOOXXOOOXXOOXOXOOXOXOOOOOOOXOOOOOOO
OXOOOOXOOXOXOOOOOOOOOXOOOOXOOOOXOOXOXOXOXXOXXOOXXOOOXOOOOXOOOOOOOXOOXOOOOOXOOOOOOOOOXOXXOOXXXXOOOOOXO
XOXXOOOOOOXOOOXOXOOXXOXXOOOOXOOXOXXXXOOXOOOOXOOOOXXOOXXXOOXXOXXOOOXXOOOXXOOOOOOOOOXOOOOXXXOOOXOOOOXXO
XXOOOOOXOOOXXXXOXOXXOOOOXXOOXXOXOOXXOXXXOXOOXOOXOOOOXOXOOOOXOOOOOOOXOOXXOOXOXOOOOOOOXOOXOXOXXOOOOXOXX
OOOXXOOOOXOOXXOOOOOXOOOOOOOOOOOOOOOOOOOOOOOOOOXOXOOOOOOOOOOOXOOOOOOOOOXOXOOOOOOOOOOOOOOXOOOXOXOOOOXOO
OOOOXOXXOXOXOOOOXOXXXOOOOOXOOXXXOOOOXOXOOOOOOXOOOOOOOOOXOXXOOOXOOOOOOOOOOXXOXXXXXOOOOOOXOOOOOOOOXOOXO
OOOXXOOOOOOOXOOXOOOOXXOOOXOXOXXOOXOXOXXXOOOOOOOOOXOOOOOOOOOXOXXOOOOOOOOXOOOXOOXXOXOXOOXOOOXXOXOOXOOXX
XXOOOXOOOOOOOOOOOXOOOOOXOOOXXOOXOOOOXOOXOOOOOOOOOXXOXOOXOOOOOOXOOOOOXOOOXXOXOXOOOOXXXXXXXOOXOOXOXXXXO
OXXXOOOXOXXOXOXOOOOOOOOOOXOOOOOOOXOOXXXOXOOXOXOXXOXOOXOOOOOXOXXOXOXOOOOXOOXXOOOXOOXOOOXOXXOXOOOXOOOXX
OXXOOXXOXOOOXOOXOOOXOOOXOXOOXOOOOOOOXOOOOXXOXXOOOXOOOXOOXOXOOXOOOOXOOOOXOOOOOOXOOOOOXOOOOOOOOOOOOOXXX
XOOXOOOXOOXXXOOXOOXOOOXOOOOOXOOXOXOXXXXOOOOOOOOXOXOOOXOXOOOXOXOOOOXOOOOXOOXXOOOXOOOXOXOOOOOOOXOOOOOXO
OOOOXOOOXOXOXXOOOOXOXOOOXOOOXOOOXXXXXXOXOOOOXOOOXOOOOXXOOOOXOOOOOOOXOOXXOOOOXXOXOOOOXOOXOOOOXXOOOOOOO
OOOXOOXXOOOOOOOOOOXXOOOOXOOOOOXXXOOOOXOOOXXOXOXOXOOXOXOOXOXXOXOOOOOOOOOOXOOXXOOOOXXOOOXOXOOXOOOOOOXOO
OOXOOXXOOOOOOXXOOXXXOOOOXOOOXXOOOOOOOXOOOOOOOOXOOOXXOOOOXXOXOOOOOOOXOOXOOOXOOOOOOXOOOXOOOOXOOOXOXOOOX
OXXXOOOOOOOOXOOOOOXOOOOOOOOXOOXOXOOOOXOXOOXXOOXOOOOOOXOXXOOOOOOXOOOXOOXOOOOOXOOOXXOXXOOOOOOOOOOOOXXOO
OOOOOXOXOOOXOOXOOOOOXOOOOOXXXOOOOOOXXOOOXOXOXXXOOXOOXXXXXOXOOOOXXOOOOXOOOXXXOOXOOOOOOXOOOOOOOXXXXXOOO
OOOXOXOOOOOOOXOOOOOOXXOOXOXXOOOOOOOOOOXXOOOXOOOXOOXXXOOOXOOOXXOOOXXXXXOXOOXOOOOXXOOOOOXOOOOOOXOXOXOXO
OOOOOOOXOOXOOOXOOOOOOOXOXOOXOXOXXOOOOOOOOOXXOOOOOOXOXOOOOXOOXOOOXXOOXXOOOXOOOOOXXOOOOOOOXXOOOXOOOOOOO
OOOOOOOXXOOOOXXXXOOXXOOOOOOXXOXOOOXOXXOOXOOXOXXXOXOOOOOXOOXOOXOOXOOOOXOXXXXOOXOOXOXXXOOOOOOOXOXXOOOOO
XOOXOXOOOOXOOOOXOOXXOXOXOOOOOOOOOXOOOXOXOXOOOOXXOXOOOOOXOXXOXXOXXOOOOXXOOXOOOOXOOOOOOOOXOXOXOXOOXOOOO
OOOOOOOXOOOOOXOXOOOOXXOOOXXXOOXOOOOOOXXOXOXOOOOOOOXOOXXXOXXXOOOXOOOOOXXOXOXOOOXOXXXOOOXOXOOOOOXXOOOOO
XXXOOOOXOOOOOOOOOXXOXXXOXXXXOOXOOOOOOOOOOOOOOOOXOXOOOOXXXOOXOOOXOOXXOOOOXOOXOOXOOXOXXXOOOOXXOOOOOOOOO
OXOOOOXOOOOOOOOXXOOOOXOOXXOXOXXOOOOOXXOXOOOOOOOOOXXOOOOXOOOXOOOOXOOOOOOOOOOOXOOOOOOOOOXOOOOOOOXXOOXOO
OXOXOOXOOXXXXOOOOXOXOXOOXOOXOXXOXOOOOOOOOXOOXOOOXOOXOXXOOXOOXOOOXOXOOOOXOXXXOOOOOXOXXOXXOXXXOOOOXOOOX
OXOXXOOOOOOOOOXOXOXOOOOXOOXXXOOOOOOXOOXOOOXXXXXOOOOOOXOOOOOOOXOXOOXOXOOOOOOOOXOOOOXOOOXOXXXXOXXXOXXOX
OOXOXOOOOXOXOOOOOXOXOOOXOOXOOXOXOXOOOXOXOXOOOXOOXOOOOOOOXOXOOOOXXOOXOXOXOOOXXOOOXOOXOOXOOOXOXOXOOOOOX
OOXOOOOOOXOOOOOOOXOOOOOXOOOOXOXOXOOOOOOOOXOOXOXOOOOOXXOOXOXOOXOOOOXOOXOOXXOXOOXOOOXOOOOXXOOXXOXOOOOOO
OXOOOOOOOOOOOXOOOOOOOXXOOXOOOOOOOOOXOOOXOOOXXOOOOXOOXOOOOOXOXOOXXOXOOOOOOOOXXOOXOOOXOOOOOOOOOOOOOXXXX
