OXOXOOOOXXOXOOOOOOOOOOOXXOXOOXOOXOOOXOXXXXXXXOOOOXOOXOOOOOOXOOOXOOOXOXXXXOOOXOOOXOOXOOOOXOXXXOXOOXXOO
XXOXOOOXOOXXOXOOOOOXXOOOOOXOOXOOOOOOOOOOOOOOOXOOXOOXXOOOXOOOXOXXOOXOXOXOOOOOXXOOOOXOOXOOOXOOOOXOOXOOO
XOXXOXOOOXXOOXXXXOOOOOXXOOOXXXOOOXOOOOXOXOOOOOOXXXXOXOOXOOOOXOOOOOOOXXXOXXOOOOOXOXOOXXOOXOOXXOOOOOOOX
OXOOXXOOXOXOOOOOOXXOOOOOOXOOXOXOXXOOOOXXXOOOXXOXOXOXOOOXOOXXOXOXXOOOOOOOOOXOOOOOOOOOOOXXOOOOOOOOOOOOO
XOOXOXOXOXOOOXXXXXXOOOOOXOOXXOOOOXXOXXOXOXOXOOOOXOOXOOOOXXXOOOXOOOOOXOOXOXOOOOXOXXXOOOOOOOOOOOOOOOOXO
XXOOXXOOOXXXOXXOOOOOOOXXXXOOXOOOOOXOXXXOOOXOXOXOXOOXOOOXOOXOOOXOOOXOXOOXOOOOOOOOOXOXOXOOXXOOOOOXXXXXX
XOOOXOOOOOOOOXOOOXOOOXOXXOXOOXOOOOOOOOOOOOOOOOOXOOOOOXOOOOXXOOXXOOXOXOXXOOOXXOOOOOOOOOOOOOXOOXOXOOXOO
OXXXOXXOXOOXOXOOOXXOXOOOXOOXOXXOOOOXXOOXXOOXOOOOOOOXOOOOOOXOOOOXOOOXOOOOOOOXXOOOXOOOOOOOXXXOOXOOXXOOO
XOOOOXXOOOOOOOXXOXOOXOOXOXOOOOOXOXXXXOOOOOOXOOOXOOOOXOXOOOOOXXXOOOOOXOXOOOOOOOXOOXOOOXXOOXOXXOXOXOOOO
OOOOOXXOOXXOOOXXXXOOOXOOXOOXOXOXXOXOOOOOOOXXOOOXOXOOOXXOOXOOOOOOOOOXXOXOOOOOOOXXXOOOOXXOXOXOXXXXOOXOO
OXOOOOOXOOOOOXOXXOXOOXOXXXXXXXXOOXOOOOXOXOXXXOOOOXXOOOOOOOOOOOOOOOOOXOOOXOXXXOXOOXOOXOOOOOOXXOOOOOOXO
OOOOOOOOOXOXXOXOXOOOXOXOOXOOOXXXOOXXXOXOOOXXXOOOOOXXXOXOOOOOOOOXXOXOOOOOXOXOXOOOOOOXXOOOOXOOXXXOOXXOO
OXXOOOOXOOOOXOOXOOOOXOOOOXOOOOOXOOXXXXXOOOOXOOXXXOXOXOOOOOOXOOOXXOXXOOOOOOOXXXOOOOOXXOOOXOOXOOOOOOOOX
OOOOOOXOOXXXXOXXOOOOOOOOOOXOOOXOXOOOOXXXXXXOOOOXOXOXOXOOOOOOOXOOOOXOXOOOOOXXXOXOOXOOOOXXXXXOOOXOOOOOX
XXOOXOOXOOOOOOOOOOXOXOXOOOOOOOXXXXXOOXOXOOOXXOOOOXXOOXOOOXOOXXOOOXOXOOXOXOXOOXOOOOOOOXXOXXXXXOOOOXOOO
OOOOOOOXOOXOXOOOXOXOOOXXOXXOOOOXOXOOOOXOOOOOOXOOOOOOOOOOOOOXOOOOXOXOOOOOOOOOOOOXOXXXOXOOOOOOXOOXOOXOO
XOOOOXOOOOOXOOOOOOOXOOOOOOXXOXOOXOOOOOOOXOXOOOOXXOOOOOOXXOOOOOOOOOOOOOOXXOXXOOOOOOXOOXXOOXOOOOXOXXXOX
OOOXOXOOXOOOXOXOOOOOOOOOXOXOXOOOXOXOXOXXOXOXOXOOXOOXXOOXOOOOOOOOXOOXXXOOOOOOXOXOOOOOXXOXXOOOOOOOOOOXX
XXOOXOXXXOOXOXXOXOOOOOXOOXOOOXXOOXOOOOOOOOXOXOOXOXXOOXXOOOXXXOOOOXOOOOOOXXOOOOXOXOOXOXOOOOOOOXOXOOXOO
OOOXXOOXXOOXXOXXOOOOOOOOXOOXOXOXXXOOOXXOOOOOOXOXOXOOOOOXOOXOOOOXOXOOOOOOOXXXXOOXOOXXOXOXOXXOOOOOOOXOO
OOOOOXOOOOOXXOOOOXOXOOOXXOXOOOOOOOOOOOOOOOOOOOOXOOXOOXOXOOOOOOXOOOXOOOOOXOOXOOXOOOXOOOOXOXXOXOOOOXOOX
OXOOOOXXXXOOOOOOOOOOXXXXOOOOOOOOOXOXXOOOOOOXXOXOOOXXXOXOXOOOOOOOOXOXOOOXXXOOXXXOXOOOOXOXOOXOOXOXXOOOO
OOXOOXOOXOXXOOOOXOOOOXOOXOXOXXOOOOOOOOOOOXXXXOOXOOXXXOOXOOOOXOXOXOXOXOXXOXOOOXXOOXOXOOOOXOXOOXXXOOXOO
OXXOOOOOOOOXOXXOXOOOXOOOXOXOXOOOOOXXOOOOOOOOOXOXXXXOOOOXOOOOOOOXOXOOXOOOOOOOOOOOXOOOOOOXOXXXOOOOOOOXO
OOOOOOXOXOXOOOXOOOXXOOOXOOXOOOXXOOXOOOOOOOOOXOOOOOOOOOOXXOXOOXOOOOOXOXOXOOOOOOOOXOOXOOOOOXOOXOOOOOOOO
OXOOXOOOOOOOOOOOOXOXOOXOOOOOOOXOXOXOOXXOXOOOOOXOOXOOOOXOOOOXOOOOOOOOOOOOOOOXOOOOXOOOOOXXXXXOOOXOOOXOO
XXOOOXOXXOOOXOOOOOOOXOXOOOOOOOOXOOXXOOOOXOXXOOXOOXXOOOOOOOOOOOXOXXXOOOOOOOOOOOOOOOOOOOOOOOOOXXXOOOXOO
OXXXOXOOOOXXOOOXXOOOOOOOOXOXOOOOOXOOXOOOOXOOOOXOXOOOOOOOOOXXXXOOOOXOOOOOOOXOOOOOOOXOXXOOXOOOOOXXXOOXO
OXXOOOXXXOXXOOOXOOOOXOOOOOOOXOXOOOOOOOXOOOXOOXXOOXOXOOXOOOOOOOOOXOOOOOOOOXOOOOXOOOOOOXXOOXOOXOOOOOOXO
XOXXOOXOOOXXXOOOOOOOOOOXOOOOOXOOOOXXOOXXXOOXOOOXXOOXXOXXOXOXXXXOOOOOOXOXXXOOOOOOOOOOOOOXXOOOOOOOOOOXX
OOOOOOOOXOOOXXOOOXOOXXOXXOOOXXOOOXOXOOOXXXOOXOOOXOOXXXOXOXXOXOOOXOXXOXOOOXOXOXXOXXOOOOOOOOOOOOOXOXOOO
OOXOOOOOOOOOOOXOOOXOXOOXOOOXOXXOXOOXXOOOXXXOXOXOOOOOOXOOXOOOOXOOOOOOXXOOOOOOOOXOOOOOXOOOOXXXOOOOOXXOO
OOOOOXOOXXXOOXOOOOOXOXOXOOOOOOOOOOOOXXOXOOXXXXOOOOXOOOXOOOOOOOOOOOOOXOOOOXXOOOXOOXOOOOOOOOOOOOXXOXOOO
OOOOOXXOOOOOOOOOOXOOOOXOOOOOOOXXOOOOOOXXOOOOOOXOXOXOOOOOOOOXOXOOOOOOXOOOXXOOOOOXXOOXXOOOOOXOXOXXOOXOO
OXOXOOOXOOXOOOOOOOXOXOOOOOOOOOOXOOOXXOOOOOOXOXXOXOOXXOOOXOXXOXXXOXXXOOXOOXXOXOOOOOOOXXOOOOOXXOOOOOXOX
XOXOXOOOOOOOXOOOOXOOOOOOOXOOOOOOXOXOXOOOXOOXOXXOXXOOOOOOXOOOOOXOOOOOOOOOOXOOXXXXXOOOXOOOOXOOOOOXXOXOX
OXOOXXOOOOOXOOXXXOXOOOOXXOXOXOOOXXOXOXOOOOOOOOOOXOOXOXOXOOOOOOOXOOOOOXOOOOXOXXOOOOXXXOOOXOOOOXOXOOXOO
OOOOOXXOXOXOOXXXOXOOOXOXOOOOOOOXOOOOXOOXOXOOOOOOOOOOOXOOXXOOXOOOOOOXXOOOXXOXOOOOXOXOOXXOXOOOXOOXOXXOO
OOOOOOOXOOXOOXOOOOOXXOOXOOOOXOXOOXXOOXXOOOOXOOOOOXOOOXOOOOXXXXOOOOXXOXOOOXOOOOOXOXXOOOOOXXOXOOOOXOOOO
XOXOOOOOOXOXOOOOOOOXOOOOXOXOOOXXOXOOOOXXOOOOOOOXOOOOOOOXXOOOOXOOOOOOOOOOOOOOOOXOXXXOOXOXXXXOXXOOOOXOO
OOOOOOXOOOOXXXOXXXOOOOOXOXOOOOOOXOOOOOXOOOOOOOOOOXOOOOXXOOOXOOOOOOXXOOOOXOOOOOOOOXOOXXOOOOOOOXOOXXXOX
OOXOOXOOXXOOXOOOOOXOXOOXOOOOOOXOXOOOOOOOOXOOOOOXOXXOXOOXXXOXXOOOOXXXOOOXXXXXXOXOOOOXXOOOOOXOOOOOOOXOO
XOOOOOXXOOXOXOOOOXOXOXOOOXXOOOOOXOOOOOXOOOOOXXOOOOXOXOXOOOXXOXOXOXOOOXOOOOOOOXOOOOXXOXXOXOOXOOXOOOOXO
OOOOOOOOOXOOOOOXOOXOOOOOOXXXOXOOOOXOXOXOOOXOOOOOXOOOOXOXOOXOOXXOXOOOOOXOXOOXXOOOOOOXOXXXXOOOOOXOOOOXO
OOXOOOOOOOXOOOOXOOOOOXOXOOOXOOXOOOOOOOOOXOXOOXOOOXOXXOXXOOOOXOOOOOOXXOXOXXOOXOOOOXOOOOOOOXOOOOXOOOOOX
XXOOOOOXOOXXOOOOOOOOOXXXOXOXOOOOOXOXOOOOOOOOOXOXOXXOXOOOOXOOXOXOOOOXXOOOOXOOOOXXOXOXOOOXOOXOOOOOXXOXO
OOOOOXXOXOOOXOOOXOXOXOOOOXOOXOXOOXXOXOOOOOOOOOXOOOOXXXOOOXOOXXOXOOOOOOOOOOXXOXOOXXOOOOXOXOOOOOOOOOXOO
OXXOOXOOOOOXOOXOXXXOOOOOOOOXOOOXXXOOOOXOXOXXOXXOOOOOOXXOXXOXOOOOOXXOOOXOXOXOOOOOOOOXOOXXOOOOOXXOOOOOO
OXOOOOOOXOOOXXOXOOOOOXXOXXOOXOOOXOXOOXOOOOXOOOXXOXOOOOOXOOXXOXOOOOOOOXOOOOOXOXOOOOOXXXOXOXOOOXOOOXOOO
XOOOOXOOXOOOXOXOOXXXOOOXOOOOXOOOOXOOXOOOXOXOOOXXXOOXOOXOOOXOOOXXOXXOOXOXXOOOXOXOXXOOOOOOOOOXXOOOOXOOX
OOOOXOOOXOOOXOXOXOOXOOXOXOXXXXOOOXOOXXOOOOOOXOOXOOOOXXOOOOXXOOXXOOOXOOXOXOOOXOOXOOOXOOOOOOXOOOOOXOXOO
OOXXOOOXOOOOOXXOOOXOOXXXOOOOXXOOOOOOOOXXXXOXOOXOXOOXXXOOOXOXXXOOOOXOOOOOXOOXOOOOOOOOOOXXXOOOXXOOXOOOO
OOXOOOXOXOOXOOOOOXOXXOOXXOOXOOXOOOOOXXXOOOOOXOOOOOOOOOOOOOOXOXXOOOXXXOOXOOOXOXOOOOXOXXOOOOOOOXXOOXOXO
OXOOOOOOXXOOOOOXOXOOOOOOOOOOXOXOOOXXOOOOOOOXXOOOOOOOXXOOOXOOXXXOOXXOOXOOOOOXOXXOOOOOOOOOXOOXXOOXOOXXO
OOOOXXXOXOOXXOOXXXXOXXOOXOOXXOOOXOXXOOXOXOXOXOOXOOOOXOOXOOOOXOOOXOOXOXXOXXOOOOOXOOOOOOOXOOOOOOOOXOXOX
OOOXOXOOXOOXOOOOOOOOOOXXOXOOXOXOOOXXOXOXXOOOXXXOOOXOOOOOOXOXOOOXOXXOOXOOOOOOXOXXXXOXOOOOOOOXOOOOOOOXO
OXXOOXOOXOOOOOOXXOOOXOXOXOOOXXOOOXOXOXOOOOOOOOOOXOXOXOXOOOOOOOOOXOXXOOOOOXXOOOXXOOOOOOXXOXOXOOOOOOOOX
OOXOOOXOOOOXOXOOXXOXOOOOOOOOOOXOXOXOXOOOXOOOXOOOXXOXXOXOOOOOOXOOOOOOOXXXXOOOXOXXOOXOOOOXXOOOOOOOOOXOX
OXOOOOXOOOOXXOXOXOXOOOOOOOOOOOOXOOOOXOOOOOXOOXOXXXOOOOOOOOOXOOXOXXOOOOOXXOOOOOOOOXOXOOOOXOOOXXOOOXOXO
XOOOOXOOOOOXOOOOOOXOXOXOXXOXOOOXXXOOXOOOOOOXOXOOOXOOOOOOOOOXOOXOXOOOOXOXXOXOOOOXXOOOOOOOOOOXXXOOOOXOO
OOOOOXXOOOOXXOOOOOOOOOXOOOXOOOXOOOOOXXXOOOOOXOOOOXOXOOOOOXXOOOOXOOOOOOOOOOXOOOOXOOOXOXOXOXOXXOOXOXXOO
OOXXXOXOOOOXXOXOOOOOOXOOXXOOXOOXOOOOOOOOOOOXOOOXOOOOOXOOOOXOOOOOOXOXOOXOOOOXOOOOOXOXOXXOOOOOOOXOXOOOX
XXOOOOXOXOXXOOXOXXOXOOXXXXOOXOXOOOXXXXXOOXOOOOXOOOOXOOOOOOOOOOOOXOOOXOOXOXOOXXOOOOOOOOOOXOOXXOOOOXOOO
OXOXXXOOXOOOXOOXOOXXXOOXOOOXXOOXOOOOOOXXXXOOOOOOXOOOOXOXXXXOOOXOOOOOOXOXOOOOOOOOOOXOOOOOOXXOOOOXOOXXO
OOXOXOOOXOOOOOOOOXOXXOOOXOXOOXXXOOOOOOXXOOOOXXOOOOOOOOXOOOOOXOXOOXOOOXXXOXOOOOOOOOOOXOOOXOOOOOOOOOXOX
XOOXOXOOOOXXOOXXOXOOOOOOOOOOOXOXXOOOOXXOOXOOOOOOXOOOOOOOOOOOXXOXOOOOOOOXXOOOOXOOOOOOXXOOXXOOOOOXXXOOO
OXOOOOOOOXOOOOOOXXOOOOOOOOOOXXOXXOOOXOOOOOOXOOOOOXXOOOOOOOOOOXOOOOOOXOOXXOOOOOOOOOOOOOXOOOOXOOOOOOOXO
XXOOOOOXOOOOOXXOOOOXXOXOXOOOXOOOOOXOOOOOOXOOOOXOOOOOOXOXOOOXOXOOOXXOXOOOOOOOOXXOXOOOXOOOXOOXOXOOOOOOO
OOXXXOOOXXOXXOOOOXXOOOOOOOOXXXOOOOXOOOOOOOOOOOXXOXXXXOOOOOOOOOOOOOXXOOOOOOXOOOOOOOOXOXOOOOOOOOOOOXOOX
OOXOOOOOOXOOOOXOOOOOOOOOXOOOOOOOXXXOOXOOOXOOXXXOXOOOOOOOOOOOOOXOXOOOOOXOOOOXOXXOOXOOOXOXOOXOXOXOXXOXO
XXOOXXXOOOOOOOOXOOOOXXOOOOOOOXXOXOOOOXXOOOOOXXOOOOOOOOOOOXOOOOXOOOOXOOOOOXOOOOOOOOOOOOXOOXOOOOOOOOOXO
OXXOXOOXOOOOOOOXXOOOXOOOOOXOOOOXOXXOOOXOOXOOXXOOOOOXOOXOOOXOOOOOOOOOXOXXOOXOOOOOOOXOOXOOOOOXOOXOXOOOO
XOXOOOXOXOOOXOXOOOOOXXXOOOOOOOOOOOOOOXOOOOOOOOOOOOOOOOXXOXXOOXOXOOOOXXOOOOXOOOOOOOOOXOOOXOXOOXOOXXOOO
OOXOXXOXXXXOOOXOOOOOOOXOOOOOOXOOOXXOOOOOOOOXXOXOOXOOOOOOOXOOOXOXOOXOOXOXOOXXOOOXXXOOOOXOOXOOXOOOOOXXO
OOXOOOOOXXOOOOOOOXOXOOXOOOOOOOXXXOOXOOOOOXOXXOOOXOOOOOXXOOOOOOXXXOOXOOOOOOOOXOOXOOOOOOOOXOOOOXOOOOOOO
XOXOXXXOOOOOOOXOOOOOOOXOOOXOOOOOOOOOOOXOXOXOOOOOOXOXOOOXOOOOXOOOOOXOXOOOOXOOOXOOXOOXOXXOOOOXOXOOOOOOO
XXOOOOOXOOOXOOXOOOXXXXOXXOOOXOOOOOXOOXOOOOOOOOXOOOXOOXOOOXXOOXXOOOXXOOOOOOOOOOOOOOOOOXXXOXOOOOOOOOOOO
OOOOOXXOXOOOOXXXOOOOXXOOOOOOXXXXOXXXOOXXOOXOOXOOXXOOOXOOXOOXOOOOOOXXXOXOOOXOOOOOOOXOOOOOXOOOXOOXOOXOX
OOXOXOOOOOOOOXOOOOXOOXOOOXXXOOOXOXOOOOXXOOXOOOXXOOOOOXOOOOOXOXOOOOXOOXOXOOXXXOOOOXOOOOOOXOOXOXOOOXXXX
OOOXOOOOOOOOOOOOOOOOXOXOOXOXOXOXXOXOOXOOXXOOOXXXOXXXOOXOXXOOOOOXOOOOXXOXOXOXOOOOOXOOOOXOOOOOOOXOOOOOX
OOOOXOOOOOOOOOOOOOOOXXXOXOOOOOOXXOOXXOXXXOOOOOOOXOXOXOXOOXOOOOOXOOOOOOOOOXOOOXXOOXOOOOOOOOOOOOOOOOOOO
OOOXOOOXXOOOOOOOOXXOOOXOXOOXOOXOOOXOXOOOOOOOOXOOOXXXXOOXXOOOOXOOOOXOOOOOOXOXOOOOOOOOXOOOOOOOOOOOOOXOO
XOXOOOOXOOXOOOXXOOOOOOOXXOOXOOOOOOXOXOOOXOOOXOXOOXXOOOOOOOXOXXXOOOXOOOXOXOXOOOXOOXXXXXOXOOOXOXOOXXOOX
XOOOOXXOOOXOOXXXOXXOOXOOOOOXOOXOOXOOOOOOOXXOOOXXOOOXOXOXOOOOXOXOOOOOOOOOOOOOOOOOOOXOOOXOXOOXXXOOOOXOO
OOOOOXOOXOOOOXOOOXXXOXOOOOOXOOOOOOOOOOOOOOOXOXOOXOOOOOXXOOXXXOOXOXXOOXOOOOOXOOOOXOOOOOOXOOOOOOOXOOOOX
OOOXXOOOOOOOOOOXOXXXOXXXOOXOOOOOXOOXOXOXOXXOOOOOOXXOOOOXOOXXOOOOOOOXOXXOOXOXXXOOOOOOXXOOOOOXOOOOOOOOX
OOXOOOOOOOOOXOXXXOOXOXXXXOOOOXOXOXOOOOXOOXXOOOOXOXOOOOOOOOXOXOOOOOOOOOOOOOOXOOOOOXOXOOOOOOOXXOOOXOOXO
XOOXXOOOOXOOXOXOOXXOOOXXOXOXOOOOOOXXOOXOOOOOXOXOXOOOOXXXOXOOOOOOOOOXXOOXOXOOOXOXOOXOOXOXOXOOOXOOOOOXX
OOOXOXXXXOOXOOXOOOOOOXOXXOXOXXOOXOXXOXXOOOOXXXXXOOOXOOXXOXOOOXOOOXXOOOOOOOXOXOOOOOOOOOXXXXOXXOOXOOOOO
OXOXXXXOOOXOOOOOXOXOXOOOOXOOOOOXOOOOOOOOOXOOOXOOOOXOOOXXOXOOOXOOOOOOOOOXOOOXXXOOOOXOXOOOOOOOOOOXOXOOO
OOOOOOOOXXOOOOOXOOOXXXXOOXXXOXOOOXOXOOOXOXOOOXXOXOOOXXOOOOOXOOXXOOXOOXOOOOOOXXOXOXOXXXOOOOOOXOOOOOOXO
XOXXXXOOOOOXOXXXOXXOOOOOOXOXOXOOOOOOXOXOOOOOOXOOXOOOXOXXOOOOXXXOOXOXOOOOXOOXOOOXOOOOOOOXXOOXOXOOXOXXO
OOOOOOOOXOOXOOOOXOOXOOXOXOXOXXXOXOOXOOOOXXXOOOXOXOOOOXOOOOOXOOOOXXOOOXOXOXOXXOOOXXOOOOOOXOXXOOOOOXXOO
OOXOXOXOOOOOOOOOOOOXOOOOOXOXOOOXOOOOOOOOOOOOOOXOOOXXOOOOXXOOOOOOXXOOXOOOOXOOOOOXOOXXOXOOXXOOXOOOOOOOO
XXOOOOOOXXOOXOOXOOOOOOOXOOOOOOXOOOOOOOOXOOOXXXXXOOOXXOOXXXOOXOOOOXOOOOOXOOOXXOXOOOOXOOOOOXOOOOOOXOXOX
XOOOXXOOOOOOOOOOOOOOXXOXXOOOOOOOOXOOOXOOOOXOOOOXOOOOOOOXOXXOOOOOXOXOOOOXXXOXXXXOOOXOOOOOXOXOXXXOOOOOX
OXOOXOXXOOXXOOOXXXOXOOXOOXXOOOXOOOOOXXXOOOOXXOOOOXOOXOOOXOOOOOOXXOOOOOXOOOOOOXOXXOOOOOOOOOOXOOXXXOXOX
OXXOOOOOOOOOOOXXOOOOOOOOOXXOOXXOOOXOOOOOXOOOOXXOXOXOOXOOOOOOOOOXOOXOXOXOXOXOOOOXXOXXOOXOOOOXOOOOOOOXO
OXXOOOOOXXOOXOOOOXOOOOOOOOOXXOOOOOOOXOXOXOOOOOXOOOXOXOOXXOOOOOOXOOXOXOOOOXXOXOOOOOXXXXOXOOOOOOOXOOOOO
OOXOXOOOXOXXOOOOOOOOOOOOOOXOOXXXOOXOXXOOXXOOOOOXOOOXXXOOOOOXOXOXXXOOOOXOXXOOXOXOXOOXOOXXOOXXOXOOOOOOO
XOOOXOXOOXXXXXXOOOOOOOOXOOOOXXOOOXOOOOOXXOOOXOOOOOOOOOXOXOXOOOXOXOOXXOOXXOXOOOXOOOOXOXOOXOXOOOOXOXOXO
