XXOOOOOOOXOXOOOOOOOOXXOOOXXOXXXOXXOOXOXXXOOOOOOOOOOOOXOXOXOXXOOXOOXOOOOXOOOOOOOOOOOOXOOOXOOXOOOOOXOXO
XOOOOXOOOOOOOOXOOOXOOOOXOXOXOOOXOXOOOOXOXXXXOOXOOXOOOOXXXOOOOOOOOOOOXOXXOOXOOXXXXOXXXOOOXOOOOOXOOXOOO
OOXXOOOOOOXXXOOOOOOOOXOXOOOOOOXXXOXXOOOOOOOXOXOXOXOXXOOOXOOXOXOOOOOXXOOXXOOXOOOXOOOOXOOXXOOOOOXOOOOXO
OOOOXOOOOOOOOOOXOOOOOOXOOOXXOOOXXXOOOOOOXXXXOOXXOOOOOOOOOOOOOXOXOOOOOOOOOXXOOXXOOOXOOOOOOXOXOOOOOOXOO
OOOOOOOOOOOXXXOXOOOOOXOXOXOXOOOOXOOOOOXOOXXXOOOOOOOOOOXOOOXXOOOOXXOOXOOXOOXXOXOXOOOOOOXOXOOXOOOOXOOXO
XXXOXOOOOOOOOOOOXXXOOXOOOOOXOOXOOOOXOOOOOOOOXOOOOXXOOOXOOOXOOOXOOXOXOXOOOXOXOXXXXXOOOOXXOOOXOOOOXXXXX
XXOXXOOOOXOOOXOOXOOXOOOXXOOOXOOOOOOOOOOOXOOOOXOOOOXOOOXOXOOXXOOOOXOOOXOXXOOOOXOOOOXOXOXXXXOOOOOXXXXXO
OOXOOOXOOXOOOXOOOOXXOOXXOXOXOOOOOOXXOOOOOXOXOXOXOOOOOOOXOOOOXOOOOXOOXOOOOOOOOOOOOOXXOOOXXXOXXXXXOXXOO
OXXOOOOOOOXXOXOXOOOOOOOOOOOOXXXOOOXOOXOOOOOXOXXOOOOXXXXXXOOXOOOOOOOOOXXOOXXOOXOOXOOXOOOOXOOOOOOOXOOOX
OOOOOOOXXOOOOOOOOXOOOOXOXOXXXXOOOOXOXXOXOXOOOOOOOOOXXOOXOOOOOXOOOOOOOOXXOOXXOXOOOXOOXOOOOOOXOOOXXXOOO
OOOXOOXXOOOOXXXOOOOOOXOXOOOOXOOOOXOOOXXXOOXXXXOXOOXOOOXXOOOOOOXOOXOOOOXOOOOXOOOOOOXXOOXOXOOOOOOXXOXOO
XOOOXOOXXOOOXOOOOOOOOOXOOOOOOOOXXOOOOOXOOOXOOOOXXXOXOXOOOXXXOOOXOOOOOXOOXXOOOXOOOXXOOOXOOOOOOXOOOOXOO
OOOOOXOOXOOOXXOXOOOXOXOOXOOOXOXXOOOOOOOOOXOOOXOOOOOOOOOXOOOXOOOXOOOXOXOOXOXXOXOXOXXOOXOXOXOOOOOOOXOOX
XXOOOXXXOXXXXOOOOOOOOOOXOOOOOOOXOOOOOOXOXOXOXXOOOXXOOOOOOOOOXOOOXXXOOXOOOOOOOOOXOOOXOOOOXOOOOOOXOOOXX
XOXOOOOOOOOXOXXOOXXXOOOOOOOOOXOOOOOOOXOXXXXOOOOOOOXOXOOOOOOOXOOOOOOOOOXXOOOOOOOOXOXOXOOOOXOXOOOOXOXXX
OOXOOOOOXOOOOOOOXOOOOXXOXOOOOOXOXOOOOXOXXXOXOOOOXOXXOXOXOXOXOXOOOXXXOOXOOOOOOOXXXXXOOOOOOXXOOOXOOOOXO
OOOOOXXOOXOXOOXXOXOOOOOOXOXOOOOOXOXOXOOXOOXOOOOOXOXOOOXOOOOXXOOOXXOOOOOOOXOOOXOOOXXOOOOOOOOOXOOOOOOOO
OOOXOXOXOXOOOOXXXXOOOOOXOOOOXXOOOXXXXOOOOXOOOOOOOXXXOXOOOXOOOOOXXOXOXOXOXXOXXOXXOOOOOOOXOXOOOXOOOOOOX
OXOOOOOOXOXXOXXXOXOOOOOOOXOOXOOOXOXXOOOOOXOOOOXOOOOOXXXOOOXOXXOOOOOXOOOOOXOXOXXXXOOOOXOXXOOOXOOOOOOOX
OXXOOOOOOOOOOOOOOOXOOOOXOXOOXOOOOXOOOOOOXOOOOOXOXOXOOOOOXOOXOOOOOXXOOOOOOOOOOOOOOOXOXOOOOOXXXOXOOOOOO
OXXOOOOXXOXOOOXXOOXOOOOOOOXOXOOOXOXXOOOOOXXOOOXOOOXOOOOOOOXOOXOOOXOOXOOOOOXOOOXOOXOOOOOXOXOOOXXXOOOOO
OXOXXXXOOOXXXOXOXXXXOOOOOOXOXXXOOOXXOOOOOXXOXOOOOXOOXOOOXXOXXXOOOOOOXXXXOXOOXXXXOOOXXOOOOOOOOOOOXXXXO
OOXXXOOOXXOXOOOXOXXXOOOXXOXXXXOOOOXOOOOOXOXXOOOOOOOOXOOOOOOXXOXOOOOXOOOOOOOOOXXOXOOXOXOOOOOOOXOXXOOOO
OOOOOXOXOOOOOOOOOXOOOOOXOOXXOXOOOOOOXXOOXXOOOOOXOOOXOOOOXOOXOXOOOOOXOOOXOOOXXOOOOOOXOOXOOXOXOXOOOXXOO
OOOXOOOOOOOOOXOXXOOOXXOXOXXOOOOXOOOOOOOOOXXOOOOOOOOOOXOOXOOOOOXXOXOXOOOOOXXOXOOXOOXOOOOXOXXOOOOOOOOOO
OOXOOOXOXOOOOOOOOOOOOOOXXOOOXOOXXOXOOXOXXXOXXOOOXOXXOXXOXOXOXOOXXXOOOOXXOOXOOOOOOXOXOOXXOOXOXXOOOOXOO
OOOOOXXOOOOXOOOXOOOOOOOXXOOOXOXXOOOXXOOOXOXXOOOOOXOXOXXOOOOOOOOOOOXOOOOOOOOOOXXXOXOOOOOXOOXOXOOOOOOOO
OOOOOXOXXOOOOOXXOOXOXOOXOXXOXOOOXOOOOOXOOOXOOOOXOOOOOOOXXXXOXOOOOXOOOXOXOOXXOXOXOXXOXOOXOOOXXXOXOOOOO
OOXOOOOXOOOXOXOOOOOOXXOXOOXOOOXOOXXOOXOXOOXXOOXXXOOOOOOOOOOOXOXOOOOOOOOOOOXXOOXXOOOXXOXXOOXOOXOOOOXOO
OOOOXOOXOXOXOOOOXOXOOXOOOXXOOXOXXOOOXOOOOOOOXOXOOXXOXOOOOXOOOXOOOOXOOXOOOOOOXXOOOOOOXOOXOXOXOXOXOOOXO
OOOOXOXOXOOOOOOOOOXOOOXOOOXXOXOOXOXOOOOOOOXOOOOOOOOOOOXOOOOXXOOOOOOOOOOXXXOOOXXOXOXOOOOOOXOOOOOXXOOXO
XOOXOOXOOXOOOXOOOXOOOOOOOXOOOOOOXXXOOOXXOOOOOOOXXOOOOXOXOXOXOXOXOXOOOOOXOOOXOOOOOXOOOOOOOOXOOOOXOOOXO
OOXOOOOOXOXXXXOOXOOOOXOXOOOOOXOXXXOOOOOOOOOOOXOOOOOXOOOOOOOOOOOOOOXOXOOOOOOXOOOXXOXXOOOXOOOOXOOOOOOOO
OXXXOOOXOOOOOOOOXOOXOOXXOOXOOXOXXOOXXOOXXOXOOXOOOXOOOXOXOXOOOXOOOXOOOXOXOOOOOOOOXXOOOOOOOOOOOXOOXOXOX
XXOOOXXOOOOOOOOXOOOXXOOOOOOOXXOOXOOOOOXOOOXOOOXOOOXOOOOOOXOOOXXOOOXXOXOXOOOOOOOOXXXXXOOOOXOXOOXOXOXXX
OXOOOOOOXXOOOOOOOOOOOXOOOXXOOXOXXXOOXOXXXOOOOOOOOOOXOOOXOOOOOOXOOOXXOOXOOXXOOXOOOOOOOOOOOOOOXOXOOOOXO
OXOOOXOOOXXOOOXOOOOXXOXXOOXOXOOOOOOXXOOOOXOOOOOOOOOOOOOXOXOXOOXOOXOXXOOOXOOOOOOOXOOOOOXOOXOOOOOXOOOXO
OOOOXOOXXOOXXOOXXOXOOOXXOOOXOOOOOXOOOXOXXOXXXOXOXOOOXOOOXOXXOOOOOOOOOOOOOOOXOOXXOOXOOOXXOXOOXOOXXOOOX
OOXOXOOXOOOOOOOOOOOOOOOOXXOXOOOXOXOOXOXOXOOOXXXXXOOXOXOOOOXOOXOOOXXXOOOOOOOXXXOOXXOOOOOOOOXXXXOOOOOOX
OOOOXOOOOXOOXOXOOOOOOOXOOOOOOOXOXOXOXOOXOXOOOOOOOXOOOXXXOXXXOOOXXOOOXOXOOOOOOOOOOOXXXXOXOXOOOOOXXOXOX
OOOOOOOOOOXOOXOOOXOOXXOXOOXOOXXOOOOOOOOOXXOOXOXOXOOOOOOOOOOOOOOOXXOOOOXXOOOXOXXXOXOOOOXOOOOOOOOOOOOOO
OXOXOOOXOOOOXOOOOOOXOOXOXOOOXXXOXOOOXOOOXOOOXOOXXOXOOOOXOOXOOOOXOOXXOOOOXOOXXOOXOOOOOXOOOXXOOXOOOOOOO
OOOOXXOOOXOXOOXOOOOOXOXOXXOOOXOOOXXXXOXXXOXXXOXXXOOOOOXXOXXXOXXOOOOOOOOOXOOOOOOXXOOOOOXOOXOXOXOOXXXXO
OXXOOOXOXOOOOXXXOOXXOOXXOOXOOOOOOXOOOXOOOOXOOOXOOOOOOOXXOXOXOOOXOOOOXXOOXOOOOOXOOOOOOOOOOXXXOOOOOOOOO
OXOOOOOOOOOOXOXOXXOXOXOOOOOOOOOOXXXXXXOOXOXXOOOXXOOOOOOXOXOXOOOOXOOXOOOXOOOOOOXOXOOOXOOOXXOOOOOOOOOOO
OOOOXOOXOXOOXOXOOOXXOOXOOXXOXOOOXOXXOOXXOOOOXOOOOOOOOXOOXOXOXOOOOOOOXOOXOOOOOXOXXOXOXOOOXOOXOOOOOOOOO
OXOOXOOOXOXOXOOOOOOXOXOOXXOOXOOOOOXOOOOXXOOXOXOXOOOOXOXOOXXOXOXOOOXOOOOOOXOOOOXOOOOOOOOOOXOXOOOOXOOOO
OXXOOOOOOOOOOOOOOOOOOOOXOXOXOOXOOXOOOOOXOXXOXOXOOXOOXOXXOOXOOOOOOOXXXXOOXOOXOXOXOOOXOOOXOOOOOXOOXOOOO
OOOOOOOXOOOOXXOXXOXOXOOOOOOOOOXOOOXOXOOOOOOOXOOOOOOOXOOOOOXOOOOOOOXOOOOOOOOOOXOOOOOXXXXOXOXOOOOXXOXXO
XOXOOOXOOOOOOOXOOXXXXOOOXXOOOOOOXOOXXOXXOOXXOOOXOOOOXXOOOOOXXOXXOXOOOOOOXXXOXOXOOOXXOOOOOOXOOXOXOOOXO
OOXXOOXXXOOOXXOOOXOOOXOXOXOXXOOOXOOOOOOOOXXXXOXXOXOOOOOOXXOOOOOXOOOOOOOXXXXOOXOXOOOOOXXOXOOOOXOXOXOOO
OXOXOOOOOXOOOXOXXOOXOOXOXXXXXOXXOOOXXOXOXOXXOXOOOOXXOOOOOXOOOOXXOXOOOOOOXXOXXOOXOOOOOXXXOXXOOXOOXXOOX
OOOOOOXOOOOXOOXOXXXOXXOOXXOXOXXOOOOXOXOXOOOXOOOOOOOOOOOOXOOOOOXOOOOOOXOOXOOOOOOXOXOXOXOXOXXOOXOOXOOOO
XXOOOOXOXOOOOXOXXOXOOXOOOOOOOXXXXOXXOXOOOOOXOOXOOOOOOXOOOXXXXXXOOXXOOOOOOXXOOXXOOXOOOXOOOXOXOOOOXOOOX
OOOOXOOOOXOOXOOXXOOOOXOXOOXOOOXXXOOOOOOOXOOXOXOOOXOOOXXXXOOXOOOXXOOXOOXOXXOXXOOOXXOXOXXOOOOXOOOOXOOXO
OOXOOOOOXOOOOXOOOXOOOXXOXOOOOXXXXOXXOOXXOOOXXXXXXOXXOXOOOOOXOXXOOXXOOOOXOOXXOOXOOOOOOXOXOOOOOOOXOOXOO
XOXXXOOOXOOXOOXOOOOOXXOOXOOXOOXOXOOOOXOOOOXXOOOOOXOOOXXOOXOOOXOOXXOOOOOXOXXXXXOOOOOOOOXOOXOOXXOXOOOOO
OOOOOOOOOOXOXOOXXXOXOOOOXOXOOOXOXXOOOOOOXOXXXOOXOOOOOOOOXOXOOOXXOOOXXXOOOOOOXOOXXOOOXOOOXOXOOOOOOOOOO
OXOOOOXOOOXOXOOOOXXOOOOOXOXOOOOXOOOOOOOOOOXXOOOOXOOOXOXXOXOOOOOXOOXOOOOOXOOOOOXXOOXOOOXOXXOXOOOOOXOOO
XXOOOOOOOXOOXOXXXOOOOXOXOOOOOOXOOOOOOOOOOOXOXOOXOXOOOOOXXOXOOOOXOXOXOOOOOOXOOOOOXOOOOOOOOOOOXOOOOOXXO
XOOOOXOOOOOXOOOXXXXOOOOOOOOOOOOXXOOOOOOXXXOXOOOOOOOOOOXOOOOOXOXOOOOOOOXXOOOOOXOOXOOOOOXOOOOOXXOOXXOXX
OXXXOOOOOXOOOOOXOOXXOOOOOXXOOOXOXXOOOXXOOOXOOXOOOOOOOXOXOOXOOXOOOOOOOOOOOOXOOOOOXXOXXXOOOOOXOOOOOXOOO
OXOOOXXOXXOXOOOOXOXXOOXXOOOOOOXOXOOOXOOOXOXOXXOXOXOOOOOOXOOOOOOOXOXOXXOXOOXXOXXOOOOOXXXOOXOOOOXXXOXOO
OXOXOOXOOXOOXOXOXOOOOXXXOOXOOOOOXOXXXXOXOOOOXXXOOXOXXOXOOXOOXXOOOOOOOOXOXOOOXOOOXOOOOOOXOOOOOOOOOOXOO
XXOOOXXOOOOOXXOXOOXOOOOOOOXXOOOOOOXOOOXOOXOXOOOOOXOXOOOOOOXOXXOOOXOXXXOOOXXOOOXOXXOOOOXXOXXOOOXOOOOOO
OOOOOOOOOOOOOXOOOOXXOOOXOOOOOOOOOOOOOXXOXOOOOOOOOOOXOOXXXOOXOXXOXOXOOOOOXOOOOXOXOXOXOXOOOOOOXOXOOOOOX
OOXOXXOXOOOXXXXOOOOOXOOXOOOOXOOOXOXOOOOOXOOOXOOXOOOOXOXXXOXXXOOOXOXOOOOOXXXOOOOXOOOXOOOXOOOOOOXOOOOOX
OOOOXOOXOOOXOXOXOXOXOOOOXOOOOOOXOOOOXOXXOOOOOOOXOOOOOOOOOOOOOOOOXOOOXOOOOXOXXOOOOOXOXOOOOXXXXOOOOOXXO
OOOOOXOOOOOOOOOOOXOXOOXOOOXXXOOOOOOXXOOOOXOXOXOOXXOOOOOOXXOOOOOOXOXXXOOOOOOOOOOOOOXOXXOOOOOOOOXXXXXXO
XOOXXOOOXOOXXOOOXOXOXOXXOOOXOOOOOXOXXOXOOOOXXOOOXOOOOXXOOXOXOOOOOOXOOOOOOXOOOOOOOXOOXOOOOOOOOOOOXOOOO
OOOOOOOXXOXOOOXOXXOOOOOOXXOXOOOOOOOOOOOXOXOOOOXOOXOOOOOXOOOOOOOXOOOOOOXOOOXOOXOOOOOOOOOOOOXOXXOXXOOXO
XOOOOXOOOXOOOXOXOXOXXXXOOXOXOOOOOXXXOOOOOOOOOOOXOOOOOOOXOXOOXOOXOOOOOOOOXOOOOOOOOOOXXOOOOOOXOXOXOOXXO
OOOOOXOOXOOXOOOXXOOOOXXXXOXXXOXOOXXXOXOOOOOXOOOOXXOOXXOXOOXOOXXOOOOOXOOOOOOXXOXXOOOOOXXOOOXXOOOOXXXXO
XXOOOXXOXOOOOOXOOOOOOOOOOOOOXXOXOOOOOOOOOXXXOOOOXOOXXOOXOXOOOOOOOOXOOOOXOOOOOOOOXOOOXOOOXOOXOXXOOOOOO
OXXOXOOOOXXOXOOOXOOXOOOOOXXOOXOXXOOOOOXOOOOOXOOOOXOOXXOXXOXOOOXXOOXXOOOOOOOXOOOOOXOOXOXOOOOOOXOOXOOXO
OOOXOOOXOXOOOOXXXOOOOXXOXOOOOOXOXXXOOOXOOOOOOOOOXOOOOXOOOOOXXOOOOOOXOXOOXOOOOOOOOOOXOXXOXOOXOOXOOOOOO
OXOOOXOOXOXOOOXOXXXOOOOOXOOOOXXOOOOXOOXOXOXXXXXOXOXOOOOOOXOOOOOOXXOXOOOXXOOXOXOXOOOOXOOXOXXXOXOXOXXXO
XOXOXXXOOXOOOOOOOOOOXOOOXOOOOOOXOXOXOOOOXOOXOOOXOOOOOOOOXOXOOOXOOOOOOXOOXOOXXXOOXOOOXXOXOOOOOOXOOOXXX
OOOXOOOXOXOOXOOOOOOOOOOOXXOXOXOOOOOOXOOXOOOOOOOOOXOOOOXOOOOOXXOOXXOOOOXOOOOOXOOOOXXOOOOXOXXOOOOOOOXOO
OOOOXOOOOXOOXOOOXOOOXOOOOXOXXOOOOOOOOXOOXOOXOXOOOOXOXXOXOXOOOOXOOOOXOXOOXXOXOXOOOOOXOOOOXOXOOXOOOOOXX
OOOOXOOOOOOXOOXOXOOOXOOOOXXOOOOOOOOXOXOOXOOOOOOXXOOOOOOOOOOOXOXOXOOOXOOOOXOXOOXOOXXOOXOXOOOOOOOOOOXOO
OOXOOOOXXXOOOOXXOOOOOOXOOOOOOXOOXOOOOOOXOOOOOOOXXOXOOOXOOOXXOXOOOXOXOXOXOOOOOOOOOOOXOOOOOOOXOOOOOOOOX
OOOXXXOOOOOOXOOOOXOOOOOOXOXOOXOOOOOOXXOXOOOOXOOOOOOOOOOOOXOOXOXOOOOOOXXOOOOOOOOXXOOOOXOXXOOXOOXOOOXXO
OOOOXOXOOXOXOOOOOOOOOOXOOOOOOOOXOXOOOOOOXXXOOOOOOOXOOOXOOOXOXOXXXOXXOOOOOXOOXOXXXOXOOOOXXOXXOXXOXOOXO
OOOXOXOOOXOOOOOOXXXOXOOXOXOXOOOOOXXOOOOOOXXOOOOXOOOOXXOXXOOOXOOOOOXOXOXOOOXOXOOOOXOOOOOOXXOOOOOOOXOXX
XOOXOOOXOXXXOOOXOOOOXXOOXOOOOOOOOOOOOOOOXOOOOOOOOOXOXXOOOXOOOOXOOOOOOOOOOOOXOOOOXXOXOOOOOXOOOOOOOOOOO
XOOOOOOXXOOXXOXOOOOXOOOXOOXOOOOOXOOOXXXOOOXXXOXXOOXOXXOOOOOOOOOXOXOOXOOOXOOOOXXOOXOXOOXXOOOXXOOXOOOOX
OOXOOOXOOXOOXXXXOXOOOXOOOXXOOXOXOOOXOOOOXOOOOOOOOOOOXOOOOOOOOOOXOOOOOOXOOOOXOXXOXOOOOOOOOXXOOXXOOOOOO
OOOXOXOOXOOOOOOXOOXXOOOXOOOOOOXXOOOXOOOXOOOOOOXOOOXOXOXXOXXXOXOOOOOXOOXOOXXOXXOOOXOXXOOOXOOXOOOOOOXOO
OOOOOOOOOOOXOXOOOOOOOOOOOXOOOXOXXOOOOOOXXOOOOOOXOOOOOXOOOOOXXOXOOOOOOOXOXOOXOXOOOXOOOXOXOOXOOXOOOOOXO
XOOXOOOOOOOXOOXOOOOXXOOOXXOOOOOOOOOOOOOOOXOOOOXOOXOOXXXXXOOXOXOOXOOXOXOOOOOOOXOXOXXXOOOOOOOOOOOOOOOXO
OOXOOXOXXOOOOOOXOXOOXOOOXOOXOXOXOOOOOOOOOOOOOOOXOOXOXXOOXXOXOOOOOOXXOXXOOXOXOOOXOXOXXOOOOXOOXOOXOXOOX
OOOOOOOOXOOXOOOOXOOXOXOOXOOOXOOXOXXXXOOXOOOOXOXOXOOOXOOOOOOOOOOOOXXOXOOOOXOOOXXXOXOXOXOXOOOXXXOXOOOOX
OXXOOXXOXOOOOOXXOOXOOOXXOOOOOOOOOOOOOOOOOOOOOOOOOOXOOOOOXOOOOOOXOOOOOOOOOXOOOOOOXOOXOOXXOOOXXOOOXOOOX
OXXOOOOOOOOOOOOOOXOOXOOOOOOXXXOOOOOOXOOOOOXXXXOOOXOOOXOOXOOOOOXXXXOOOOOOXOOOOOOOXOOOOOXXOXXOOXOXOOOOO
OOOOOOOOOXOOOOOXXXOXXOOOOOXOXOXXOOOOOOOXOOXXOOOOOXOOOOOXOXOXOOXXOOOOOOXXOOOXXOOOOOOOOOOOXXXXOOOXXOOXX
OXXOOOOOXXOXXOOXOOXOOOOOOOXOOXXOOXOOXXXOOOOXOOOXOOOOOOOOXOOOXOOOXXOOXOOXOOOXXOOOXOOOOOOXXOOOOOOOOOOOO
OOOXXOOOOOOXXXOOOXOOXOXOOXOOOOOXOXXXOXOOOXXOOXOOOXOOXOOOOOOXXXXOOOOOOOXOOOOOOXOOOXOOXXOXOOOOOOOXXOOOX
XXOXOOOOXOXOOOXXXXXXXXOOOOOXOOXOXOOXOOOXXOXOXOOOOOOOOOOOOOOXXOXOOOOOOOOOOOOXXOOXOOOXOXOOOOOOOXOOOOOOO
XOOOOXXXOOOOXXXOOXOOOOOXOOXXOXXXXXOXXOOOOOOOXOOOOXOXXXOOOOXOXOXOXOOOXXOXOXXOXOOXOOOOOOXOOOOXXOOOOXOXO
OOOXOOOOOOOOXXOOOXOOOXOOOOOOXOOXOOOXXXOOOOOXOOOXOOOXOXXOOXXXXOXOOOOOOOXOOOXOOOXOXOXXOXOOOOOXOXOXOXOOO
