OXOXOOOXOOXXOXOOOOOOOOOOOOXOOXXXOXXOOXOXOOOXXOXOOOOXOXOOOOOXOXXOOOOXXOOXOXXOOOOXOOXOOXXOOOOOXXOXOOOOX
XOXOOOOOOOOOOOXXOOOXOOOOOOOOOOXOXXOOOOOOOOXXOXOOOOXOOOOXOOOOOXOOXOOOXOXOOOXOOOOXOXXXOOXOXOOXOOOOOXXOO
OOOOXOOOOOOXOXOOXOXOXOXOXOXOXXXXXOXOOOOXXOOOOOOOOOOOOOOXOXOOOOOOOXOOXXOOOOOXOOOOOOOXXOXOOOXXXXOXXXOOO
XXOOOOXOOOXXXXOOOOXXOOOOXOOOOOOOOOOOXOXXXOOOXXOXOXOOOOXOOOOOOXOOOOOOOXXOXOOOOOOOXOOOXXXOOOOOOXOOOOOXX
OOOXXOXOOXXOOOOXXOXOOOOOOOOOXOXOXOOXOOOXXOXOXOXOOXXOOOXOOOOOXOOOOOOXOXOOOOOOOOOOXOOOOOOXOOOOXOXOOOOOO
OOOXXXOXOOOOOOOXXOXOOOOOOXOOOXOOOOOOOOXOXXXOOOOOOOOOOXOXOOOOOOOOOXXXOXXOXOOXOXOOOOOOOOOXOOOOOXOOOOOXO
XOOOOOOOXOXXOOOXOOOOOXXOOOOOXOOXXOOXXXOXOXOOOOXOOOOXXXOXOOXOOOOOOOXOOOOXOOOXOOOXOXOOOOOOOOXOOOOXXXXXX
OXXXXOOOOOOOXOOOOXOXOOOOOOOOOOXOXXOXOXOOOOOXXXXOXOOOOXOOOOXOXOXOOOXXOOXOXOOOOOOXOOOOOOOXXXXXXOOXXXOOO
OOXOOOOOOOOOOOOOOOOOOOOXOOOOOOOXXXOOOXOOOOXOXOOOOXOOOOXOXXXOOOOOOXXXOOOOOXXXOOOOOOOOOOOOOOOOOOXXOXOOO
OOOOXXXOXXOOOXOOXOOXXOXOOXOXXOOOOXOOXOOOOXOOOOXOOXOOOOOOOOOOOXXOOOOOXOOOOXXOXOOXXXXOOOXOOOOXOOXOXOOOX
XXOXOOXOXOOOOXXXOOOOOOOXOXOXXXOOXOOOOOXXOOXOOOOOOOOXXXOXOOXXOOXOXOXOXXOOOOOXXXOOOOOOOOOOOOOOOOOXOXOOO
OOOOOXOOXOOOXOOXOOXOOXOXOXOOOOXOOOOOXOXXOOXOOXOOOOOOOOXOOOOOOXOXXOOOOOOOOXOOOOOOOOOOOXXOOOOOXOOOOOOOX
OOOOOOOOOXXXOXOXXOOOOOXOOOOXOXOOOOXXOXOXOOOOOXOOOOOOOXOOOOXOOXXOXXOXOOOOXOOOOXOXOOXXOOOOXOXOXXOOXOOXO
OOOXXOOOXOOOXXOXOOXOOXOXOXXOXOXXXOOOXXXXOOXOXOXOOOOXXOXXXOXXOOOXOOOXOOOOOXOOOOOOOXOXOOOOXXOOOOOOOXXOX
OOOXOOOOXOXXOOOOOOXOOOOOXOOOOOOXXOOXOXOXOOOOOOOOOOOOOOOOOOOOOOOOOOOXOXXOOOXOOXOOOOXOXXOXOOOOOOXOOOXOX
OOOOOOOOOOOOOOOOOOOOXOOOOOXXOOOOOXOXXOOOXOOOXOOOOXXOOXOXXOOXOOXOOOOOOXOOXXOXXXOXOOOOOOOOOOOXOOOOOOOOO
OOOOOXOOOOOXOXOOOXOOOOXOOOOOXOXOOOOOOXOOOXOXOXOOOXOOOOOOOXOOOXXXOOOOOOXOOXOOOOOXOOOOOXOOXOOOOOOOOOOXO
OOOOOOOOXOXOOOXOOOXXOOXOOOOXOOXOXXOOOXOOOOOXOOXOXOXOOXOOOOOOOXXXXOOOOOOOXXOOOOOXOOOOXOOXOOOOOOXXOOOOX
XXOOOXOOOXOOXXXOXOOXOOOOOOXOOXOOXOXXOXOOOOOXOXOOXXOOOXOXOXOXOOXOXOOOOOXOOOOOOOXOOXOOXOOXXOOOXOOOOOXXO
OOOOOXOOOOOOOOXOOOXOOOOXOOOOOOOXXXOXOXOOOXOOOOOOOOXOOOOXOOOOOOOOOOOOXXOOOOOOOXOOOOOOOOOOXOOOXOOXXOOOX
OOOOOOXXXOOOXOOOXXXOOXOXOXOOOXOOXOOXOOOXOOOOXXOOOXOOXOOXOOXOOOXOXOOOOOOXXOOOOOOOXOOXXOXOOOOXOOXXOOOOO
OOXOOOOOOOXOXOOOOOOOOOOXOOOOOXXXOOOOXOOOOOOOOXOOOOOOOXOOOOOXOXXOXOOOXXXXXOXOOOXOOXOOXOXXOOOXOOOOOXXXX
OOOOOOXOOOOOXOOXOOOXOOOOXXXOOOOOXXOOXOOXXOOXXOOOOOOOXXXXXXOOOXOOOOOOOXOXXOOOOOXOOOOOOXXXXXXOXXOXXXXXO
XOOOXOOXOXXXOXOOOOOXXOOOXXOXOOXOOXOOOOOXOXOOOXOOOOOOXOOOOOOOXXOOXOOXXOOXOXOXOOOOXXOOXOOXXOXOOOOXOOXOO
XOOXXOOOOOXOXOOOOXOOOOOOXOOOOOXOOOXOXOOOXXXOOOXOXOXXOOXOXOXOOOOOOOOXOOOOOOOOOOXOXOXOOXOXOOOXOOOOOOOOO
OXXOOOXXOOOOOXOOOOXOOXXOOOOXOOOOOOOXXOOOOOOXOXOOXOOOOOOOXXOOOOOXXXXOOXOOOOOOOOOOXOXOXOOXXXOOXOOXXOXXO
OXOOOXXXOOXOOOOXOOOXOOOXOXOOOOXOXOOXOXXOOOXOOOXOXOOOXXOOXOOOXXOOOOOOXOXOOOXXOXOXXOOXOOOOOOXXXOOOXOOOO
OOOOXXOOOOXOXOOOOOOOXOOOOOOOOOOXOOOOXOOOXOXOOOOXXXOXOOOOXOOXXXXXOOOOOOOXOOXOXXXOOOOOOXOOOOOOXXOOOXOOO
XOOOOXXOXOOXXOXOOXOXOOOOOXXXXOOOXOXXOOOXXOOXOXOOXOXOXXOOXOOOOXXXXOOXXXOOOXOXOXXOOXOOOOXOOOOXOXOXXOXOX
XOOOOXXXOOXXOOOXXOOOXOOOXOXXOXOOOXOOOXOXOOXOXOOOXOOOOOXOOOOOXXOOXOOOOOXXOXOXXXOOOOOOOXOOOOXOOOXOOOOXO
OXOOXOOXOXOOXOOOXOXOXOOOXOOOXXOOOXOOXOOOOOOXXOXXXOXOOOOOOOOXOOOOXOOOXOOOXXOOXOOOOOXOOOOOOXXOXOOXOOOXX
OXOOOOOXOOOXOOOOXXOXOOXXXOOXXOXXOOOOOXOOXXOOXXOXXOOXOOOOXOOXXOOXOXOOXXXXXOOOOXOXXXOXOXXOOOOOXOOOOOOOO
XOXXOXOOOOOXOOXOXOOOOOOXXXOOOXOOOXXOXOOXOXOOXOOOXOXXOOXXOOOOOOOXOOXOXXXOOOOXOOOOOOOOOXXOOOOOOXOOOXOOO
OOOOXXXOOXXOOOOXXOXXOOXOOOOOXOXXOOOXOXOXOXOOOOXXOOXOOOXXXOOOOOOXOXOXOOXOOXOOOXOXXXOXOOOOOXXXOOOXOXOXO
OOOOOXOXOOOXOOOOOXOOOOOXOOXOOXXXOOOXOXOOOOOXXOXOOOOOOXOXXOOOOOOOOOOOOOOXXXOXOOOXXOOOOOXOOXXXOXOOXOOOO
XXXOXOXXXOOXOOXOOOOXOOOOXOXOXXXXOXOOOXOOXOOOOOOOOXOOOOOOXOOXOOOXXOOOXOXOOOOXOXOOOXOOXOOOXXXOXXOOOOOOO
OOXOOOOXOOXOXOXXOOOXOXOOOOXXOOOOOOOXOOOOOXOXOOOOOXOOXXOOOOOOOOXOOOXXOOOOOOOXOOXOOOXXOXOOOOOXXXOXXOOOX
OOXOXXXXOXOOOOOOXXXOXXOOOOOOOXOOXOOXXOOOOOOOOOXOOXOXOOOOOXOXXOOOXOOOXOOXOOOOOOOOOOOOOOOOOOOXXXXOOOOXX
OOXXOOOOOOXXOOXOOOOXOXXOOOOOOXOOOOOOOOOXXOXXXOOOOXOOOOOXOXOOXOOOOOXOOOOXOXOOOOOOOOXOXXOOOXXOOOXOOXOXO
OXOOXXOXXOXOXOOOOOXOXOOXXOXOXXOOOOOOOOXOOOXOXOXOOOOOOOOOOOXXXXOOOOOOOXXXXXOOXOOOOOOXOOXXOOXOOOOOOXOOO
OXOOOXOOOXOOOXXXOOOOOOOXOOXOOOXOOXXOXXOOXOOXOXOXOOXXXOOOXOOOOOOXOOXXOOXOOOXOOXXOOXOOOOOOOXOOOOOOXOXOO
OOXOOOXOOOOXXOOXOOOXOOXOOOOOOXOXOOXOOOOOOOXOOOOOXXOOOXXOOOOOOOOOXOXOXOOOXOOXOXOOOOOXOOOOXOOXOOOOXOOOO
XXOXOOOOOOXOXXOXXOOXOOOOOOOOXOOOXOOXOXOXOXOXOOOOOXOOOOXXXOOOOOOOOXOOOOXXXOOOOOOOOOXOXOOXXOOOXXXOOOXOO
OOXXXOXXOOOOOOXXXOOOXXOXOOOOOOXXOXXOXOOOOOOOOOOOOOOXOOXOXXOXOXXOXOXOXOOXXOOOOOOOXXOOOOOXOOXOOOXOOOXXO
OOOXOOXXOXOOOOOOOOOOOOXOXXOOOOOOOXXXOOXOXOOOOXXOXXOOOOXOOOXOXOOXOOOOOOXOOOOOOOOOOOXXOXOOOXOXOOOOOOOOO
OOOOOOXOOXOOOOOOXOOXXOXOOOXOOOXOOXOOOOOOOOXOXOXXOXXXOOXXOOXXXOXOOOOOXXOXXXOOOOXOOXXXXOOOOOOOOOOXOOOOX
OOOOOOOXOXXXOXOXOOOOOXXXOOXXOXOOXXOOOOOOOOXXXXOOOOXOOXXOXOOOOOXOOOOOOXOOOOXOOXOOOXXOOOXOOOXXXOOOOXOOX
OOOOOOOOOOXOOOOOOOXOOXOOXXOOOOXOOOOXOOXXOOOOXOOOOXOOOXOOOOOOOOXOOOOOXXOXOXOOOOOOOOXXOOOXOXOOOXOXXOXXO
OOXOOOOOOXOOOOXXOOOXOOOOOOOOXOXOOOXOOOXXOXXOOXOOXXXOOXOOXXXOOOXOOOXOOXOOOOOOOOXXOOXOXOOOOOXOOOOXOXXOX
OXOOOOOOXXOOOOOOOOOOOOOOOOXOOOXOOXXOOXOXXXOXOXOOXOOOOOOOOXOXOXOOXOXXOOOXXOOXOOOOXOOXOOXOXOXOOOOXXXOOO
XOOOOOOOOOXOOXXXOOOOOOOOOXOOOXXOOOXOOOOOXOOOOOOOOOOOOOOOOOOXOOOOXOOOOXOXXXXOXXXOOOOOXXOOOOXOOOOOOOOXO
XXXOOOOXOOXXOOXXOOXXOXOXOXOXOXOOOXXOXOOXXOOXXOXXXOXXXOOOOOXOOXOOOOXOOOOXOOOOOOOXXOOOOXXOXOOXOOOOOXXOX
OXOOOOXXOXOOOOOOOOOOOXOOOOOOXOXOOOOOOOXXOOOOOOXOOXOXXOOOXOOXOOOOOOOOXOOOOOOOOOXXXOOXOOXXOOOXXOOOOOOOO
XOXOOXOOOOXOXOXOOXOOOOOOOOOOOOOOOOOOXXXOOXOOOOOOOOOOXXOOOXOOXOOOOOOXOOXOXXOOXOOXXOOOOXOOOOOXOXXOXOXOO
OOOOOOOOOOXXOOXOOOOOOXOOOXOOXXOOOXOXOOXXOXOXOXOOXOOOOOOXOOOOOOXOOOOOXXXOOOOOOOXOXOOOOOOXOOXOOOOOOXOOX
OOXOXOOOOOOXOOOOXOOOOXXOOXOOXOOXOXOXXXXXXOOOOOOOOXOXOOOXOXOOOXXOOOOOOXOOOXXXOXOXOOXXXOXOOOXXOOOXOOOOO
OOXXXOOOXOOOXXOXOOOXOOXOXXOOXOXOOXOOOXXXOOOOOOXXOXOOOOOXOOOOOXOXOOXXOOOXOXOXOOOOXOOXOOOOOOOXOOOOOOOOO
OOXXOOOOXXOXXXOXXXOOOOXOOOXXOXOOOXXOOXOOOXOXXOOOXXXOOOOOOOXOOOXOOOOXOXXXOXOOXOOOOOXOOOXOOOOOXOOOXXOOX
OXXOOOXOOOOOOOOOOOOOXOOXOXXOXOXOXOOOOOXOOOOOOXXOOOXOXOOOOXXOXOXOXOOOXOOXOXOOXOOOOXOOXOXOOOXOOXOXOXOOX
XOOOOOOOOXOOXXXOXOOOOOOOOXOXOOOOOOOOOOXOOOXOOOOXOOOXOOOXOOXOOOXOOXXOOOOXOOOOXXXOXOOXXOOOOXOOOOOOOOXOO
OOOXXOXOOXOOOOOOOOOXOOXOOOOOOXOXOXXXXXOXOOOOXXOOXXOOOOOOXOXOOXOOXXXOXXOOOOOXOOOOOOOOXOOOXOOOOOOXOOXOO
OXOXOOOXOOOXOXOOOOOOOOOOOOXOOOOOXOOOOOOOXOOOOOOOXOXOOOOXXXOOOOOOOXOOXXXOOOOXOOXOXOXXOOOOXXOOOOOOOOOXO
XOOOOXXXOXOXXXXOXOXXOOOOOOXXXOOXXXOXOOOOOOOOXOXOXOOXOOOXOOXXOOXOOXOXOXOXOXOOOOOXOOOOXOXOXXXXXOOOXOOOX
OOOOOOXOXOXXOOOOOOOOXOXXXOXOOOOXOOOXOXOOOXOXOOOOXOOOOOOOOXOOOOOXOXOOXOXXOOOXXOOXOXOOOOOXOOXOOXOOOXOOO
OOOOXOOOOOOXXXOXXOXOOOOOXOOXOXOOOOXXOXOOOXOXOOOOOXXXOXOOXOOOOOOOXXOXXOXOOOOXOXOOXXOOOXOOXXOXXXOOOXOXX
XOOXOXOOXOOXOOXXOOOOOOOXOXOOXOOXXXOXXOOOXOOXOOXXXOXOOXOXOXOOXOOOXOOXXXXOOOOOOOXOOOOOOOOOOXOOXXXXOXOOO
OXXOOOXOXOXOOOXOXOOOXOOOXOOOOXOOOXOOOOXOOOOOOOOOOXOXOOOXXOXOOOOOOXOOOOOOOOXOOXOXOXOOOOOOOOOXOOOOOOOXO
OOXXOOOXOOOOOXOXXXOOOXOXOXOXOOXOOXOOOOXOXOOXOOXOOXXXOOOXOXXXOOXOOOXOOOOXOOOOOXOOOOXOXOOXXOXOOXOOOOXOO
OOXXXOOOOOOXOOOOXOXXOXXOOOOOOOOOOOOOOXXOXOOOXOXOOOXOXOOXOOXXOOXOOOOOOOOOOOOXOOOXOXOOOOXOXXOOXXOXOOOOX
XOOOOOXOXOXOOXOOOOOXXOOXOOXXOOOOOOOOOOXXXOOOOOXOOOOXOOXOXXOOOOOOXOOOOXOXOOOXOXXOOOOOOOOXOOOOXOXOOOXXO
OOOOOXOOOXXOOXXOXOXOOOXOXXOXOOXOXOOXXOOOXXOXOOXOXXOOXOOOOOOXOXOOXOXXXXOOXOOXXOOOXOXOOXOOOOOOOOXOOXOOO
OOXXXOXOOOXOOOXOXOOOOOOOXXOXOOOOOOOOOOOOXOOXXOXXOOXOOOXXOOOOOOOOOOXOOXOOOXXOOXOOOOOXXOXXXXOOXXXOOOOOO
OOXOOOOOOOOXOOOOXOXXOOOXXXOOOXXXOOOOXOOOOOOXOOOOOOXOOOOXOOXOOOOOOOOXOOOOXOOOOOOOOOOOOOXOXXXXOOOOOOXOX
OOOOOOOXXOOOOOOOOOXOOOOXOXOXXOOOOOXOXOXOOOOOOXOOOXOOOOOOXXOOOOOOXOOOXOOOXOOOXOOOOOOXOOOOOXOXXXOOXOOXO
OOOOOXOXXOOOOOOOOOXOOOOOOOOOOOXOOOOOOXXXOXOOXOOXOOXXOOOOOOOOOOXXXOOOOOOXXOOOXOXOOOOXOOOOOOXOOOOXOOOOX
OOOOOOOOOXXOXXOXOOXXOOXOOXXOOXOXOOOOOOOOXOOOOXXOOOOOOOOOXOXOXOOOOOXXOOXXOOOXXOOOOOOOOOOXXOOOXOOOOOOOX
XOXXOOOOOOOOOOOXOOXXOOOXOOOXOXOOXOOXOXOOOOOOOOOOOOXXXOOOOOOOOXOOOXOOOXOOOXOOOOOXOOOOXOOOXOOOXOOOXOOXO
OXOXOXOXOOOXOOXOXOXOOXOOXOOOXOXOOOXOOXXOOOOOXOOXOXOXOXOOOOOOOOXXOOOOXOOOOXOOOOOOOOOXXOXOOOOOOXOOXOXOO
OOOXOOXOXOOOOOOOOXOOXOXOOXXOXOOOOXXOXXXOOOOOOOXOOOOXOOOOXOXOXOOOOXXXXOOOXOOOOOOOOOOOOXOOOOXOOXOOXOOOO
OXOOXOXOOOOOOXOOOOOOXOOOOOOXOOXOXOOOOOOXOOOOOOOOOOOOXOOOXOOXOOOXOXXOOOOXOOOOOXXXOOXOXOOOXOXOOOXOOXOXO
OOOOXOOOOOOXXXOOXXXOOXOOOOXOXOOOOOOOOXOXOOOOOOOOOOOOOOXXOOXOOXOOOOOOOOOOOOOOOXOOOOOOOOOOXOOOOXOOOXOOO
XXOOXOOOOOOOOXXXOOXXOOXOOOXOOOOOXOXOOOOOOXOXXXXXXXOXOXOOOOXOOOOOOXXOOXOOOXOOOOOOOOXOOOXOOXOOOOOOOOOOX
OXOOOOXXOOXOXOOOOXOXXOOOOOOOXOOXOOOOXXXOOXXOOOXOOXOXOOOXOOOXOOXOOOOXOOXOXXXOOOXOOOXOOXOXOOOOOXOOOOOXO
XOOOOOOXOOOOOOOXXOOOOOOXOOOXXOOXOXOXOOOOXOXXOOOOOOXOOOOXOOOOOOXOOOOOXOXOOOOOOOOOOOOXOOXOOXOOXOOOXXOOO
XOXXOXOOXOXXXXOOOXOXOXXOOOOOXXOOXOOOOOXXOXOXOOOOOOOOXXOOXOOOOXOOXOOXOOOOOOOOXOOXOOOOXOOOXOOOOOOOOOXOO
OXXXOOXXOOOOOOOOXXOOOXXXOOOOOOXOOXXOXOOOOXXXXXOXOXOXXOOOOOOXXOOXOXOOOOXOXOOXOXOXOXOOOOOOOXOOOXOXOOOXO
OOXXOOOXOXOOOOOOXOXXOOXOXOOXOOXOXOXOOOOOOXOOOOOOOOOXOOOOOOOOOOXXOOXOOOOOOOOOXXOXOXOXOOOOOOOOOOOXXOOOO
OOOXXXOXXOXOOOOXOOOXOOXOXOOOOOOOOOOOOOOOOXOOOOOXOOOOXOOXXOOOOOXOOOOXOOOOXOOXXOXOOOXOOOOXOOOOOXXXOOOOX
OOOXOOXXOXXXXOOOOXXOOXOOOOXXOOOOOXOXOOOOOOOXOOOXOXXOOOOOOOOXOOOOOOOOOOXXXOOOOOOOOOXXXOOOOOOOOXOXOXOXX
OOOOOXXXOOXOOXOOXXOOOOOXXOOOOXOOOXXOXXXOXOOXOXOOOOOOOXXOOOXOOOXOXOXOOOOOOOOOXXOOOOXOXXOXOOOOOOXXXOOXO
OOXOOXOOOXXOOOOOOOOOOXXXXOXOOOOXXOXXOOOOOOXXOOOOOOOOOOOOOXXOOOOXOXOOOOOOOOOXOOOXXXOXOXOOOOXXOXOOOOOXX
OOOOXXOOXXXXXOOXOXXOOXOOOOOOOOOOOXXOXOOXXOOXOOOOOOOOOOXOOXOXOOXXOOOXXOXOOOOOXOXXOXXXXOXXXOXOOOOOOXOOX
XOOOOXOOOOOOXOOXOOXOOOOOOOXOXXOOOXXXOXOXOOOXOOOXOXOOOXOOOOXOOXOOOOOOOOOXOXOXXXOOOOXOOXOOOXOOOOOOXXOOX
XXXOOOXOOOOOXOOXOXXOOOOOOXOXOOOOOXOOOOXOXOOOXOOOXOOXXOOXOOOXOXXOOOXOOOOOOOOXOOXXOXOOOXOXOOXOOOXOXOXOO
XXXOOOOXXXOOOOOXOOOOOOOOOOOOOOOOOXOOOOOOOOOOOOOOOXOXOXOOOXOXOOOOOOOOXXOOOXOOOOXOOXOOOXOXXOOXOOOOOXOXX
OOOXXOXOOXOOOOOXXOOOXOOXOXXOXXXXOOOOXOOOOOXOOXXOOOOOOOXOOOOOXXOXXXOOXOOXXOOXOOXOOOOXOXOXOOOXOOXXXXOXX
OOXOXOOXOOOXOOXOOOOOXXOOOXOXOOXOXXXXXOOXOXOOOXOOOOOOOXOXOOOOOXOOOOOOOOXOXOOOOOOOXXXXOOOOOXXOXOXOXOOXX
XXOXOXOXXOOOXXXOOOOXOOXOOOOOOOOOOOOXOOXOXXOOOXOOXOOOOXOXOXOOOXOXOXOXOOXOXOOOXOOOXXXOXOXOOOXOOXXXOXOOO
OOXOXXOOOXOXOOOOOXXOOOOOOXOOOXXOXOXOXXXOOOOOXOOXOOOXXOOOOOOOOOOOXOXOXXOOOOOOOOXOXOOOOOOXOXOXOOXOXXOOO
OXXOOOXOOXXOOOOOXOOOOXXOOOXOXXOXOOOOOOOOOOXOOXOXXXOXOXOOXXOOOOXOXOXOOOOXXOXXXXOOOOOOOOXOOXOOOOOOXOOXO
XOXOOOXOOOXOOOOOOOOOOOXOXOXOOOXOOXOOOOOOXOXOOXOXOXOOOXOOOXXOXOOOOXXXXOOOOOOOXOXOXXXXXOXOOOOOOXXOOXOOO
