OOOXOXOOOXOXOOXOOOOOOXOOOXOOOOXOOOOOOOOOOXOOOOOXOXOOOXOOOOOOOXOOXOXXOXOOXOXOXXOXOXOXXXOXOOOOOXXOOOXOO
OOOOXXOOOOXOOOOXOXXOXOOXXOOXOXOOXOOOOOOOOXOOOOXOOOOOXXOOOOOOOOOOOOOOOOXOOXOOOOOOXOOXOOOOOOOOOOXOXOOOO
XXOOOOOXXXOOOOXXOOOXOOXOOOXOOXOOOOXXOXOOXXOOOOOXOXOXOOOXOOXOXOOOOOOOXXOOXXOXOXXOOOOOOOXOXOOXOOOXOOXOX
OXOOOOOXOOOOOXOOXOXXXOOOOOOXXOOXOXOOOOXXXOOOOOOOXXOOXXOOOXXOOOOOOOXOXOOOOOOXOOOOOXOXOXOXXOXOOOXOXOOOO
OOOXOOOOXXOOOOOXXXOOXOOOOXXOOOOXOOOOXXXOOOOOOOOOOXXXXOOOOOOXOOOOXOXOXXOOOOOOXXOXOOOOOOOOXOOOOOXOOOOXX
OOXOXXOOXXOOOOOXOOXOXXOOOOXOOOOOXOOXXOOXOOXOXOXOXXXOXOOOOOOOXOOOXXOXOOOOOOXXXXOOOOOXOOOOXOXOOXXOXXOOX
XOOXOOOOOOOOOOOXOOOOOXOXOOXOOOOOXXXOOOXXOOXOOOOOOOOOOOOOOOOOXOOOOOOXOOOOOXOOXXXOOOXOOOOOXOOOOOOOXXOOX
OOXOOXOXOOXXOOOOOOOOOOOOOOOOXOXXOXOXOOXOOOXOXXOOXOOOOOOXXOXOXOXXOXOOOOXXOOOXOOXOOOOOOXOXXOXOOXXOOXOOX
XXOOXOOOOOOOOOOOXOOOXOOOXOOXOOOOOOXOOOOOOOOXXOOXXXOXOOOOOXOOOOXOXXOOOOOXXXOXOXOXOXOOOXOOOXXOXOOOXXOOX
OOOOOOOOXXXXOOXOOXOXXOOOXOOXOXOOXOOOXXOOOXXOOOOOXOXXXXOOOXXXOXOOXOOXOOXOOOOXOOOXXOOOXXOOOOXOOXXOOOOOX
OOXXXXOOOOOOOXOXOOOOXOXXOOXXOOOOXXOOOOOXOOOOOOOOOXOOOOOOOOOOOOXOOOOOOXOOOOOOOOXXOOXOOOOOOOOOOOOOXOXOX
XOOXXOOOXOOXOXOXOOOOOOXXOOOXXOOXOOXXOOOOOOXOXXOOXOXXXOXXOOOXOOOXOXOOOOOOOOOXOOXOXOOOOOOOOOOXOOOOOOOOO
OOOXOOXOOOOXOXOOXOOOOXOOOOOXXOOOOOOOOOXOOOXOOOOOXOOOXOOOOXOXOOXOOOOOXOOXOOOOOXOOOOXXXXXXXOXXXOOOOOOXO
XXOXOOXOXOOXOOOOOXOOOXXXOXXXOOOOXOOXOXOXXOOOOOOOOOXOOXOOOXOXXOOOOOOOXOOXOOXOXOOOOOOOXOOOOOOOOXXXOOOXO
OOOOOOXOOXOOOXXOOOOXXOXXOOOOOXXOOOOOXOOOOOOOXOOOOXOOXXOXOOOOOOOOXOXXOOOOOOOOOOXXOXOOOXXXOOOXOOOXOOOOO
OOOOXOOXXOOXXXOOOOOOOXOOXOXXOXOOOOOOXOOOOOOOOXXOOOOOXOXOOXXOOOOXXOOXOXOXOOOOOOOOOXOOXXXOOOXOOOOOXXXOX
XOXOOOXXOOOXOOOOOOXOXOXXOOOXXXOOOXOOXOXOOXOOXOXXXXOOOOXOOOOOOOOOOOXOOXOOOOXOOXOXOOOOOOXOOOXOOOOOOXOOO
XXXOOOOOOOOOXXOOXXOOXOOXXOXXOOOXOXXOOXOOOOXOOOXOOOOOOOXOOOOOXOOOXOOXOOXOOXOXOXOXOOOOOOOXOOOXOOOXOOXOO
OXOXOXOXXXOXXXXOXOXOOOOXOXOXXOOXOOXOOOOOOXOXOXOOOOOOOOXOOXOXXOOXXXOXOXXXXOOOOOOOXOOXOXOOOOOOOOOOOOOOO
OXOOXOXOXXOOXOXOXXOXOOOOOXXXOXOXOXXOOOOOOOOOOOXOXXXOOOXOXOOOXXOXOOOXOXOXXOOOOXOOOXOOOOXOOOOXXXOOOOXOO
OOOXOOOOOOOOOOOOOOXXOOXOOOOOOXOOOOXOOOXXOOOOOOOXOOXOOOXXOXXOOXOOOXOOOXOOOOOOXOOOXOOOOOXOXOOXXOOOOXOXX
OOXOOOOOOOOXXXXOOOXOOOXOOOXOXOOOOOOOXOOXXXOOOOOXOOOOOOOOXOOOOOXXXXXOOOOOXOXOOOXOOOOOXXXOOOOOOOXOOOXOO
XOOOXOOOOXOOXOOOOXOOOOOXXOOOOXXOOOOOOOOOOOOOOXXOOXXXOOOOOOOOOOOXOOOXOXOOOOOOXOOXXOOOOOOOOOOXXOOXOOOXO
OOOOOXXXXOOOOOOOOXXXOXOOXOOXOOXOXXOXXOOOXOOOOOOOOXOOXXXOOOOXOOXOOOOOXOOOOOXOXOXXXOOOOXOOOOOOXOXXXXOOO
XOOOOOOOOOOXOXXOOOXOXOOXOOXXXOOXXOOXOOXOXOXXOXOOOOXOXOOXOOXXOXOOOOOOOXXOOXOOXOXOXOOOXOXOXOOXOOOOOOOOX
OXXXXOOOXXOOOXOOOOOOOOOOOOOXXOOXOXOOOOOOOOOXXOOXXOOOXXXXOOXOXOOXOOOOOOOOOOXOXOXOXXOOXOOOOOOOXOOOOXXOO
XOXOOOOXXOXXXOOOOXOOOOOOOXOXOOXXOOOOOOXOOOXXOXXOXOOXOOOOOOOOOOOOXOOOXXOXXOOOOXOXOXXOOXOOOOXXXXXOXOXOX
OOOOXOOOOXXOXOXOOOXOOOOOOXOXXOOOOOOOOOOXOOOOOOOOXOOOOOOXXOXOOXOXXOXOOOXOOOXOOXOOXOXOOOOXXOXOOXOOXXOXO
XOOOOOOOOXOOXOOOOXXXOOOOXOOXOOOOXOXXOOOOOOOOOOOOOOOOOOOOOOOOOOOOOOXXXOXOOXOXOOXXXXXOOOOOOOXOXXOXOOXOO
OOOOOXOOOOOOOXOOOOXOOXOOOXOXOOOXXOOXOOOOOXXOXXXOXOOXXXOOOXOOOXOXOOOOOXXOOXXOOOOXOXXOOXOOOXXXOXXOXOOOO
XOOOXXXOOXOOOXXOXXOOXOOOOOOOOOOOOOXXOOXOOOOXOOXOOXOXOOOOOOOOOOOOOXOOXOOOOOXOOOXOXOOOOOOXXXOOOOOOXOXXO
OOOOOOOXOOXOXXOOOOXOOOOOOXXOOOOXXXOOOOOXOOXOOOOOOXOXXOXOOOOXXXXOXOOXOOOXXOXOOOOXOXOXOOOXOOOOOOXOOOOOX
OXXOXOOXOOOOXOOOOOOOOXOXXOXOOXOOOOOOXXXOOOOOOXOOOXOXOXOOOOOXOOOOXOOOOOOXOOXOXOXOXOXOOOOOOOOOXOXXOOOOX
OOOOOOOOOOXOOOXXOOXOOOOOXXOXOOOXOOOOXOOOOOOOXOOOOXOXOXOXXOXOOOXOXOOXOOOOOOOOOOOOOOOOXXOXOOOOOXOOOOXOX
XOOXOOOOOOOXOXOOOOOXXXOXOXOOOOXXXOOOOOOOXXXXOOOOXOOXXOXOXOOXOXXOOOOXOOXOOXOOOOOOOOOOOOOOOOOOXXOOXOOXX
XOOOOOOXXXOXOOXXOOOXOOOXXOXOOOOXOOOOXOOOXOOXOOOOOOOXOXXXOOXOXOOXOOOXOXOXOOOOXXOOOOOOOXOOOOXOXOOOOXOOO
OOOOOOXOOXOOXXXXOOOOXOOXOOXXOOOXOXOOOXOXOOOXOXOOOXOOOOXOXXOOXOXOXXOOXXOOOXOOOOOOXOOOOOOXXXOOXOOXOXXOO
OOOOXOOOXOOOOOXXOXXOXXXXXOOOOOXOXOXOXOOOOXOXOOOOOOOOOOOOOOOXOOXOXOOXOXOOXOOOOOXOOOOOOOOOOOOOXOXOOOXOO
XXOXOXOOOOOOOOXXOOOXOOXOOOOOOXOOOOXXOOOOOOOOXOOXOOOOOOOOOXOXXOOXXXXOOOOOOXOOXOOOOOOXOOOOOOXOOOXOXXOOO
OOOXXXXXOOOXOOOOXOXXOOOOOOXOOOOOOOXOOOXOOOXXOOOOOXXOXOOXXOOOOXOXOOXXOXOXOOOXOXXXOXXXXOXOOOOXXXOOOOOOX
OOOXOOOXOOOXOOOOOOOOXXOXOOOOOOOOOXOOOOOOXXOXXXOOOOOXOOXXOXOXOXOOOOXOOOOOXOXOOXOXOOOOOOOXOOOOOOOXOOXXO
XXOOOOXOOOOOXOXOXXOOOOXXOXOOOXXOXOOOXOOOOXOOXOOXOOOOXOOXOXXOOOOXOXOOXOOXOOOOXXXXOOXOOXXXOOOOOOOOOOOOX
OOOXXOXXOOOXOOOOOOOOXOOXOOOOOXOXXOOOOXOOOOOOXOXOOXOOXOOOOOOXXXOOOOOOOOOXOOOOOOOXXXOOXOXOOOOOOOOOOOOOO
XOOOOXOOOOOOXXOOXOOOXOXOOOOOOOOXOOOXOXOXOOOOXXXOOOXOOOXOXXOXOOXXXOOOOOOOOOOOOOOXOOOOOOOOOOXXOXXOOOOOX
XOOXXOXXXOOOOOOOOOOOOXXOXXOOOXOOXOXOOOXOOXXOOOOOOOXOOOOOXOOXXOOXXOOOXOOOOXOOOOXXOXXOOOOXOOOOXOXOOOOOX
OXOXXXXXOOOOOXOOOXXOXXOXOOOOOOOOXOOOOXOXXXOXOXOOOOOOOXOOXXXOXOOXXOXOXXOOOOXOOOOOOOOOXOOOOXOOOXOOXOOOX
XOOXOOOOOXXXOOOXOOOOOXXOXXOOOXOOXOOOXXOOOOOOXOXXXOOOXOOOOOOOOOOOOOOXOOXOOXOOOOOXOOOOOXXXOXOXXOXOXOOXO
XOOOOXOOXOXXXOOOXXOOXOOXOXOXXOOOOXOXOXXOOOXOXXOOOOOOOXOOOOOOXXOXOOOOXXXOOXOOXOXOXOXXXOOOOOXOOXOXXOXOO
OOOOOOOOOOOOOOXOOOOOXXOOOOOOOOOOOOOOOXOXOOXOOXXOOOOOOXOXOOXOOOOOOOOOOOXXOOXOOXXOOXOXOOOXOOXOOXXOXOOOO
XOOOXXOOOOXXOOXOXOXOXOXOXOOOOXOOOOOOOOOOXXOOXOOOOXXOOXOOXOOXOOOOXOOOOXOOOOXOXOOXXOXXOOXOOOOOOOXOOOOOX
OOOOOOXOOOOOXOOOOOOOXXOXOXXOOOXXOXXOOXOOOOXOOXOOXXOXOOOOXXXOOXXOOOOXOOOOOOOXOOOOOOXOXXXXOOXXOOOXOOOOX
OOOOXOOOOOOOOOOXOOOOOOOOOXOOOOXXXOOOXXOOXXXOOXOOXXOOOOOXXOOXOOXOXOOOXXXOOOOOOOOOOOXOXOOOXOOOXOOXOOOOO
OOOOOXXXOOOOOXOXOXXOOOXXOOOOOOOOOOXOOOXXOXOXOOXOOOOOXXXXXOXOOOOOOOOOXOOOXOOOOXXOOOOOXXXXXXOXOOXXOXXXO
XXXOOOXOXOOXOXOOOOOOOXXOXOOOOOOOXXOOXOOOOOOOOOXOXOOXXXXXOOOXOOOOOXXOOOOOXOOOOOXOXOXXXOOOOOOXOXOXOOOOX
OOOXOOOOOXXOOOXOOXOOOOXOOOXOXXOXOXOXOOOXXXXOOOOXOOOXOOOOOOOXXOOOXOOXOOOXXOOOOOOXOXXOOOOXXOXOXOOOOOOOO
OOOXOXOOOOOXOOXOOOOOOOXOOOXOOOOOXXXOOXOOXOOOXXXOOXXOOOOOXOOXOOOXOOOOXXOXOXOOXOOOOOOOOOOXXOOOOXOXOXOOO
OOOOOOOXOOOXOOOXXOOXXOOOXOXXOOXXXOXOXXOOOOOOOOOXOOOOOOXXOOOOOOOOOOOXOXOXXOXOXXOOOOOXOOXOOOXOOOXOOOXOX
OOOXXXOXOOXXXOOOOOXOXXOOXOOOXOOOOXOXOOOXOOOXOOOOXOXXXOXOXOOXOXXOXOXOXOOOOXOOOOOOOOOOOOXOOXOXOOXXOOXXX
OOOOOOOOXOXXXXOXXOXOOOOOOXOOOXOXOOXXXOXOOXOXOXOOOXOOOOOXOOOXOOOOOOXXOOXOOXOOOOOOOOXOXXOOOXOOOOXOXXXOO
OOOOXOOOXOOXXOOOOXOOOOOOXOOOXOOOXOOXOOOOXOOOOOOOOXXOOOXOOOOOOOOOOXXOXOOOXOOXOXXOXOOXOOXXOOOOOOOXOOXOO
XXOOOXOXOXXOOOOXOOOOOOOXOOOOXXOOOOOOOOOOOOXOOOOXOOOXOOOOOOOOOOOOXOXOOOOXOOOOOOXOOOXOOXXOOXOOXOXXOOOOX
XOOXOOXOOOXXOXOOXOOXOXOOOOXOXOOXXXXOOXOOXOOXOXXOOOOOOOXOXOOOXOXOOXOOOOOOOOOXOXXOOOOOXOOOXXXOXOXOOOXOO
OOXXOXOOOXOOXOOOXXOOOXOOXOOXOOOOOXOOXOXOXOXXOXOOOXOXOOOOXXOOOXXOOOOOOXOXOOOOOOXOXOXOOXXOXOOOOOXOOOOOO
OOOOOOOOXOOOOXXOOOOOXXOXOOXXOOOOOXXXOXOOOOOOOOOOXOOXOOXOOOOOXOOXXOOOOOXOXXOXOOOXXXOOXOOOOXOXOOXOXXXXO
OOXOOOOXOOOOOXOOOOOOOXXXOOOOOXXOOXXOOOXOOXOXOXOOOXOOOXXOOXOXOOOOXXOOXXOOXOOOXOOOOOOOOOXOOXXXOOXOOXXXO
OXXXXOXOOOOOXOOOOOOOOOOXOOXOOXXOOOXOOOXOOOXXOOXOXOOXXOOXOOXOXOOOOOOOXOOOOOOOOOXOOOOOOOOOOOOOOXXOXOXXX
XOOXXOXOXOOXXOOXXOXXOOXOXOXOXOOOOOXOXXOXOOOXOOOXOOOOOOOXOXXXOOOOXOXXOXXOOXXXXOOOOXOOOOOOOXOOOOXOOOXOX
OOXXOOOOOOOOXXXXOXOXOOOXXXOOXOOOOXOOXOXXOOXXXOOXXOXXOXOOOXOXOOOXOOOXXXOOOOXOOOOOOOXXXOOOXXXOOXXXOXOOO
OXOOOXOOOOOOOOOOOOXOOOOOOOXOOOOOXOOOOOOOOOOXOOXOXXXOOXOOOOOXOOXOOOOOOOXOOOOOOXXXOOOOOXOOOOXXOXOOOOXOO
OXOOOOOOXXXOOOXOOOXXOXOXOOOXOOXOOOOOOXXXOXXXOOXOOOOOOOOOOOOXOXOOOOOXOOOXOXXOXOOXOXOOOOOOOOOOXOOOOOXXO
XXOOOOOOOOOOOOOXOOOOXXXXOOOOOXOOOOOOOXOOXOXOOOXOOOOXOXOOXOOOOOOXOOOXOOXXOOOOOXOOXOOOOXXOXOOOOOOXOXXOO
OXOOOXXOOXOOOOOXOOXOOXOOOOOOOXOOOOOOOXOOOOXOOOOOXOOXOOXXOOOOOXOOOXOXXXOOXOOOXOXOOOXXOOOOOOOOXOOOOOOOO
OXXOXOOOOOOXOOOXOXXOXOOOOXOXOOOXXOOOXOOOOOOOOOOOOOXXXOOOOXOOOOOOOOOXXOOOXXOOOOOOXOXOOOOXOOXOOXXOOXOOO
XOOOOOXXXOOOOXOOXOOOOOOOOOOOOXXOOOOXOXXXOXOOOOOOOOOOOOOOOOOXOOOOOOOOOXOOXOXOOOOOXXXOOOXOOOOOOOOXOXXOO
XOOOXXOXOOXXOOOXOOOOOOOXXOOOXXOOOOXOXXOOXOOOOOOOOOOOXOOXOOXOOXOOOXOXXOOXOOXXOXOOXOXOOOXOOOOXOOOOOOOOO
XOOOOOXOXXOXXOOOOXXOXOOOOXOOOXOOOOXOOXXOOOXOOOOOOOOOOOOOOOOXOOOXOXOXXOXXOOOOXOOOXXOOXOOOOOXOOOOXOXOOO
OOOOXOOOOOOOOOXOOOXOOXOOOOOXXXXXOOOOXOOOOOOOOOOXOOXOOOXOXOOXOOOXOOOOOOOOOOOXOOOXXOXXXXOXXXOXOXXOOOOOX
OXXXOOOOXOOOXOOXOXOOXOXOOOXOOXXOOXOXXOOXOOOXOOOOXOXOXXOXOOOOXOOXOXXOOXOXOOOOOOOOOXXOXXOOXXXXOXOOOOOOO
OXXOOXOOOOOXOXOOOOOOOOXOOOXXOOXXXOOOOXOXOOOOOOOXOXOOXOXOOXXOOOOOOOOOOXXXOXXOOXXXOOOXOOOXOOOXOOOOOOOXO
OXXXXXOOXXOXOOOXXOOOOOXOOOOOOOOOOOXOOOXXOOOXOOOOOOOXOOXOOXOOXXOXOOXXOOOOOOOOOOXXOOXXOOOOOOOOXOOOOOOXO
XOOXOXOXOOXOXOOXOOOXOOOOXOOOOOOOOOOXOOOOXXOOOXOOXOXOOXOOOOXOOXXOOOXXOOOOOOOOOOOOOOOOXOOOOOOXOOOXOOXOO
OOXOOOXXXOOOXOXXOXOOOXXOOOOOXOOOOOOOOOXXOOOOOXXOOOOOOOOXOOOOXXXXOXOOOOXOXOOXOXOOOXOXOOXOOXOOOOOXOOOOX
XOXOXOOOOXXXOOOOXOOOOOOOOXOXOXOXXOOXOOOOOOOXOOXOOOOXOOOOXOOXOOXXOOXOOOOXOOOOOXOOXOXOOOOOOOOOOOOXOOOOO
XOOOXOXOOOOXOOOOOOOOXOOOOOOOOOOOOOOOXXOOOOXOOOXOOOXXXOXOXOOOOOXXXOOOXOOOXOOXXOOOOXXXOOXOXOXOOOOXOOOOX
OOOOXXOOOOXOOXOOXOXXXOOXOXOOOOOXXXOOOXOXXXOOOOOXXOOXOOOOXOOOOOOOXOOXOOOOXOOXXXOOOOXOOXXOOOOOXXXOOOXOO
OOOXXOOOOXOOXOOOXOOOOOOXOOOOXXXOXOOOOOOOOOOXOOXOOOOXOOXXXXXOXOOOOOOOOXOOOXOXXXOOOXOOOXOOXOOOOOOOXOOXO
XOOOOOOOOOXOXOOOOOXXOOOOXOXOXOXOOOOXOXOXOOOOXOOXXXXOXXXOOOOOXOOOOXXOOXOOOOXOOOOXOOOOOOOOOOXOOOOOOXOXO
OXOOOXOOXXOOXOOOOOXOOOOOOOOOOOOOOXXXOOOOOOOOOXOOOOOOOOOOOOOXOOOOOOOOOOOXOXXOXXXXOOOOOXOOOOXOXOOXOXOOO
OOXXOOOXXOOOOOOOOOOOXOOOOXOXOXOOXOOOXXOOOOXXOXOOOXXOOXXOOXOXOOOOOOOXOOOOXOOOOOOOOOXOOOOOXXOXOOXXXXXOO
XOOOOOXXOXOXXOOOOOOOOOXOOOXXOOOOOOXXOOOOXOOOXOOOOOOOXXOOXOOOOXOOOXOXOOOOXOXOOOXXOOOOOXOOOOOOOXOOOOOXO
OXOOXXOOOOOOOOOXXOOOXXOOXOXOXXXOOOOOXOOXOOXXXXXOXOOOXOXXXOXOOOOOOXXOOOOOXOXXOOOOOOOOXOOXXXXOXOOOOOOOO
OOXXXOOOOXOOOOOXXXXOOOOOXOOOXOXOOOOOOXXOOOOOOOOOOOOOOOOOOOOXXOOOOOOXXXXOOOOOXOOOOOOXOOOOXOOXOOXOOXOXO
XOOOXOOOOOOOOXOXOOOXXXOXOXOOOOOXOOOOOOOXXXOOOXOXOOOOOXOOXOXOOOOOOOOXXOOXOXOOOXOXXOOOXOXOOOOOOOXXOOOOX
XOOOOOOOOOOOOOOOOXOOOXOOOOXOOOOOOOXOOOOOXXOXOOOXOXXOOOOOOXXOOXOOOOXXOXOOXOXOXOOOOXOOXOOOXOOOOOOOXOXXO
XOOXOOOOOOOXOXOOOOOXOOOOXOOOOOXXXOXOXOOOXOXOOOXOOOOOOXOOOXXOXOXOOOOXOXOOOOOOOOOOOOXOOOOOXXOXXOXXOOOOO
OOOOOXXXOOOXOXXOOOOOXXOOOOXOOOXOOOXOOOOOOOXOOOXOXOOXOOOOOOOOOOOOOOOOXOOXXOXOOXOXOOOOOOOXOOXOOOXOXXOOO
OXXOOOXOXOOOXOXXXXXXOXOOOOOOOOOOOOXOOOOXOOXOXOOOXXOXXXOOOXOOOOXXXOOOXOXOOOOOXOOOXOXOOOOOOXXXOOOXOOOXO
OOXXXOOOXOOXOOOXXOXXOXOXOOXXXOOOOXOOOXOOXXOXOOOOXOOOOOOOXOOXOOOXOOXOOOXXXXXXOXOOOOOOOOOXOOXOOOOXOOXXX
XOXOXOOOOOXOOOOOXOXXXXOOOXXOOOOOOXXXOXXOOOOOOXOXXXOOXOOOOOOXOOOXXXOOOXOOXXOXOOXOOOOOXOOXOOXOOOOOOOOXX
OXOOXOOOOXXXOOOOOOXOOXOOXOXOOOXOOOOXOXOOOOOOXOOOXOOXOXXOXOOXXOOOOXOOOOOOXOOOXOOXOOOOXOOOXOXOXXXOXOOOO
XOOOXOOXXOOXXOOOXXXXOOOXXOOOOOOOOOOXOOOXOOOOOXXOXOXOXXOOXOOOOOOOXOOXOOOXXOOOOOXOOXOOOOOOOXOOOOXXXOXOO
