OOOOOOOOOXOOOOOOOOXOXOOOXOOOOOOOOXOXXOXXOOOOOOOOOXOOOOXOXXXOXXOOXOOXOOOOOOOOOOOXOXOOOOOOOOXXOOOOXOOOX
XOOOXOOXOOOOOOXXXOXOOOXOXOOXOOXOOOXOXXXXOOOOXOOXOOOOOOOOOOXOOOOXOXOOXOOOOOOOOOOXOOOXXOXOOXOOOXOOXXOOX
XOOXOOOOXOOOOXXXOOXOXXXOOOOXOOXXXOOOXXOOXOOOOOOXXOOOOOXOOOOOOOOOXXXOXOXOOXOOOOOXOOOXOOOOXOOXOOOOOOXOO
OXXOOOXOOOOOXOXXXOOXXOOOOOOXXXOXOOXXXXOOOOOOOOOOOOXOOOOOXXOOXOOOOXOOOOOOXOOOOXXOXOXOOOOOOXOOOXOXOXOOO
XXOOOOOOOOXOOOOXXOOXXXOXXOOOOXXXOOOOXXOOXXOXOOOOOOXXOOXOOOOOOXOXOOOOOOOXOOOOOXOXOOOOOOOOXOOOOOXXOXOOO
OXOXOXXOOOXOXXOOOOOOXOXOOOXOOOOOOXXOXOXOXOOOOOXOXOXOOOXXXXOXXOOOOOOOOOXXOOOOOXOOOOOXXOXOXOOOOOOOXOOXX
XOOOOOXOOOXOOOOOOOOOOXXOOOOOOOOOOXOOOOOOOOXOXOOOOOOOOOOOOXXOOOOOOOOXOOOXOOOOOOOOOOOXOOOOOXOOXOOOOXXXO
OXXXOOOXXOXOOOOXXOOOOOOOOOOXXOXOXOOOOOOOXOOXXXOOXOOOOOOXXXXOOXXXOXXOOXOOXOOOXXXOXOOOOOOOXOXOOXXOOXOOO
OOOXXXOOXXOOOOXOOOXOOOOOOOXOOOOOXOOXXXXXOOXOOXXOOOXOXXXOXOOOXOXOOOXOOOOXOXOOOXOXOOOOOOOOOXOOXOOOOXOXO
OOXXOOOXXXXXOOXOXOOOXOOOOXXOXOOOXOXOXXXOOOOXOOOXXOOXOXOOOXOOXOOOOOOXOXOXOXXXOOOOOXOOOOXXOOOXXXXOOOOXO
OOXXOXOOOOOOXOOOOXOOOXOOOOOOOXOXXOOXOOOOOOXOXOOOXOOOOOOOOOXXOOXOOXXXOXXXOOOOOXOOOOXXXOOOOOOOXOXOOXOOO
XOOOOXOOOOXOOOOOXOOOXOOXOXXOOOOOOOXOXXOOOXOXOOOOOXOOOOXOOOXOOXOXOOOXOOOXOXOOOOOOOXOOXXXOOOOOOXOOOOOOO
OXOOOOOOXOOOXOOXOXOXXXXXOOOOOOOOXOOXOOXOXOOOOOOOXOOOXOXXOOXXOOXOOOXOXXOOXOXOXOXOXOOOOXXXOXOOOOOOOOXOO
OOXXOOOOOOXXXOOOXXXOOOOOOXOOOOOXOOOXOOOOOOOOOOOOOXXOOOOOOOOXOOXOOOOOOXOOOOOXOOOOOOOXXOXOOXOOOXOOOXOOO
XXXOOOOXOXXOXOXOXOOXOOOOXOOXXOXOXOOOXOXOOOOXOXXXOOOOOOOOOOXXOOOXOOOOOXOOOXXOXOOOOOXOOOOXOXXXXOXOOOOXX
OOOXXOXXOOXXOXXOXOXXOXXOOXXOOXOOOOOOOOOOOOXOXOXOXOOXXOOOOXOXOOOXXOOXXOXOOOOOXOOOXXXOOXOOOOXOOOXXOOXXX
OOOXOOOOOOXOOOOXOOOXXXOXOOOOXOXXOOOXXOOOOOOXOOXOOXXOOXXOOXOOOXOOXOXOXOOXOXOXOXOOXXXOOXOOOOOOOOOXOOOOO
OXOXOOXOOXXOXXXXOXXXXOOOOOXOXOOXXXOOOXXOXXOOXOOOOOXXOOOOOOXOXOXOXOOOOOOOXOOOXOOXOOOOOOOOOXOOOOOOXOOXO
OOXOOOOOXOXOOOXOOXOXOOOOOOOOOOOXOOOXOOOXOOOXOXXOOOXOOOXXOOOOXOOOXOXOOOOOXOXOOOOXOXOOOOOXOXXOXOXXOOOOO
OOOOOOOOOOXXXXOXOOXOOOXXOXOXOXOOOOOXOOOOOXOXOOOOOXOOOOOXXOXOOXOOOOXOXXXOOOOOOOOXXOXXOOOOOOOXOXOOOXXOO
XXOOXOOOOOOOXOOOOOOOXOOXXOOOXXOOOOOOOXOXOXOOXOOOOOOOOXOOOOOOXXOOXOOOXOXOOOOOOOOOOOOOOOOOOOOOOOXOOXOOO
OXOOOOOOOOOOXOOOOOXXOOXOOXOXOOXXXOOXOXOXOOOOOXOOOXOOOOOOOOOOOXXOXOOXXXOXOOOOOXXOOOOXOOXXOOOXOOOXOOOOX
OOOOOXOOOOXOXXOXXOXXOOOOOOOOXOOOOOOOOXXOOOOOOOXOOOXXOXXOXOOXOOOOOXOOXXOOOOOXOOXOXXOOOXOOXOOOOOOXXXOOX
OOOOOOXOXXOOOXOOXOOXOOOOOXXOOOOOOOOOOOOOOOOXXXOOOXOOOXOXXXOXOOXOOXOXOOOOOXOXOOXOOOOOXOOOXOOXOXOOOOXOO
OOOOXOXOXOOOOOOXXOOXXXOXXXOXOOXOXXXOXOOOOOXXOOXXOXOOOXXOOOOXXOOOOOOOOXXOXXXOXXOXOOOOXOXXOOOOXOXOOOOXO
XXXOXOOOOOOXOXXOXXXXXOOXOOOXXXOOOOOOXOXOXOXOOOOXOOXXOXOXOOOOOOOOOOXOOOXOOXOOOOXOXOXXOOOOOOOXXOOOXXXXO
OXOXOOOXXXXOOOXOOOOOXXXOXOOOXXOOOXXOOXOXXOXXOOOOOOOOOOOXXOXXXOOOXOOOOOOOXOXOXXOOOXOOXOOOOOOOXOXOOOOOO
XXOOXXOOOXOOOOOXOOOXOOOOOOOOOXOXXOXOOOOOXOXOOOXOXOXOOXOOXOOXOOOOOXOOOOOOXOOXXOXOOOOXOOOOOOOXOOOOOOXXO
OOOOXXOOOOOOXOOOOOOOOOOXOXXOOXXOOOOXXOOOOOXOOOXOOOXOOOOXOOOXOOOOXXOXXOOOOOOOOXOXOOXOOOOOOOXOXOXOXXOOO
OOOXOXOOXXXXOOOXOOOOXOOXXOOOOOXOOOOXOXOXXOOOOOOXOXXXOOXOXOOOXXXXOOXOOOOXXXOOOXXOOXXOXOXOOOOOXOOXXOOXO
XOXOOXXOOOOXXOOOOOOXOOOOOOOXXXOOOOOOOOXXOOOOOXXOOOOOOOOOXOOOXXXXOOOOOOXOOOOOOXXXOOXOOOXOXOOOOOXOOOOOO
XOOOOXOOOOOOOXOOXOXOOOXXXOOOOOOOXXOOOOOOXXOOXOOOOOXOOOOOXOOOOOOOOOOOOXOOOXOXOOOOXOOXXOOOOXXXXXXOOOOXO
OXOOXXOOXOOXOOOOOOOOOXOOOOOOOOOOOOXOOOOOOXOXXXOOXOOOXOXXOOXOOOXXXOOOOOOXOOXOOXOXXOXOOOOOXOOXOXXOOOOOO
XXXXOOXXOXOOXXOOXOOOOOOXOXXOOXXXOOXOXOOXOOXXXOOOOOXOXXXOOOOOXXOOXOOXOOOOXOXOXXOOOOOOXOOOXXXOOOXXOOOOX
OOOXOXOOOOOOOXOOOOXOXOOOOXXXXOOOOOXOOOOOOOOXOOOOOXOOOOXOXOOOOXOXXOXOXXXOOOOXOOXXOOOXXOOXXXXOOXOOXXOOO
XOOOOOXOOOXOXOOOXOOOOXOOOXOOOOOOOOXXOOOXOOOXXXOOXOXOXOOXOXOOXXXXOOXOOOOOOOOOXOXOOOXOOXOOOOOOOOXOOXOXX
XOOXXOXOXOOOOXOOOOOOOOOOOXOXOOOXXOXXXXXOOOXXOXOOXXXOOOOOOXXOOXOOXOOOXOOOXOOXOXXOOXOOOOOOXOOOOOOOOOXOO
XOOOOOOOOXOOXOXOXOOXOOOOXOXOOOOOXOOXXXOOOOOOOXXXOOOXOOOOOOOOOOOXXOOOXOOXOOOXOOOOOOOOXOOOOXXOXOXOOOXOO
XOXXXXXOOOOOOOOXXOOOOXOXOOOXOXOXXOOXXXOOOOOOOOXOOXOOXXXOOOOOOOOOOOXXOOOOOXXOOOOXOOXXOOOOXXXOXOOOOOXXO
XXOXOOOXOXOOOXOXOOOOOXXXXXOXXOOXOOOXOOXOOOOXOOOOOOOOOOXOXXOXOXOXOXOOOOXXOOXOOOOOXXXOXOOXXOXOOXXXXOOOO
OXOXOOXOOOOXXOOOOXXXOOOXOOOOOXXXOXOOXXXOOXXOOOOOXOOOOXOXOXOXOOXXOXXOOOXOOOXOOOOOXXOXOXOXXXOXOXOXOXXOO
OOXOOOXOOOXOOXOOXOOOOOOOOOOOOOXXXXXOXOOOXXOOOOXXOOOOOXOOOXOOOOXXOOOOXXOOOOOOXXOXOOOXXOXOOOOXOOXOOXXXO
XXXOXXOXOXOXOOOOOOOOXXOOOXOOOXXXXOOOOOOOOOXOOOOOOOOXOOOOOOOXOXOXOXOOXOOOOOOOOOXOXOOXXXOXOXOOXXXOOOOXO
OOOOOOXXOOOOOOOXOOOOXOOOOXOOXXOOOOOOXOXOOOXXOOOOOOOOOOXXOOOXOOOXOOOOOOOOOOXOOOOOOOOOXOXOOOXXOOOOOOOOO
OOXOOOOOXOOXOOOXOOXOOXOOOOOXOOOOOOXOOOXOOOXXOOXOOOOOOOOOOOOXOOOOOXXOXOOOOOOXOOXOOOOOOOXOOXOXOOOOOOOXO
XOOOOOOOOOOOOXXOXXOXOOOOOOOOOOOXOOOXOOXOOOOOOXOXXOOOXXOOOOOOOOOXOXOOXOOOOOOOOOOXOOOOXOOXOXXXOOOOOOXXO
OXOXOOXXXXXXOXXOXOOXOOOOXXOOOXOXOXOOXOOOOOOXOOOXOOOOOOXOOOXXOOOOOXOXOOOOOOXOXXOOOOOOXXOOOOOOXOOXOOOOO
XOOXOOOOOXOOOOOXOOXOOXOOOOOOXOOOOOOOOOOXOOOXOXXOOOXOXOOOOOXOXOOXOXOOOOOOOOOOOOOXOXOOOOOXOOOOOOOOOXOOO
XOXOOOOOOOXOOXXOOXOOOXOOXXXOXOOOOXOOXOOOOXOOOOOXXXXOOOXOXXOOOOXOXXOOOOOOXXOOXXOOXOXOOOOXOOOOOOOOOOXOX
XOOXOOOOXXOOOOXXOOXOXOOOOXOOXOOOOOOOOXOOOXOOOOOOOXOOOXOOOOOXXOOXOOXOOOXOOOOXOOXXOOOOOOOOOXOOXOOOXOXOO
OXOXXOOOOXOOOOOOOXOOOOOOOOOOXOOXOOOOOOOOOXOXOOOOOXOOXOOXXXOOXOOOOXXOOOOOOOOXOOOOOOOOOOOOOOXOOOOXOOXOO
OXOOOOXOOOXOXOXOOOOOOOOXOXOOXOOXOOOOXOXOXXOOOOOXOOOOOOOOXOXXXOOOOOOOOOOOOOOOXOXOOXXOOOXXXOOOOOXOOOOOO
OOXOOOOOOOXOOOOOOXOOOOXXOXOOOOXOOXOXOOOOOXOOOXOOOOOOXOOOXOOXOXOOXOOOOOXXXOOOXOXOXOOOOXOXXOOXOXOOXXOXO
OOOOXXXXOOXOXOXOOXXXXOOXXOOOOOOOOOOXOOOXOXOXOXXOOOOOOXOXOXXXOOOXOOOOXOOXOOOOOXXOXOOOXOOXXXXOOXOXOOOOX
OOXOXOOXXOOOOOXOXOOOOOOXOXXOOOXOOOOOOOOOXOOXXOOXXOOXOOOXOXOXOXXOOOOOOXXOOOOOOOOOOXOXOOXOXXOXOOOOOOOOX
OOOOXOOXXOXOOOOOOXOXXOOOOOOOXOXXOOOOXXOXOOOOOOXXOXOXOOOOOOOOXXOXOOOOOXXOOOOXOOOOXOOOOOOOXOOXOOXOOOOOX
OOOOOXOOOXOOXOOOXOOOXXXOXOOXXOOOOOOOOOOOOOOXXXOXOOXOOOXOOOOXXXXOXOOOOXOOOOOOOOXOXOOOOXXXOOOXOOOOXOOOO
XOOXOOOOOOXXXOXOOOXOOOOOOOOOXOOOXOOOOXOOOOOOOOXOXOOXOOOXOOXOOXXOXOOOOOXOXOXOXXXOXXOXOXXOOOOXOOOOOOOOO
XXOOXOXOXOOOOOOOOXXXOXXOXOOOXXXOOOOOXXXOXXOOOOOOXOXXOXOXOXOOOOOXOOOOXOXXXOOOXOOOXXOXOOOXXOOOOXOOXOOOO
XXXXOOOOOOOOXOXOOOOXXOXOXOOXOOOOOXXOOOOOOOOXXXOOOOXOXXOXOOXOOOOOOOOXOOOOOXOOXOOOOOOOXXOXOOOXOOXOXOOOO
XOOOOOOOOOOXOOXOOXXOOOOOOOOXXOOOOOXOOOXOXOXOXOXXOOOXOOXXXOOOOOOOOOOOOXOOXOOXOXXOOOXXOOXXXOOOOXOOOOOOX
XXXOXOOOOOOOOOOOOOOXOOOOOOOXOOOOXXOOOOOOOXOXOXOOOOOXXOXOOOOXOOOOOOXXXXOOOOOOOOOOOXXXOOOOOOOXOOOXOOXOO
OOXOOOOOXOOXOOOOOXOXOOOOOXOOOOOOXXOOXOXXXOOXOOXOOXOOOOOXXOXOOOOOOOOOOXOOOOOOOOOOXOOOXXOOOOOXXXOXOXXOO
OXOXOOOXOXOOOOXOXXOOOXXOOOOXOXOXXOXOOOXOOXOXOOOOOXOOXOXOXXOOOXOOOOOOOOOXXOOOOXOOOOOOOOOXOXOOOOOOXOOOX
OXXOOOXOOOOOOOOOOXXOOXOOOXOOXOOOOXOXOXOXXOOOOOOOOXOOOOXXOOXOOOXXOOXOOXOXOOOOOOXOOOXXXOOOOXOOOXOXOOOOO
OOOOXOXOOXOOOXOXOOOOOOOXOXOOOXOXOOOOOOXOOXOOOOOOXOXOOOOOOOOXOOXOXXOOOOOOOOOXOOOXOXOOOOOOXOOXOOOOOXOOO
XOOOOOOOOXXOOOOOOOOOOOOOXXOOOXOOXXXOOOOXXOXXOXOXOXOXOXXOOOOXXXOOXXOOOOOXXOXOXOOXOOOOOXOOOOOOOOOOOOXOO
OOOOXXOXOOOOXOXXOOOOXOXOOOOOOOOOXOOXOOOXXOOXXXOOXOXXOOOOXOOOOOXXOOOXOOOXXOOXOXXXOOOOOOOXOOOOOOOOOXXXX
XOOXOOOOOOOXXOOOXOOOOOXXOOOXOXOOOOOOOXXOXOOOOXXOXXOOXXXOOOOOOOOOOOXXXOOOOXOOOOOOOOXOOOXOOXOOOOOOOXOOO
OOOOOXOOOOOOOOXOOOOXXXOOOOOOOOOXXOOOOXXXOOOOOXOOOOOOOXOOOOOOOOOOOOOOOXXOOXOXXOOXXOOOXOXOOOOOXXOOXXOOO
XOOOOXOOOOOOXXXXOXXOOOOOOXOXOOXOOOXOOOOOOXXOOOOOOOXOOOOOOOOOOXXOXXOOOXOOOOOOOOOXOOOOXOXXOOOXXXXOOOOOO
XXXOOXOOOXOOOOOOOXXOOOOOOOXOOOXOXOXXOOXOOXOOOOXOOXOOOOOOOXOOOOOOOOOOXXOOOOOXOXOXXOOOXXOOOOOXXOXOOOXOX
OXXOOOOOOXOOOXXOOXXXOXOXOOOXOOOXXOOOXOXOOOOXOXOOOOXXOXOOXOXOXOXXXOOOOOXOOOOOOOOOOOOOOXXOXXOXXXOOOOXOO
OXOOXOXOOOOOOOXOOXOXOOOOOOOXOOOXOOXOXOXXOOOOOOXOOXXOOOOOOOOOOXOOXOOOOOXXOOOOXOXXOOOXOOOOXOOOOOXXOXOOX
OOOXOXOOOXOXXOOOOXXOOOOXOOXOOXOXOXOOXOXOXOOXXOOOOOXOOXOOXOOOXOXOOOOOOOOOOXOOOXXOXXOXOOOOXXOOOOOOOOXOO
OOXOXXXOOXOOOOXOXOXOOOXXOOOOOOXOOOOOOOXXXOOOOXOOOOOOOXOOOOOOXOXOOOXXOOOOXXOXOOOOOOOOOOXOOOOOXOOOOOOOO
XOOOXXOOOOOXOOXOOXOOOOXXOOOOOOOOOOOXOOOOOXXOXOOOOXOOXOOXOOXOOOOOOOOOOXOXXXOXOOXXOXOOXXOOOOOOOOXOOOOOO
OOOOXXOOXXXOXXOXXOOXOOOOOOOOXOOXOOOXOOOOOOOOOOXOXOOXXXOXOOOOXXOOOOOXOXOOOOXOOXXOOOOOOOOXXOOOXXOOOOOXO
OOOXOOOXOOOOOOOOXOOOXOOXOOOXXOXOXOOOOXOOXOXXXOXXXXXOOOOXXOXOOOOOOXOXOXOOXOOOXOXOXOXOOOOOXXOOOXXOOXOOO
OXXXOOOOOOOOXOOOOXOXXOOOOOOOOXXXOOXOOOOOOOXOOOOOOOOOXOXOOOOOOOOOOXOOOOOOXOXXOOXXOXXOXXOOOXOOOXOOOOOOO
XOXOOXXOOOXOOXOOXOOXOOXOOXXOOOOOOXOXOOXOXXXXOOOOOXOOXOOOXOOOXOXOXXOOXOOXOOOOOXOOOOOOOXXOXOOOOOOOOXOXO
XXOXOOOOOOOOOOOXXOXOOOOOOOOXOOOXOXOXOXOOOXOOOOXOXOOOXOOXOOOXXOOXOXOOOOXOXOOOOOXXXOXOOOOOXOOOOOOOOOOOO
OXOOOXOOOXOOOXOXOXXOOXOOXXOXOOOOOOOOXOOXOXOXOOXOXXOXOXOXOOOXOOOOOOOOXXOOOXOXOOOXOXXOOXOOXOOXXOOOXOXOO
OOOOXOOOOOXXOXOOXOOXXOXXXXXOXOOXXOOOXXOXOOXXOOXOOOOOOOXXOOXXXOOOXOOOXOOXXOOOOXOOOOOOXOOOXOOOXOOOOOOXX
OXOXXOOOXOXOOOOOXXXXOXXOOOOOOOOOOOOOOXOOOOXOOXOOXOOOOXXOOOOOOXXXOOOXXOOOOOOOOXOOOXOOXXOOOOOXOOOOXOOOO
XOOXOOOOOOOOXXOXOXOOOOXXOOOOOOOOOOOOOOOOOOXOOXXXOOXXOOOOXXOOOOOOOOOOXOXOOOXOOXXXOOOOOXOOOXXOOXOXOOOOO
XOOOXOOOXOOOOOOXXOXOXOOOOOXOXXOXOOXXOXXOOOOOOXOOOOXOOOOOXOXOOOOOOOXOXOXXOXXOOXOOOXXOXOOXOOOOXOXXXOOXX
OXXOOOOOXOOOOOOXXOOOOXOXOOOOOOOOOOOXOOOOOXOOOXOXOOOOOOOOOOOOOOOXOOOXOOXXOOOXOOOOOOXXOOOOOOOOOOOOOOXOO
OOXXXOOOOOXXOOOXXOXXOOOOOXOOOOOOOOOOXOOXOOXOOOOOOOOXXXOOXXOOOXOOOOOOXOXOOXOOOOOOOOOXOXXXOOOXOXOOOOXXO
OXOOOOOOOOXXOOOOOOOOOOOOOOOXXXOXOXOOOOOXOOOXXOOOOOXXOOOOOXOXXOXXOOOXOOOOXOOOXXOOOOOOOOXXOXOOOOOOXOOOX
XOOOOOOOOOOOOOXOOOXOOOOOOXOOXOXOOOOOOXOOOOOOXXXOOOOXXOOOXXOXOOXOOOOOOOXOOOXOOOOOOOOOOOXOXOOOOOXXXXOXO
XOOXOXXOOOOOXOOOOOXOXOOOOOOOXOOOOOOOXOOOXOOOXOOOOXOOOOOXOOXOOOOXOXOXOOOXXXOXOOXOOOXXOXOXXXOXXXXOXOOOO
XOXOOXOXOOOOXOOOOXOOOOOOOOOOXXOOXXXOXOOXOOOOXOOOXOOOOXXXOOOOOOXXOOOOOOXOOXOXOXXOXOXOOXXOOXXXXXOXOXXOO
XOOOOXOOOOOXOOOXOOXOOOOXOOXOOOXXOOOXOXXXOOXOOOOOOOOOOOOOOOOOOOOOOXOOOXOOXXOXOOOOOOOOOOXXOOOOOOOOOOOOO
OOOXOOOOOOOOOOOOXOOOOXOOXOXOOOXOXOOOXOXXOOOOOXXOOOXOOXOOOOOOOOXXOXOOOOOOOXOXXXXOXOXOOOXOOXOOOOOOXOOXX
OOXXOOOOOOOXOXXOOXOXOOXOXXOOXOOXOOOXOXOOOOOOOOXOOOOXXXXXXXOOOOOXOOXXOOOOOOOXXXOOOOXXXOOOOOXOOOOOOXOOO
OOOOXXXOXOXOOOXOXOOOOOOOOXOOOOOOOXOOOXOOOOXXOOOOOOXXOOXOXOXOOOOOXOOOOOOOOXOOOOXOOOOOOOXOXOOOOOOXOOXOO
OXXXOXXOXXOOOXOOXOOOXXXOOXOOOXOXOOOOOOOOOOOXXOXXXOOOOOOOXOOOOOOOOXOXOOXOOOOOXOOOOOOOOXOOOOOOOXOOOOOXX
OXOOXOOOXOXOOXOOXOOXOOXOOOOXOXOXOOXOOOOOOOOXOOOOOXOOOOOOOOOOOOXOXXOOOOXXOXOOXXXOOOXOOOOXOOOOXOOXOXOOO
OOXOOXOXOOXOXOOXXOOOOOXOXOXXOOOOOOOXOXOXOOOOOXOXXXOOXOOOOOXOOOOOOOOOOOXOOOOOOOXOOOXOOXOOXOOOOOOXOOOOX
OOOOXXOXOXOXXXOOOOXOOOOXXOOXXOXOOOXOOOOOOOOOXXOXOOXOOOOXOOOOOOOOOXXOOOOOOOOXXOOOOXOOOOOOOOOXOOXXOOOOO
