OXXOOOOXXOOOOOXOOOXOOOOOOXXOOOOOOOOXXXXOXXOOOXOOXXOOOOOOXOOOOOOXOXXOOOOXOOOXOOOOXOOOOXOXOOOOOOOOOOOOO
OXXOXOXXXOOOXOOOOOOXOXXOOOOOOXOXOOOXOOOOXOXOXOOOOOOXOXOOOOOOXOXOOOOOXOOOOOOOOOOXXOOXOOOOOOOOOOOOXXOOO
OOOXOOXXOOOOOOOOOXXXOXXOOXXXXOXXOOOXOOOOOOXOOOOOOOOXXXOOOOOOXXOOOOXOXXXOXOXXXOXOXOOOOOXOXXXOOOOXOOOOO
OOXOOOOOOOXOOXXOXXOOXOOXXXOOOXOXOOOXOOOOOOOOOOXOOOOXOOOOXOXOOXOXOXOOXOOOXOOOXOOOOXOXXOOOOXOXXOOOXXXOO
XOOOOOOOOOXXXOOOOXOOOOOOXOOOXOOXOOOOOOOXOOXXOOXOOOOOOOXXOOXOOOOOOOOOOXXOXOOOOOOXOOOOXOOXOXOOOOOOXOOXO
OOOXOOXOXOXOXXOOXOOOOOOOOOOXOOXXOXXOOOXOXOXOXOOXXXOOOOOOOOOOOXOXXOXXOXOOOXOOOOOOOXOOXOOOXOOXOXXXOXOOO
OXXOXOXOOOOXOOOOOXXOOOOOOXXOXXOOOOOXXOOOOOOXOXOOXOXOXOOXXOOOOOOOOOOOOXOOXXOOXOOOXOOXOOOXOXOXOOOXXXOOO
OXOOOOOOXXOXOXOOXOOOOXXOOOOOOOXOOOOXXOOOOOXXXOXOOXOXOXOXOXOOOOOOXOXOOXXOOXXOOOOXOOOXOOOOOOXOXOOOOOOXX
OOOXOOOOOOOOOOOOOOOOOOOXOOOXOOXOOXXOOXOOOOXOOOOOOOOOOXOXOOOOOOOOOXOXOOXXOXXOOOXOOOOOXXOOXOOXXOXOOXOOX
OOOOOOOOOOOOOXOOOOXOXOOOOOXOOOOOXOOOOXOXOOXOXXOXOOOXOOXXOXOXOOOOXXXOOOXXOOXOOOOOXOXOOOOOOOOOXOXOXXOOO
OXOXXOOXOXXOOOOOOXXOOOOOOXXXXOXOOXOOXOXOOOOOOOOOXOXOOOXOOOXOXXOOOOOOOOOXOOOOOOOOOOOOOOOOOXXOOOXOOOXXX
OOXXOOOXOOXOOOXXOOOXOOXOXOXOOOOOOOOOOOOXOOOXOXOXXOXOXOOXOXXOOOXOOXOOOXOOOOOOXOOXXOOXOOOOOOOOOOOOXOOOO
OOOOOOOOOOXOOOOOXOXOOOOOOOOOOOOOOOXXOOOOOXOOOOOOOOOOOOOOOXOOOOOOOXOOOXOXOOXOXOXOOXOXXOOOXXXOOOXOOXXOO
XOOOXOXOOOOOOOXOOXXOXXXOOOOXOOXOXOOOOXOOOXOOXOOOOOOOXOOXOOOOOOXOOOOXOOXOOOXOOXOOOOXXOXXXOOXOOXOOXOOOO
XXXXXOXXOOOOXOXOXXOOOOXXOOOOXOOOOXOOXOOOOOOXXOOXOOOOOOXOXOOXOOOOOOOXOOOOOXOXOOXOXOOXOOOOOOOOOOOOXOXOO
OOOOOXOXOXOOOOXOOOOOOOXXXOOXOOOOOXOXOXOXOOOOOOOXOOOOXOOXOOOXOOOOOOOOOOOXOOXOXXOOXXOXOOOOOXOOOOOOXOOOO
XOOOOOXOOOOXOOOOXOXOXOOOOOOOXXXOOOOOOOOOOOXOOOOXOOXOXXXOOXXOOOOOXOXXOXXXOOOOXOXXXOXOXOOXOOOOOOXXOOOOO
OOOOOOOXOOOOXXOOXOXOOOXOOOOXXOOOOOOOXXOOOOOXOOOXOOXXXXOOOOOXXXXOOOOOOXXOOOOXOOXOOOOXOXOOXOOOOXOOXOOXX
XOOOXOOOOXOOOOOOOOXXOOOOOOOOXOXOOOOXOOOOOXXOOXOOOOXOOOXOOOXOOXOOOOXXOOOXXOOOOXOOXOOXOOOXOOOOXOOOXXOOO
OOXXOOOXOOOOOOOOXOOOOXOOOXOOXXOOOOOOOOOOOOOOOOOOOOOOOOOXOOOOXOOOOOOOOOOOOOOOOOOOXOOOOXOXOOOOOOOOOOXOO
XXOXOXOOOXXOOOOOOOOOXXOXOOXXOOXOOXXOOOOXOOOXOOOOXOXXOOOOOXXOOXOOOXOOOOOOOXOOOOOOOOOXXOXOOXOOOXOOOXOOO
OOOOOOOOXOOOOOOOXOOOXOOOOOXOXOOOOOXOOXXOOOOXOXOXOXOXOOOOOOOOXOXXOOXOOOOXOXOOOOOXXOOXOXOOOOOXXXOOOOOOO
XXOOXOOXOXOXXOOOOOOOOOXOOOOOXOOOOXOXOOOXXOXXXOOOOXOOXOXOOOXOOOOXXOOXOXOXOXOOOOOXOOOXOXOXOOOOXOOOOOXOO
OXOOOOXOXOXXXOOOOOXOXXXOOOOXOXOOOOOOXXXOOOOXOOOXXOXOXXXOOOOXXOOXXXXOOOXOOOXXOXOOOXXOOOOXOOOXXOOXOXOOO
OXXOOOOOOOXOOXOOXOOOXOOOOOOOOXOOOOOOOXOOOXOOOOOOOXXOOOOXXXOXXXOXXOOOOXOOOOXXOXOXOOOOOOOOOOOXOOOOOOOOX
OOOOOOOXXOOOOOOOOOOOOXOOXXOXXOOOXOOOOOOOXOOXOOOOXOOOXXOOXOOOOOOOOXXOOXOOOXXOOXOOXXXOOXOOOOXOOXOOOXOXO
XOOOOOOXOOXOOOOOOXXOXOOXXOXOOOXOOXOXXXOOXOOOOOOOOOOOOXOXXXOXXOOOOOOXOOOXOXOXXXOOOOXOOOXXXOOOOXXOOOOXO
OOOOOXOOOXOOOOOOOOOOOXOOXOOOXOOXXOOOOXXXOXOXOXXOOOXOXOOOOOXOXOXXOOOOOXXOXOXOXOOXOOXOOOOXOOXOXOOXXOXOX
XXXOOOOOOOOOOOXOOOOOXOOOOXOOOOOOOOXOXXOOXOOXOOOOOOOOOOOOOXXOOXOOXOXOOOOOOXXOOXOOOOOXOXOOOXOOXXXOXOOOO
XOOXOOOXOOXOXOOOOXOOOOXOOOXXOOOXXXXXXXOOOXOOOOXXOXXOOOOOOXOXOXOXOXXOOOOOOXOOXOXXXXOOOOOOXXXOOXOOOOXXO
OOOOXOOOXXXOXOOXOXOOOOXOXOOOOOOXOOOOOOXOOXOOOXXXXXOXOOOOXOOXOXXOXXOXOXOXOOXXOXOXOOOOOOOXXXXOOXXOXOOOO
OXOOXXOOOOOOOOOXXXOOXOOXOXOXOXOOOOOOOOOXOXXXXOOXOXOOOOXOOOXOXOOOOOOOXOOOXOXOOXXOXOXOOOOOXOOXXOOOXOOXO
XOOXOOOXOOOXOOOXXOOOXXOOOOXOOXXXOOXOOXOOOOOOXXOOOXXOXOOOOOXOXXXOOOXXOOOOXXOXOOOOXOXOOXOOOXXOOXOOOOOOO
OOOXOOOXOXOXOXOOOOOOOXOOOOXXOOOXOOXOXOXXOOXXOXXOXOOXOOOOOOOOOOOOOXOOXOOOOXXXOXOOOXOXOOOOOXOXOXXOXXOXX
OXXOOOOOOOOOXOOOXOOOOOOOOXOOOOOXOOOXXXOOXOOOOOOOOOXXOOOXOOOOOOOOOOOOOOXXOXOOOOOXOXOOOOOXXXXOXXOOOOXXO
XOOOXOOOXOOOOOXOOOOOOXXXOOOOOXXXOOOXOXOOOOXOOOOOOOOOOXOOXOOXOOOOXOOOOXOOXXXOOOXXXOOXOOOOXOOOOOOOXOOXO
OOOXOOXOOXOOOOOOOOOXOOOXXOXOXXXOOOXXXOOOOOXOXOXXOXOOOOOOXOOOOOXOOXOOOXOXOOOXOOOOXXOOOOOOOOOOXOOXXOOOX
OXXOOOXOXOOXOXOOXXOXXOOOXOOXOXOXOOXXOOOOOOOOOXOOXXOXOXOOOOOXOXOOXOOOOXOXOOOXOOXOXOOOOOOXOOOOOXOXOOOOO
OOXXXOOOOXOOXOOXOXOOOOOOXXOXXOOXOOOOOOOOOXOOXOOXOXXOOOOOXXOXXXXOOOXOXOOOOOOOOOOOXXOOOOOOXOOOOXOOXOOXX
XXOXOXXOOOOOOOXXOOOXXOOXOXXOOOOOOXOXOOOOOOXOOXOOXOXXOXOXOOXOOOXOOOOOXOOOOOOOOOOOOOOOOOOOOOOOOOOOOXOOX
OXXOOOXOOXXOOOOOOOOXOOOOOOXXOOOOOXOOXXOOOOXOXOOOOOOOXOOOOOOOOXOOOOOXXXXOXOXOOOOOOOXOXOOXOOOOOOXOOOXXX
XXXOOXOOXOXXOOXOXOOXOXXXXOOXXXXOOOOOXOXOOXOOOOOOOOOOOOOOOOXOOOXXXOOXOOOXOOXOXXXXOOXOXXOXOOOOOOXOOXOOO
OOOOXOXOOXXOOXOXOOOOXXXXOOXOXOOOXXOOOOXOXOOOOXOOOOOOXOOOXXXXOOOOXXOOOOOOOOOXOOXXXOOOOOOOOOOOOXOOOXOXO
OXOOOOOOXXOOXXOOXXOXOOOOOOOOXOOXXOOXXOXOOOOOOOOOOOOOOOOOOOXOOOOOOOOOOXOXXOOXOOOOXOXOOOOXOXOOOOOOOOXOO
OOXXXOOOOOOOOOOOOOXXOOXOOXXXXXOXXOOOOOXOXOOOOOOOOXOOXOXOOXOXOOXXXOOOOOOXXXXOXXXXOOOXOOOOXOOOXOXXXOOOX
OOOOOOXOOOOOOOOOOOXOOOXXOOXXOOOOOOXXOOOXOXOXOOOXOXXOOOOXXOOOXOXOOOOOOXOOXOXOOOOOOOOOOXOXOOXOOOOXOXOXX
OOOOXOXOOOOOOOOOOOOOOOOXXXOOOXOXOOOOXOXOXOXOOXXOOOXOXOOOOOOOOOXOOOOOOOOOOOOOOOOOOOXOOXOOXOOOXOOXXXOXO
OOOOOOOOOOOOOOXOXOXOOOOXXXOXOXXXXOXXOXOXOXOOXOXOXOOOOOXOXXOOXOXOOOOXXXOOOOXOOOXOXXOOXOOOXOOXOOXOOOOOO
OOXOOOOOOOOXOXOXOXOXOOOXOXXXOXOOOXXXOOXOOXOOXXXOOXXXXOOOOOOOOOOOXXOOOOOOOOOOOXOOOXXOOOOOXOOOOOXOXXOOX
OXXOOXXOOOOXOXXXOOXXOOXOXOOOXOOOXOXOOXOOOOXOXOOOOOXOOOOOOOOOOOOOOOOOOOXXXOOXOOOXOXXOXOOOOOXOOXOOOOOOO
OXXOXOOOOXOXOOOOOOXOXOOXOOOOOOOOOOOOOXOXOOOOOOOOOXOXXXOOOOOOXOOXOOXOOOOXOOOOXXOXOXXOXXXOOXXXOOOOXOOOO
OXOOOXOOOXOOOOXOXXXOXOOXOXXOOOOXOXXXOOOOOXOOOOXXOOXOOOOOOXOOOOOOXXXXOOXOXOXOOOOOOOOXXXXXOOOOOOXXOOOOX
OOOXOXXOOXXOOOOOOOXOXXXOOOXOOXXOOOOOOOOOXOXOOXOOOOOOOOXOOOXOOXOOOOOOOOXOOOOOOOOXOOOOXOOOXXOOOOXOOXXOO
OXOOOOOXOOXXOOOOOOOOOOOXOOOXOOOOOOOOOOOXOOOOOOOXOOOOXXXOXOXXOXXOXOOOOOOOOXXOXOOOXXXOOOOOOXOXOXOOOXXOO
OXXOOOOXXOOOOOOOOOOOOOOOOOXOOOOXXOOXXOOXOOOXXXOOOXOOOOOXOOOOOOOOXOOXOOXXOXOXXOOOOOXXXXXOOOOOOXXOOXOOO
OOOOXOOOXOOOOOOOOOOOXOXOOOXOOOXOXXXXXOOOXOOOOOOOOOOOXOOOOOXOOOOOOOXOOOOXXOOOOOOXOOOOOXOOOXOOXXOXOOOOO
OOXOOOOOOXOOOOXOOOXOOOOXXXXOOOOOXOOOOOOOOOOOXOOOXOOOOOXXXOOOOOXOXXOOOOOOXOXXXOOXOOOXOOOOOOOXXOOOOXOOX
OOOOOOOOXOXOOOOOXXXOXXOOOOOOOOXOOOXOXOOOOOOOXXXOOOOOXXXXOXOOXOOOXOXXOOOOOOXOXOXOXOXOXOXXXOOXOOOOOOOOO
OOOXOXXOXOXOOXOXOXXOXOXOOOOXOOOOXOOOXOOOXXOOOXOOOOOOOOOOOOOOOOOXOOOXXOOOOOXXOXOOOOXOOXXOOOOOOOXOOXOOX
XXOOOOOOXXOOXOOOOXXOOOOOXOXOOOOOXOXXOXXXOXOOOOXOXXXOOXOXOXOOOXOOOOOOXXOOOOOOXOOOOXXOXOXXOOOOOXXOOOOOX
OOOOOXOOOOOXOOOOOOXXOOOOXOOOXOXOXXXOXXOXOOOOOXOOXOOOXOXXOXOOOXXXOOOOOOOXOXXXOOOOOOOOXOOOOXOOXOOOOOOOX
OXOOOOXOXOXXXOOOOOOXXOOOOOXOXXOOXOXXOOOOXXOOOOOOOOOXOOXXOOOOOOOXOOOOOOOXOXXOXOXOOOXXOXXOOOOOOOOXXOOOO
XOOOXOXXOOXOOXOOOXOOOOOOXXOOXOXOOOOXOOOOOXOOOOXOOOXOXOXXOOOOXXOOOOXOOOOOOOXXXXXXXOOOOOXOOOOOXOOOOOOXO
OOOOXOOOOXOXOOXXOOOOOOOOXOOOXOOOOOOXOOXXOXOOOOOOOXOOOOOOOOOOOOOXXOXOOOOXXOXOOXOOOXXXOOXOOXOOOOOXOXOOO
XOOXOXXOXXOOOOOOOOOOXXOOOOOXOOOXXOOOOOOOOOOOOOOOXXOOOOOOOXOOOXOXOOOXOOXOOOOOOXXOOOOOOOOOOXOXXOOOOXOOX
OXXXXOOXOOOOXXXOOOOOOXOOOXOXXOOOOOOXOXXOXOOOXOOOXXXOXOOXXOOXOXOXXOXXOXXXXOOOOOOXOOOOOOXOOOOXXXOOXXOOO
OOOOOOOXOOXOOOOOOXXXOOOXOOOOOOOOOXXOXOOOXXOOOOOXOOOOXOOOXOOOOOOOOOOXXXOOOOOXOOXXOOOXOOOOOXXXOXXOXOOOX
XXOOOOOOOOOXXOOOOOOOOXOXXOOOOOOOOOOXOXXOXOOOOOOOXOOOOOXXXOOOXOOXOOOXOOOOXOXXOOOXOOXXOXOXOOOOOXOOOOOOX
OOXXXXOOOOOOOXXOOXOOOXOOOXOOXOOOXXOOOOOOOXOOOOOOOXOXXOOOOOOOOOXOOXXOOXOOOOOOXOOOOXXXOXOOOXOOOOOXOXOXO
OXOOOOOOXXOOOOOOOXOXOOOOOOOOXXOXXXOOOOOOOOOOXOOXOOXOXXOOXXOXXOOXOOOOOOOOOXXXOOXOOOXOXOOOXXXXOOXXOOOOX
OOOOOOOXXOOOXOOOOXOOOOXOOOOXOOXOOOOOOOOOOXOOOXOOXOOOOOOOOXOOOOXOOOXOOOXOOOOOOXXOXXOOOXOOXOOXXOOXXOOXX
OOOXOOXXXOOXOXOOOOOOXXOOOOXOXOOOXXXOXOOOXOOOOOOXOXOOXOXOOOXXOOOOXOXOOOOOXOOOOXOOXOXXOOOOOOXOOOOOXOOXO
OOOXOOOOXOXOXXOOOOOOXOOXXOOOOXOXXOOOOOOXXOXOOOOOOOOOOXOOOXOXOOOOXOOOOXOOOOOOOOXOOXOOOOXOXOOOOOOOOOOOO
OOOOOXOOOOOXOXOOOXXXOOXOXXXXOOOOOOXXOOOXOOXXOOOOOOOOOOXOOOXOXOOOXOXOOOOOXOOXOOOOOOOXXOXOXOOOXOOXOXOOO
OXOOOOOOXXOXOXOOOOOXXOXOXXOOOXOXOOXXOOXOOOOOXOXOOOOOOOOOOOOOOOOOXOOXOOOXOOOOOXOOOOOOOOOOOXXOXOXXOOOXO
XXXOOOOOOOXOXOOXOOOOOOOXOOXOOOXOOOXOXOXOOOOXOOOOXOXOOOOXOOOOOOOOOXOOOOOOOXXXXXOOOXOOXOXOOOOOOOOXXOOOO
OOXOOOOXXXOOXXOXOOXOOXOOOXOXOOOOXOXOOOOXOOXXOOOOOXOOXOXOXXOOXOOOXXOOOOOOXOOXOOXOOXOXOOOOOOOXOOOOOOXOO
OOOOOOXOOOOOXOOOOXOOXOOOOXOOOXXOXOOOXOOOXXXXXOXOOOOOOOOOXOOOXOOOXOOOXXXXOOOOOOOOOOOXOOOOXXXOOOOOXOXOX
XOOXOOXOOOXXOXOOXOOOOOOOXOXOOOOOXOXXOOXOOXOXXOOOOOOOXOOOOOOOOOOXOXOXXXOXOOOXXOXOOOOOXOXOOXOXOOOOXXXXO
OOXXOOOOXOXOXOXOXOXXOXOXOOOOOOXOOOXOOXOXOXXXOOOXXOXXXOOOXOXOOOXOOOOOOXXOOOOXOXOOOXOXOXOXXXOOXOOOOXXOO
XOXOXXOOXOOOOOXOOOXOXOOOOOXOOXOOXOOOOOOXOOOOOOOOXXOXOXXXXOOOOOXXOXOXOOOOOOOXOXXOOOXXXOOOOOXXOOOOOOOOX
OOOOOOXOXOOOOOXOOOOXXOOOOOXXXOOOOOXOOOXOOXOOOOOOOXOOXOOXOOOOOOOOOOOOOOXOXOOOXOOOOOOXOXOOOXOOOOOXOOXOO
OXOOOOOXXOOOOOXXXOOOXOXOOOXXXOXOXXOOOXXOXOXOOXOOOOOOOXOOOXXOOOOOXXXOOXOOOOOXXOOOOXOOOXOXXOOXOOOOOXXOO
OOOXOOOOOOOOOOOOXOOXOOOOOXOOXOOOXOOOOOOOXOOXXXOOOOOXOOXXOXOOOOOXOOOXOXOOOOOOOOXOOOOOOOXOOXXOOOOXOOXOO
OXXOOXOOXXOOOXXOOOOOOXOOOOOOOOOOXOOOOOXOOOOOOOOOXXOOOXOOOOOOXOOOXXXXOOOOXXXOXOOXOOOOXOXXOOOXOOOXXOOOO
OXOOOOOXOOOXOXOOOXOXOXOOOOOXOOXXOOXXOOOOOOOXXXXOOOOOOXXOOOOOXXOOOOOXOOXXOOXOXXOOOOOXOOOOXOOOOXOOXOXOO
OOOOOOOXOXOOXOXXOXOOXXOOXOXXOXOXOOXXOOXXXOOOOOXXOOOOOOOXOOOOOOOXOOOOOOXOOOOOOOOOOOOOOXOOOXOOOXOOXOOXX
OOOOOXOOXXOXOOXOOXOOXXOOOOOOXOOOOXOOOXXOOOOOOXOOOOOOOXOOOOOXXXOXOOOXXOOXOXOOOOOOOOOOOOOOOOOXOOOOOOOOO
OXOOOXXOOOOOOXOOOOOXOXOOOXOXOOOOOOOOXXXOOOXXOOOOXOOOXXOXOOXOOXXOOXXOXXOXOXXXOXOOOOOOXOOOOOXOOOOOXOOXO
OOXOXOOXXOXOOOOXOOOXOOOOOOOOOXOOOOXOOOXOOOOXOOOOOOOOXOOOOOOOXXXOXXXOOOOXXOOOXOOXOOOOOOXOOOOOOOOXOOOOX
OOXOOXOOOOOXOXXXOOOXOOXOOOOOXOOOXXOXOXOOOOOXOOOXOOXOOXOXOOOOOOOOOOOOOOOXXXOOOOOXOOOOOXOOOOOOOXOXOOOOX
OXOXOOXOXXOOXOOOOXXXXOOOOXXOOXOOOXOOOOOOXXXOOXOOOXOXOOOOOXOOXOXOOXOXOOXXOOOOXOOOXOXOXOOOXOOOOXOOOOOOO
OXOOOOOOOOOOOOXOOOOXXOOOOXOOOOOXOXOOOOXOOOOOOXOXOOOXOOOXOOXXOOOXOXOOOOOOOOXXXOOOXXOOOXOOOXXXOOOXOOOXO
XXOOOOOOOOOOOOOOOXOXOXOOOOXXOOOXOOOOOXXOXXXOOOXXXOOOOXOOOOOOXOOOOOOOOXXOOOXXXOOOXOOOOXOOXOOXOOOOXOOXO
OOXOOOXXOOOOXOOOOOOOOXOOXOXOXOOXXOOXOXOOXXOOOXOOOOOOXOXOOOOOOOXXOXOXOOOOOOXOOOOOOXOXOOOXOOOOOOXOOOOXO
OOOOOXOOOOXXOOOXOOOOOOOOOOOXXXOOXOOOOOOOOOOOOXOOXOOOOOOXOXOXOOXOOOXOXXXOXOOXOOOOOOOOOOOXOOOOOOOXXOOOX
OXXOOOOOOOOOXXOXOOXXXOOOOOOOXOOOOOOOOOXOXOOXOXOOOOOXOXXOOOOXOOOOOOXOXOOOXOOOOXXOOOOOOXOOOXOOOOOXOOOOO
OOXOOXXXOXOXOOXOXXOOOXOOOOXOXOOOOOOOOXOOOOOXXOXOOOOOXOOOOXOOOOXOOOXXXOOXOOOXOOOOOOOOOXXXXXOOOOOOOOOXO
XXXOXXOOXOOXOOXOOOOOXOOOXOOOOOOOOXXOXOXXXOOOOOOOOOOOXOOXOOXOOXOOOXOOXOXOOOXOOXXOXXXOOOOOOXOOOOOOOOOXX
XOXOXOOXOOOOOOOOOOOOXOOOOOOOOXOOOOOOOOXOOXXOOOOOOOOXXXXXXOXOXOOOXOOOXOXXOOOOOOOOXOXOOOXOOOOOOOOXOOOOO
XOOOXOXOOOXXOOOOOOOOOXOOOOXOOOOXOOOOOXOXOOXOOOXOXOOOOOOOOOOOOOOOOOOXXOOOOOOOXOXOXOXXXOXXOOOXXOXOOXXOX
