OOOOOOXOOOOOXOOOXXXOOXOOXOOOOXOOXOOXOXOOOOOOXXOOOOXXOXOOOXXOOOXOOOXOXOXOOOXOOXOOOOOXXOOOOXOOOXOXXXOOO
OOOOXOXXXXOOOOOOOOOOOXOOOOOXXOOXOOOOOOOOOOOXXXXXOXOOOXOOOOOOXOXXOXXOXXXOXXOOOOOXXOOOOOOOOOOOXOOOOOOOO
OOOOOXXXXXOXOXOOXXOXOOXOOXXOXOXXXOOXOOOXOXOOOXOOOOOOOXXOOOOOOOOOXOOXOXXOOOXOOOOOXOOOOOOOOOXOXOOOOOXOO
OOOOOOOXOOXOOOOOOOXXXXOXOOXXXXOXOOOXXOOXOOXOOXOOOOXOOOOXXOXOOOOOOXOXXOOOOXOOOOOOOOOOOOOXOXOOOOOXOOXOX
OXOXXXOOOOOOOOOOOXXOOOOOOOXOXOOOOXOOOXXOOOXOOOOOXOXOOOOXOOOOXXOXXOOOOOOOOOOOXOOOOXOOXOOOOXXOOXOXOOXOO
OOOOOOOOXOXOXOOOOOOXOOOOOXOXOOOOOOOOOOXOXOOOXOOXOOOOOOOOOXOXXOOOOOXOOXXOOOXXXOOOOOOOOOOOOOXOXOOOOOOXX
XOOOOOXXOXOOXOOOXOOOOOXOOXOXXXXXXOOOXOOOOOXXOXOOOXXOOXOOOOOOOOOXXOOOOXOOOOOOOOOOOXOOOOOOOOOOOXOOOOOOO
OXOOOOOOXOOOOOXOOXOOXXOXOXOXOOOOOOOOOOXXOOOOXOOOXOOXOOXOOOOXXOOOOXOOOOOXOXXOOOXOXOXXOXOXOOOOXOXXXOXOO
OOOXXOOOOOXOOOXOOOOOOOOXXOOXOOXOXOOOXXOXOOXOOOOOOOOOOOXOXOOOXXOXXOOOOXOOXOOOOXXXOOXXOOXOOXOOOOOXOOXXX
XOOXXOXOOXOOOOXOOOOOOOOOXOXOOOOXOOOOOXOXOXOXOOXOOOXXOOOXOXXOXOXOOOXXXOXOOOOOOOXOOOOXOOXXOOXOOOOOOXOOX
OOOOXOOOOOOXOOOXOOOOOOXOXOOXOOXOXOOOOOOOXXOOOOOXXOOOXOOOOOOOOOOOOXXOOOXOXOOOXOOOXOOOXOXOXXXXXOOOXOOOO
XXXXOOOOOXXOOOXXOXXOOOOOOOOOOOOOOOOXXOOOXOXOOXOOXXXOXOXOXOOOXXXOOXOOOXXOOXXXOXXOXOXOXOOOOOXOOOOOXXXXO
XOOOXOXOOOOXOXXOOOOOOOXOOOOXOOOXXOOXOOXOXOXOOXXXOOXOXOOXXOOOOXOXXOXXOOOOOOOOOOOOOXOOOOOXOOOOOOOOOOOOO
OXXOOOOOOOOXOOXXOOOOXOOOOXOXOXOOOXOOOOOOXXOXOOXXOOOOOOOXXXOOOOOOXXXOXOXXXOOOOOXOXXXXOOOOOOOXOOOOXOXOO
XOOXOXOOOOOXXOOOOXXOOOXOOOOOOOXXOOOXOOXOOXXOXOOOOXOOXOOXOOOOOOOOOOOOOOOOOXXOOXXXOOOOXXOOOXOOOOOOOXOOO
OOOOOXOOOOOOOXXXOOOOOXOOOXXXOOOOXOOXOOOOOOOOXOOOOOOOXXOOOOOOXXXXOXOOOOXOXOXOOOXOOOOOOXXXOXOOXXOOXOXOO
OOOOXXOXXOOOXOOOOOOOXOOOOOXOXXOXXOOOOOOOOOOOOOOXXOOOOOOXOXXOXOOOOOXOXOOOXOOXOOOXOXOOOOOOOOXOOOOOXOOOX
OOOOOOOOOOOXOOXXOOXXXOOOOXOOOOXOXXOOOOOOOOOOOOOOXXOOOOOOXXXOOOOOXOOOXOOOOXOOXOOOXXOXXOOOOOOOOXXXOXOOO
OOXXOOOXXXOOOOXXXOXOOXOOOOOXOOOOOOXOOOOOOOXOOOXXXOOOOXOOOOOOOOXOOXOOOOOOOOOOOOXOXOXOOOOOXOOOOXOXOXXOO
XOXOXOOXOXXOOXOOXOXOOXOXOXOOXXOOXOXXOOOOXOXOOOOXXOOOOOOXOXOOXOOOXOOOOOXOOXXXOOOOXOOOOXXOOXXXOOOXOOOOX
OOOOXOOOOOXXXOXOXOXOXXXOXOOOOOXOOOOOXXOOOOOXOOXXXOOOOOOOOXXXOOOOOXOOOOXXXOOOOXOOOXOXXOXOOXOOOOOOOOOOO
OOXOOXOOOOXOOXOOOOOOOOOOOXXOOOOOOOOOOOOXOXOXXOOOOXXXOXXOOOOOOXXOXOXXOXOOXOXOXOXOOOOOOXOXOOOOOOOOOOOOX
XOOXOOOOOOOOXOOXOOOOOOOOOOXOOXOOOOOXOOOOXXXOOOOOXXXOOOXOOOOOOXOOXOXXOXOXXOOOXOOOXXXXOOOOXOXOXOOOOOOXO
OOXOOOXOOOOXOXXXOOOXOOXXOXXXOOOXOXOXXOOOOOXOXOOXOXOOOOOOOOXOOXOOXXXOOOOOXXXOOXXOOXXOOOOXOOOXOOOOXOOOO
OOXOOXOXOOOOOOOXOXXXOXOOOXOXOOOOOOOOOOOXOOXXOOOOOXXOXOXOOOOOOOXOOOXOOOXOOXOOOOOOXOOXOXOOOOOOOOXOXXOOO
XOXXOOOOXOOOOXOOOOXXOXXOXOOOOOXOXXOOOXOOXOXOXOOOXOOOOOOXOOXOOXOOOXOOOXOOOOOXXOOOOOOXXOOOXOOXOOOOOOOXO
OOOXOOOOXOOOOXXOOXOXOOXOOOXOXOOOXXOOOOXOOXXOOOOOOXOXXOXOOOOOXOOOOOOXOXOOOXXXOOOXOOXOXOOOXOOOOOXOOOOOX
OOOOXOOOOOXXOOOOOOXXOOOXOOOOOOOXOOOOXXOXOOOOOOOOXXOXOOOOOOXXXOXOOOOXOXXOOOXOOOOXOOXOXOOOOXOOOOXOOXXXO
OXOOXXOOXXOOXOOOOOXOXOOOOOXOXOOOOOOXOOOOOOOOOXXOXXOOOOOXXXOXOXOXOOOXOOOOOXOXXXXOOXOOXXOOOXOXOXOXOXOXX
OOOOOOXOOOXOXXXOOOOXOOOOOOOOOXOOOOOOXOOOOOXOOOOOOOXOXOXOOXOOOOOOOOXOXOOOOXXOXOOOXOXOXXOOOOOOXOXOXOOOO
OXOXOOXOOOXOXOXXOXOXOXXOOOOOOXOOOOOOOOXOXOOOXXOOOOOOXOXXOOOOOOOOOOOOOOOOXOOOOXOOOOOXXOOXXOXOXXOOXOOOX
XOOOOOXOOXXOOOOXOOOOXXOOXXOXOOXOOOXXXOXOOOOOXXOOXOOOXOXOOOXOOOOOOXOXOOOOOOXOXOXOOXXOOXXOOOOXOXOOOOOOX
OOOOOOOXXXXOOOOOOXOOOOOXOXOOXOOOOOOOOOOOOOOXOOOXOOOXOXOOOOXOOOOOOOOOXOOOOXOOOXXXXOXOXOXOXXOXOOXOXOOXX
OXOOOXOXXOOOOXOOXOOOOXOOOOXOXXOXOOOXOOOOOOXOOXOXXOOOOXOOOOXOXOXXOOXOXXOOOOOXOXOOOOXOOOOOOOXOOXOOXOOXO
OOOOOXOOXOOOOOXOOXOXOOOOOOXOXXXOOOOXOOXXOOOXXOOOOXXOOOXXOXOXXXOOXXXOOOOOOOXOOOOOOOOXOXOXOOOOOOOXXXOOX
OOOOOXOOOXOOXOOXOOXOOOXXOOXOOXOXXOXOOOOOOOXOOOOXOOXXOOOOXOOOOOOOXOOOOOOOOOXOXOXOOOXOXOXOOOOOOOXXOOOXO
OXXOXXOOOOOOXOOOOOOOOXXOOXOOXOOOXOOOXXOOOXOXOOOOOOXOXXOOOOOOOOOXOOOOXOXOOOXXOOXXOOXOXXXXOXOOXOOOOOOXX
OOOOOXOXXOOXXOXOXXOXOOOOOOOOOOOXOOOXOOOOXOXOOXOOOOOXOXXOXOXOXOOXXXOXOOOOOOXOOOOOOOXOOOOOXOOOXOXXOOOOO
OXXOXOXXXOOXOXOXOXXXOOOOXXXXXXXXOOXXOXXXOOOXXOXOOOXXXOXOOXXOOOOOXOOXOOXXOXXXXOXXOOOOXOXOOOXOXOOOOOXOO
OXXXOOOXOOXXOOOOXXOOOOOOOXOXXXXXOOOOXOOOXOXOOOOOOXXOXOOOOXXOOXXOXXXXOXOXOXXOOXXXOOOOOOXXOOXXOOOOOXXOO
OOOXXOOOOXXXOOOOOOOXXXOXOOOOOOOOOOOXOOOOOOOOOOXOXOOXOOOXOXXOOOOOXOXOOXOXOOOOOOXXXOOXOXOOOOXOOOXOOXXOX
XOOXXXOOOXXOOXOXOXOXXOOOXOOXXOOOOOOOOOOOXOOOXOXOXXOOOOOOXOOOOOOXXOOOOXXOOOOOOOXOOOOXXOOXXXOOXOXXOXOOO
OOOOOOOXOOOOXOOOOOXOOOXOXXOXOXOOOXOOOOOOOOOOOOXOXXOXOXXOXOOOXOOXXOOOOOXOOOOOOOXXOOXOXXOOOOOOOOOOXXOOO
XOXOXOOOOOOOOXOXOOXOOXOXOOOOXOOOOXOOOOXXOOXOOOOOOXOXOOOOOOOOOOOOOXOXXOOOXOXOXOXXOOOOOOOOOXOOOOOOOXOOO
OXOXOOOOOXOXOXOOXOOOOXOXOOXOXOXOOOOOXOXOOOXXXOOXXOOXOOXOOOOOOXOXOOOOOOXOOOOOOXOOOOOXOXXOOXOOOOXOXOXXO
OOXXOOXOOXXOOXOOOOXOOOXXOOOOXXOXOXOOOOOOOOXXOXXOOOXOOOXOOOOXOXOOXOXOOOOOXOOOOOXOOOXOOOOXOOOXOXXOOXOXX
OXXOOXXXOOXOOOXOOOOXOXOOXXXXOOOOOOOOOOXOOOOOOOXOOOOXOXXOOOOOOOOOXOXOOXOXXOOXOXOOOOOOOOOXOXXXXOOOOOOOO
OOXOOOOOOOOOXOXOXXOXOOOOOOOXXOXOXOOXOOOOOOXOOOOOOXOOXOOOOOOOXXOOOXOXOXOOOOOOXOOOOXXXOOXOOXOOOXOOOXXOO
XOXOOXOXOOOXOOXOOOOOOOOOOXXXOOXOOOOXXOOXXXOXOXOXXXOOOXOOOOOXOOXOOOXOOOOOXXOXXOOOXOOOOOOXOOOOOOOOOOOOX
OOOOOOOOOOOOOOXXOOOOOOOOOOXXOOOXOXOXOOOOOOOOOOOOXOOOOOOOXXOXOXOOOOXXXXXOOXOOXOXOOOOOOOOXXOOOXOOOXXOOO
OOXOXXOOXXOOOOOXXOXXOOXOOOOOOOOOOXXOOOXOOXOOOOOOXOXOOXXOOXXOXOOXOXOOOOXOOOOXXOXXOOXOOOOOOOOXXOOOXOOOO
OOOOXOXOOOXOXOOOOOOXOOOOOXOOOOOOXXOOXOXXXXXOOOXOXXOOOOOOOXOOXOOOOXOOXOXOOXOOOOOOXOOOOXOOOXOOOOXXOOXOO
OOOOOOOOXOOOOOOOOOOOXOOOOOXOXXXXOOOXXOXOOXOOOOOOOOOOXOOOOXOOOOOXOOOOOOOOOXOXOOXXOXOOOOOXOXOOXOXXXOOOO
XOXXOOOXXOOXOOOOXOXOOOOOXXOOOOOOOXXOXOXXXOOOXOXOOOOXOOOOOXXXOOOOOXXXOOOOOOXOOOXOXOOOXOOOOOOOOXOOXOOOO
OOOOXOOOOOXOOOXOOXXXXOOOOXOXOXXXOOXXOOOOOOXXOXOOOXXOXXXXOXOOOOOOOOOOOOXOOOXOOXXOOOXOOXOXOOXXXOOOXXOOO
XOOOOOOOOOOOOOOXXOOOOOOOOOXOXOOOOOOOXOXXOXOOXOOOOOXOXOOXXOOXXOOOXOOXOXOOOOOOOOOOOOXOOOXOOOOOXXOXOXXOX
XOOOOXOOOOOXXXOXOOXOXOOOOOOOXXXOXOOXOOOOXOXOOXOXOXOOOXOOOXOOOOXXXOOXOOOXOXXXXOOOOOXOOXOOOOOXXOXOOOOOO
XOXOOOOOOOOOOOOOOOXOXOOXOOOOXOOOOXXOXOOXXOXXXOXXOOXOOXOOXOXXOOOXXOOOXOXOOOOOOXXOXOXOXXOOOXOXOXXOOOOXX
OXXOOOOXOOOXOOOXOOOXOOXOOXOOXOXXOXOXOOXOOOXOXXXOXOOOOOOXOOOOXOXOOOOOOOOOOXOOXOOOOOOOOOOXXXXXXOXOOXXXX
XOOXOOXXOOOOXXXXOOOOXOOOOOOOOXOOOOOXOXXOXOXOOXXOOOOXOOOOXOOOXOXXOOOXOOXOOOOOOOOXOOXOXOXOXXOOOOOXXXOOO
OXOOOXOOXXOOOXXOOOXXOXOOOOXXOOOOOOOXOOXOOOOOOXOOOOXOOOXXXXXOOXOOOOXOXXOXOOOXOOXOOOXOOOXXXOXOOOXOOOOOX
OOOXXOOOOXOOXOXOOXOXOXXOOXOOOOXXOOOOOOXXOOOOOOXOOOOOXXXXOOOOXOXOXOOOXXOOOXOOXOOOOXOOOOOXXXXXOOOOXOOOO
OOOOOOOXOOXOOOXOOOXOOOXOOXOXOOXOOXXOOOXOOOXOXOXOOOXOOXOXOXOOXXOOOXXOOOOOXXOOXXOOOOOOXOOOOOOXOXOOXOOXX
OOOOXOXOXOOOOOOOXOOOXXXOOOOOOOOXOXOOXXXOOXOOOOXOOOOOOOOOXOOOOOXOOOXOXOOOOOOOOOOOOOOOXOOOXXXOOOOOOOOOO
OOOOOOOOOXXOOXOOOXOOOOOXOOOOOOXOXOOOOOOXOOOOXXXXOOOOOOXOOXXOOOOOOXXOOOXOOXOOOXOOOOOOOOXOOXOXOXXOOOOOO
OXOOOXOOXOOOOOOXOXOOOXOOXOOXOOOOOOOXXOOXXOXXXOOOOOOOXOOOOOOOOOOOOOXOXOOOXXOOOXOOXOOOXOOOOOOXXOOOOOOOO
XOOXOOOXOOXOXOOOOOOOOOOXXXXOOXOOOOOOOXOOOOOXOXOOOOXOOOXXXOOOOOOXXOOXOOOOOOOOOXXOOXOXOOOXOOOOOXOXXXXOX
OXOOOOXOOOOXOOOXOOOOXOXXXXOOOOOOOOOXOOOOOOOXXOOXOOOXXXOOOOOOXOOXXXOXOOOOOXXOOOOXXOOXOOOOXOXOOOXOOOXOO
XOOOOOOOOOOXXXOOXOOXOOXOOOOXOOOOOOXOOOOXXOXXOOOOOOXOOOOOOXXOOOOOOXXOXOOOOOOOOOXOXOOOXOOOXOXOOOXXXOXOO
OXOOXOOOOXXXOXXXXXOXOOXXOOOOXOXOXXOOXOOXOOXOOOXXXOOOOOXXXXXXXOXOOOOXOOOXOOXOOOXXXXOOOXOOXOOOOOOOXOXOO
XOXOOOXOXOXOOOXXOOXXOOOOXXOXXOOXOOOOXOOXOOXOOOOXXOOOXXXXOOOXXOXXXXOOOXOXOOOOXOOOOOOOXXXOOOXOXOOOOXXOO
OOOOOXXOOOOOOXOXOOOOOOOOOOXXOXOXOOOOOXOOOXOOOOXOOOOOOXXXOXOXOOXXOXXXOOOOXXOXOXXXXOOOOXOOXOXOOOOXOXOOO
OXXXXXXOOOOOXOOXXOXOXOXXOOOOXXOOXOOXOOOOOOXOOOOOOOOOOXOOOOXOXOOOOOOOOOOXOXXOXOOOOOOOOOOXOXOXOOXOOOXOO
OOXXXOXOXOXOXOOOXOOXOXXOXOXXOOXXOXXOOOOXOOXXOOXOOXOOOOXOOOXXOOXXOOXOXOXOOOOOOOXOXOOOXXOOOOOOXXXXOOXXO
XXOXOOOOXOOXOOOOXXOOOOXOXOXOXOXOOOXOXOXOOXOOOOOXOXOXXOOXOXOXOXOOOXOOXOXOOOXOXXXOOOOOXOOOOOOOOXOOOOXXO
XOOOOOXXOOXOOXOXXOOOOOOXOOXXOOXOOOOXXOOXOOOXXXOXOOOXOOOXOXOOOOXOOOOOOOXOOOXOXOXOXXXOXOXOOXXOOOOXOXOOX
XXOOOXOOOOXOXOXOXOOXOOOOXOOXOXOOOXOXXXXOOOOOOOOXOOXOXOOOOOOOOOOOOXOXOOXOXOOXOOOOXXXOOXXXOOOOOOXOXOOOO
OOXOOOXXOOOOOOOXXOOXXOXXOOOXOOOXOOOOXOOOXOOOOXOOOXOXXXOOOXOOOOOOOOOOOOOOOOOOOOOOOXXOOOOXXOOOOOOXXOOXX
OOXOOOXOXOOOOOXOXOXOXOOOOOOXOXOOOOOOOOOOXOOXOXOXOXXOXOXOOOOOOOXOXOOOXOOXOOOOOOOOOXOOOOXOXOXOOOOOOOOOO
OOXXOOOOOOOOOOXOXXXOOOOOXOOXXXXXOOXOOXOXOOXOXOOXOXOXOOOOOOOOOOOOXOOXXOXOOXOXOOOXOOXOOOOOOOOOXOOOOOOOO
OOXXOOOOOOOXOOXXOXOXOXOOOOXXOXOXOXOXOOOOOOOXOOOXOOOOOOOXOOOXOOXOOOOXOOOOOXOOXOOOOXOOOOXXOOOOXXXOXOXOO
OOXOOOXOOOOOOOXOOOOXXXOXXOOXOOOXOOOOOOOXXXOOXXOOOOOXOOOOOXOOOOOXOXOOOOOXXXOOOOOOOOOXOOOOOOXXOXXXOOOOO
XOOXOOOOXOOOXOOXOOOOOOOOXOOOOOOOOOXOOOXOOXOOOOOXOOXOOOOOOOOXOOOXOOOOOOOOXOOOOOXOOOOOXOOOOXOOXOOOXOOOO
XOOOXXXOOOXOOXOOOXOOXXOXXOOOXOOOOOXXOOXXOOOXOOOXXXOXOXOOOOXOOOXXOOOXOXOOOOOOXOXOXOXOOOOXOXOOOOOXOXOOO
OOXOOXOOXOXOOOXOOXOOOOOXOOOOXOOXOXOOOOOXOXXXOOOOOOOOOOXOXOXXXOOOOXXOXOOOXOXOOOOXOOOOXOOOXOXOOXOXOOOXX
OOOOOOXOOOOOXOXOOXOOXXOXOXXOOOOOOOOOOXXOOXOOOOXOOOOOOXOOOOOOOOOOOOXXXOOOOOOOOOOOOOXOOXOOXOXXOXXXOOOOO
OXXXOXOOOOOOOOOOOOXOOOOOOXOOOOXOXOOXXOOOXOOOOXOOXOXOOXOOOOOOXOOOXOOOOOOOXOOOOXXXXOOOOOOOXOOXOXXXOXOOO
OOOOOOXXOOOOXOOOXOOOXOOOOOOXOOOXOOOOOXOOOXOOXOOOOXOOOXXOXOOXXOOOOXXOOOXOOOOOOOOOOOOOOXXOOOOOOXOOOXXXO
OOOXOOXOOXOOOXOOOOXXOOOOOXOOXXXOOXOOOXXOOOOXOXOOOOOOOOOOXOOOOXOOXOOOOOXOOOXOOOOOXXXOOOXOOOOOOOXXOXXXO
OOOOXXOOOOOXOXOOOXXOOOXOXOOXOXOOOXOOXOOOXOOXOOOOXXXOXXXXOOXXOOOOXXOXOXOOOOOXOXOOXXOOXOOOOOOOOOXOXOOXX
OOOOOOXOOOOOOOOOOXOOOOOXOOOXOXOOOOOOOOXOOOOOXOOOOOXXXOOOOOOOXOXOOOOOOXXXOXOOOXOXXXOXOOOXXXOXOXOOOXOXX
OOOOOXXOXOOOOOOOXXOOOOOOOOOOOXOOOOOOOOOOOOXXXOXOXXOXXXOOXOOOXXOOXXOXOOOOOXOXOOOOOOOOOXXXOOOOXXOOOOXOX
OOOOOOOOOXOOXOOXXOXOOOOXOXOOXOOXOOOOOXXOOOOOOXOOOOOOOOOOOXOOOXXOXOXOOOXXXXOOXOOOXOXOXXOOXOOOOXXXOXOOX
XOXOOOXXXOOOOOXXOOOOOOOOXOOOOOOXXOOOOOOOXOOXXXOOXXXOOXXOOOOXOOOOOXOOOXOOXOOXOOOOOOOXOOXXXXOOOOOOOXXOO
OXOOOXXXXXOOOOOOOOOOOXOOOOOXOOOOOOOOOOOOOOOOOOXOOXXOXXXOOXOOXOOOOXOOOOOOXOXXOXXXOOOOOXXXXXOOOOXOXOOXO
OOOOOOOOOOXOOOXOOOOXXOOXOOOOOOOOOOXOXXOXOOOXOXOXOXOOOXOXXOOXOOOOXOOXOOOXXXXOOOXXXXXOOOOOOXXOOOOXOXOOO
OOOXOOOXOOXXOOXOOOOXOOXOOXXXOOOOOXXOOOXOOOXOOOXOOOXXOXOOXOOOOXOOOXOOOOOXOOOOOOXOOOXOOXXOOOOOOXOOOOOXX
OOOOOOOOOOOOOOOOXOOXXXOXOOOXOOOOOOXXOXOOXOOXOOOOOOXOOOOXOOOOOOOXOXOXOOOOXOOOXOOXXOXOOOXOXXXOOOOOOOOOO
XXOXOOXOOXOXXXOOOXOOXOOXOOXOOOOXOOOXOOXXOOOXOOOOXOOOXXOOOXOOOOOOOOOXOOOXOOOOXOOOOOXOOOOOOOOXOXOXOXOOO
XOXOOOOOOXXXXOOOOXOOXOOOOXOOOXXXOOXOOOXOXOOXOOOXOXOOOOOXXXXOOOXOXOXXXOOOOOXOXOOXOOOOOXOXOOOOOOOOOOOOO
XOOOXOXOOXXXOOXOOOOXOOOOXOOXOXOOOOXXOOXOXOXXOOOOOOOXXOOOOOXOOXXOOOOOOOOXOOXXOOXOOOOOOOXOOOXOXXOXOOOXO
