OOOOOOOOOOXOXOXXOOXOOOOOXXOXOXOOOOXOOOOOOOOOOXOXXXXXOOOOOXXOOXOOXOOOOOOOOOXXOOOOOOOOOOXOOOOOXOXXXOOOO
OXOXOOOXOXOOOOOOOOXOOXOOXOXOXOOOXXXOOOXOOXOOOOOOOOOXXOXOXOXXOXOOOOXOOOOOOXOXXOOXOOXOXOOXXOOOOOOOOOOOO
XXOOXXOXXOOOOXOOOOOOOXOOOOOOOOOOXOOOOOOOOOOXOOOXOOOXOOOOOOXXXOXOOXXOXOXOOOOOOOOXXOOOOOXOOXOOOOOXOXOXO
OXXXOXOXOXOOOOOOOOXOOOOOXOOOOXOOXXOOOOOOOOXOOOXOOOOXXOOXXOXOOXOOOOXOXOXOXXOOXOXXXOOOOOOXOXOXOOXOOXOOO
OXOOOOOXOOXOXOOXOXOXOOOXOOOOOXOOOOOOXOOOOOOOXOOXOXXOOXOXOXOXXOOOOXXOOOOOXOOXOOOXOOXXOOOXOXOOOXOOOOOOO
OOOOOOOOXOOOOOOXOOXXOXOOXOOOOXXOOOXOOOOXXOOOOXXOOOOXOOOOXOOXXXXOOOOXOOOOOOXOOOOOOXOXXOOOOOOXOOXOOXOOO
OOOOOOOOOOOOXOXXXOOOOXXXOXOOXOOXOOXOOOOOOOOOOOOOOXOOOXOXOXOOOOOOOXOOXOOXXOOOOXXOOOOOOOOOOOOOOOOOOOOXO
XOOXXOXOOOOXOOXOOOXOOOOOOXOOOOOXXOOOOXXOXOXXOXOOOOOOXOOOOOOOXOXOOOXOOOXXXOXOXOOOXXOXXOXOOOOOXOOOXOOXX
XOOXOOOOOOOXOXOOOXOOOOOOXOOOXOXOOOOOOXOOOOOOXOOXXOOOOOOXXOOOOOOXOXXOOOOXXXOOOOOOOXXXXOOXOOXOOOOXOOOXO
XOOOOOOXOOXXOOOXOOOOOOOOOOOOOXXXXXOOXOOXOXXOOOOXOOOOOXOOOXOOOOOOXOOOXOOOOXOOXXXOXOOOOOOOOOOXOOOXXOOOO
XXXOOXOOXOOOOXOOOOOOOOOOOOOOOOXOOXOOOOXOXXOOOOOXXOOOOOOXOXOOOOXOXOXOOOXOOXOXOOOOOOXXOXOOOOOOXXOXOOXOO
OXOOOXOOOOOOXOXOOOOOOOOOOOXOOXXXXXOOOOXOXOXOOXOOXXOXOOOOXOXOXXOOOOOOOOOOOXXOOXOOXOOXOOOOXOOXOXOXOOXOO
OOOOOOOOOOOOOOXOXOOOOOOXOOXOOOOOXOOOOOXOOOOOOOOOOXXOOOOOOXOOOXXOOOOOXOOOOOXOXOXOXOOXOXXOXOXOXOOOXOOXO
OXXOOOOOXOOXOOOOOOOOOOOOXOOOOOOOOXOOOOOOOOXOOOOOOOOOXOOXXOOOOXXOOOOOOOOOXXOXXOOXXOOXOOOOOXXOOOOOXOOOX
XOOOXOOOXOOOOXOXXXOXXOOXOOOOOXOOOXXOXOOOOOOOOOOOOOOOXXXXOOOOOXXOOOOOOOOXXOXXXOOOOXOOOOOOOOXOXOOOOXOOX
XOOOOXOOXOXOOOOOOXOOXOXOOOOOOOOOOOXXOOOOOOOXXXXOOXOOOOOOXOOXOOOXOOOOXOOOOOOOOOXOOOOOOOOXOXOXXXOOXXOOO
XOOXOOXXOOOOOXXXOOOXOOXXXOOXOXXOOOOOOXOOOOOXXOXOOXOXOOXXOOOXXXOOOOOOOXOOOOXOOOOOOOXOOOOOXOXOXXOXOOOOO
OOXXXOOOOOOOXXOOXOOXXOXOOXXOOOOOOOXOOOOOOOOOOOXOOOOOOOXOOOOOXOXOOOOOOOXOXXOOOOOOOOOOOOOOOXOOOXOXOOOOO
OOXOXOOOOXOOOXOOXXOOOOOXOOOXOOOXOOOOOOOXOXOOOOOOOOOOOOXXOXOOOXXOOOOOOOXOOOXOOXOOXXOOXXOOOXOXXXOOXXXXO
OOOOOOOOOOOXOXOXOOOOXOOOOOOXOOOOOOOOOXOXXOOOOOOXOOOOOOXOOOOOXOOOOOOXOOOOXOOOXOOOXOOOOOOOOOXOOOOOOOXOO
XOXXXXXOOOOOOOXOOXOXXOOOOOXOXOXOOOOOOXOOXOOOOXXXOOXOOXOOOOXOXOOOOOOOOXOOOXXXXOOOOXOXOXXOOOOOOXXOOOXOO
XOOXOOOOXXXOOOOOOOOXOOOOXXOOOOOOXXOXOOOXXXOOXXOOOOOOOXXOOOOOOOXXOXOOOOXXXOOOXOOOOOXOOXOXOOXXOOXOOOOOO
XOOOOOXXXOXOXOXOOOOOOXOXOXOXXXOOXXOOOOOOOOXOOOOXOOXOXOXXXOXOOOXOXOXOOXXOOXOXOOOOOOOXOOXXOOOOOXOXXOOXO
OOOOOXXXXOOOOOOOOXOOXOOXXXOOOOOOXXXOOOOOXXXOOOOXOOOXOOOOXXXXOXXOXOOXOXOOOXXOOOOOOXXXOOXXOXOXOOOOOOOXO
OOXOOOXOOOXOXOOOXOOOOOOXOOOOOOOOOOXXOXOOOOXXXXXXXOXXOOOOOOOOOOOOXOOOOXOOXOOXXOOOOXXOOXOOXOOXOOOOXXXOX
OOOOXOOOXOOOXOOOOXOOOOXOOOOOOOOXOXOOOOXOOOOOOOOXXXOOXXXOOXOXXOOOOOXXOXOOOOOOOOOOXXOXXOOXOOOXOOOXOXXOO
XXOOOXOOOOXOOOXXOXOXOOOXXOOOOOOOOXOOOOXXOOOOOOOXOXOXOOXXOOOXOOOOOXOOXXXOXOXOXXOOOXOOXXOOXOOXOXXOOOOOO
XOXXXOOOOOOOOXOOOXOOOOOOOXOXOXOOXOOXOXOXXOOXOXOXXXOXOOOOOOOOOOXOOXXXOXXOOOXOXOOXOOOOOXXXXOOOXOOOOOOOX
OXOXXOOOOOXOXOOOOOOXOOXOOOXOOOOXOOOOOOOOOOOOOOOOOOOOOOXOOOXOOXOXOXOOOOOOOOXOOOXOOXOOOOOXOXOOOXOOOOOOO
OOOXOXOOOXXOOOOOOOXXOOOXOOXOXXOOOOXOOOOOXOOXXXOOOOOXOOXXOOOXXOXOOXOXOOOXOOXOOXOXOOXOOXOXOXOOOOOXOOOOO
OXXXXOXOOOOOOOXXOXOOOOXOOXOXOXOOOOXOXXXOOOXXXOXOXOOXOOOXXOOOXOOXOOOXXOOOOXOOOOOXOXOXOOXOXXOOOOOOOOOOO
OXXOOOOOOXOOXXXXOOOOOOOOXOOOOOOOOOXXXXOOOOXOOOXXXOOOXXXOOOOXOOOOXOOOOXXOXOOOOOOOOOOOOOOOOXOXOOOOOOXOO
OOXOOOOOOOOOXXXOOXXOOOXOOOXOOXOXOOOXOXOXOXXXOOOOOXXXXXOOXOOXOOXOOOOOOXOXOXOOOXOOOXOOOOOOXOOXXOXXXOOOX
OOXOOXOOOXOOXOXXOXOXOOOOOXOOOOOOOOOOOOXOXOXOXXXXOOOOOOXOXXOOOOOOOXOXOOXOOOOOOOOOOOOOOOXOOOOOOOOXXOOXO
XXXOXOXOOOOOOOOOOOXXOXXOOXXOXOOOXOOOOOOXOOOXOOOXOOOOOOOOOXOOOOOXOOXXXXOOOOOXXOXOXOOOXOOOXOOXOOOOOXXOX
OXXOXXOOOOOOOXOOXOOOOXOOXOOOOXOOXOOOOXXOOOXXOXXOOOXXOOOXXOOOOOOXXXOOOOOOOOOOOXOOOOOXOXOXXOOOOOOXXXOXO
XOOOOOOOOOOXOOOOOOOXOOOOOOOOOOOXOXXXXOXOOXOOXOOXOOOXOOOOOOXOOOXOOXOXOXXOOOOOOXOOOOXOOOOOXOXOOOOOXXOXX
OOOOXXXOXOOOOOOOXOXOOXXOXXXOOXXOXOOOOXOOXOXOOOXOOXOOOOOOOOOOOOXOOOOOXOOOOOOOXOOOXOOOOXOXOOOOOXOOOOOOO
XOOOOOXOXOXOXOOOOOOXXXOOXOOOOOOOOXOOOOOXOXXXOOOXOXOOOOXOOOOOOOXOOXXOOXOOOXXXOOOXOOOOOOOOOOOOXOOOXOOOO
OOOOOOOOOXXOOXXOOOXOXOOOOOXOOOOXOOOOXOOOOOOOOOOOOOOOXOXXXOOOXOOXXOOXOOOXOOOXOOOOOOOOOOOOOOOXXXOOOOXOO
OXXOOOOOOOXOOOXXXXOOXXXOOOOOOXOOOOOXXXOOOOXXXOOOOOOOXOOOOOOXXXOOOOOOOOXOOXXXOOOOOOOOOOXXOOOOXOOOXOXOO
OOXOOXOXOOXOOOXOOXXOOOXOOXXXXXOXOOOOOOOOXOOOOOOOXOOOOOOOOOOOOOXOOXOOOOOOXXOOOOOXOOOXOOOXXXXOOOOOOOOXO
OOOXXOOOOXOXXOOOOOOXOOXOXOOOXOOOOOOXOOXOXOOOOXOXOOOXOOOOOXXOOOOOOOOXOOOOOOOOXOXOOOOOXOXXXOOXOOXOOOOOO
OXOOOXOOOXOOXXOOOXOXXOXOOOXOOOOOOOOOOOOOOOOOOXXOOOXOOXOXOOOXXOXOXXOOOOXOOOXOXOOXOXXOOOXXXOOXOXXOXXOOX
XOOXOOOOOOOXXXXOXXOXOOXXXOOOOOOOOOOXXOOOOOOOOXOXOXOOOXOOOOOOOOOOOOOOXXXOOOOXOXOXXXOOOOOOXOOOXOXXOOOOX
OOOOOOOXOXOXOOOOOOOOOXOOXOOOXXOOOXXOXOOOOXOOOOOOOOOOOOOXOOXOXOOOOOXXXOXOOXOXOXXOOXXOXOXOOOOOOOOOXXXOO
OOOOOOOXOOOOOXOOXOXXOOOXXXXOOOOOOOOOXOOOXOOOOOOOXXOOOOOOOOOOOOOOXXOOOXOOXOXOXOOOXOOXOXOOOOOOOOXXOXOOX
XOOOOOOOXOXOXXOOXOOOXXOOOXXXOXOXOXOOXXOOOOOXOOOOXOOXOXOOXXOXXOOXOOOOOOOOOOOXOXOXOXOOXXOOOOOXOOOOOOOOX
XOXOOXOXOOOOOOOOOXXOOOOOXXXXOOOOOOOOOOOOXXOOOXOXOOXOOXOXOOOOXOXXXOOOXXXOOXOXOXXXOOOXOXXXOOXOOOOXOOOOX
XOOXOOOOXXOXOXOOXXXXOOOOOXOXOOOOXXOXOOOXOOOOXOOXXXOOOXXXOOOOOOOXOOOXOOXOXOOOOOOXXOOXXXXXOOOXOOOXOXOOO
OXOOOOXOOOXOOOOOXXOXOXOOOXOXOXOOXOOOOOOOOOOOOOOXXOOOXOOOXOOOOOOOOOXOOOOXOXOOXXOOOOOOXOOOOOOXXOOOOXXOO
OOOXXOOXXXOOOOOOXOOXOXXOXOOOOOOOOXXOXOOOXXOOOXXXOOOOOXOOOOOXOXXOOOOOOOOXOXOOOOXXOOXOOXOOOOOOXOOOXXOOO
OOXOXOOOOOOOOOOXOOOXOOOOOOXOOOOOOXOOXOOOXOOXOXOOOOXOOOOOOXOOOOXOXOOOOOOOOXOOOOOOOXOOOOOOOXOOXOXOOOXXO
OOXOXXOOXOOXOOOOOOOOXXOXOOXXXOOXOOXOOXOOOOOXXOXXXOOOOOXOOXOOOOOXOOXXXXXOOOXOOOXOOOOOOOXOOXXOXOOXOOXOX
OXOOOXXOXOOXOOOOOOXOOXXXOOOXOXOOOXOOOOOXXOXXOOOOOOOOXXOOOXXXOOOOOOOOOXOOXOOOOXXXOOOOOOXOOXXOXOXXXXOOO
OOXXXXOOOOOOOXOOOXOXOOOOOXOOOOOOOOXXXXOXOXOOXOOOXOXOOXXOOOOOXOOOOXOOOOOOOOXOOOOXOXOOOOOXXOOXXOOOXOXXX
XOOOXOOOXOOOOXOOXOOOOXOXOOXOOOOXOOXXOXOXOXOOOOXOOXOOOOXOOOXXOXOOOOOOXXOXOOXXOOOXOOOOOOOOOXOOOXXOOOOOO
XOXOOOOOOXOOOXOOOOOOOOXXOOOOOOXOOOOOXXOOXOOOOOOOOOXOOXOOOOOXOOXXOOOOOXXXOOOOOXOOXOOXXOXOXOOOOOOOOOXOO
OOXXOOOOXOXOXOOXOOXXOOOOOOXOOOOOOOOXOOXOOOXOOOOXOOOOOXOXOOXOXOXOOXOOOXOOXOOOOXOOOOXXXOOOOOOOXOOXOOOOX
OOOOOOXOOOXOOOOOOXXOOOOOOXXOOOOXOOXOOOOXOOXXOOOOOXOXOOXOOOOOXOOXOXOOOOXXOXXOOOXOOXOOXOOXXOOOXOOXXXOOO
XXOOOOXOOOOOOOOXXOXOOOOOOOOXOOOXOOXOOOOXOOOOOOOXOOOOOOXOOOOXOXXOXOXOOOXOXOXOOOOXOOOXOOOOOOXOOOXOXOOOO
OXXOOOXXOOXXXOOXOXOOOOXOXXOOOXOOOOOOXOOOOOXOOOOOXOOXOOOOOOOOOXOOXOOXOOOXOOXOOOOXOXOOOXOOXOXOOOOXXOOOO
OXXOOOOOOOOXOOXXOOOOOXOOOXXXXXOOOOOXOOXXOXXXXXXXOOOOXOXOOOOOOXOOOOOXXOXOXOOOOOOOXOOOOXOOOXOOOXOOOXOOO
XXXOOOXXOXOOXOXXOXOOXXOOOOOXOXOOOXOOOOOXOOOOOOOOOOXXOOOOOXOXOXOXOOOOXOOOOXOXXOOOXXOOOOXOOOOOXXOOXXXOO
XOOXOOOOOXOOOXOXXOXOOOXOOOOXOOXOOOXXOOOOOOOOOXOXXOOXOOXOXXOOOXOOXOXXXOOOOOOOOXXXOXOOOOOOXOOXOOOOOXXOO
XOOOOOXOOOOOXOOOOXXOXXOOOXOOOXOOXOOOXOOOOOOOOOXOXOOOOOXOOOXOOOXXOOOOOOXOOOOOOOXXOXOXXXXOOOXXXOOOOOXOO
XOXXOXOOOXXXOOXOOOOXOOOOOOXOOOOOXOXOXXOOOOOOOXOOOOOOOOOOXXOXOOOXOOOXOXXXOOOOOOOXXOOOOOXOOXXXOOOOOOXXO
OOOOOOOOOOOXXOOXOXXXOXOOXXOOXXOOOOOXXOOOXOXOOXOXOOOXOXOOOOXOOOOXOXOOOOXOOXOXOOOOXOXOOOOOOOOOOOOOOOOXO
XXOOOOOXOOOOXOOXOOXOXXOXXXXOOOXOXXXOXXOOOOOOOOXXOOXOOOXOXXOOOOXOOOXOOOOOOOOOOOXOOOOOOOXOOOOOXOOOOXXXO
OOOXOOXOOOOOOXXOOXOOXXXXXOOOXOOXOXOXXOOXOOXOOOOOOXOXOOXOXOXOOXOXOOXOOOXOXXOXOOOXOOXXOXXOOOXOOXOOOOXOO
OXOOOOOOXOOOXOOOOOOOOOOOOXOOOOXOOOOXOOOXOOOOOOOOOXXOOOOOXOOOOOXOOOOOOXXOOXOXOOOOOOXOOXXXOXOXXXOOOOOOO
OOOOXOOXOXOOXOOOOOOOXOXXOOOXOOOOOOXOOOXOOOOOXXXOXXOOOXXOXOXOOOOOOOXOOOXOOOXOXOOOOXOXOOXOOOOOXXXOOOXOX
OXOOOOXXOOOOOOXOOOOXXXOOOOOOOOOXOOXXOOOOOOOOOOOOXOXXOOOOXOOXOXXOXOXXOOXOXXOXOOOOOOOXOOOOOXXOXXOOOOOOX
OOOXOXOOOOXXXOXXXOXXOOOXXOXXOOOXXOXOOOOOOXOXOOOXXOOXOOOOOOXOOOXOOXXOOOXXOOOOXOOOOXOOOOOOOOOOOOXOXOOOO
OOXXOOOOOXOOOOXOOXOXOOOXOOOXOOOOOXOXOXOOOOOXOOOOXOOXOXOOOOOXOXOOXXOOXOOXOXOOXOOXOOOOXOOXOOOOXOXOOXOOX
XOOXOOXXOOOOOOOOOOOXOOOOOOOOOOOOOOOOOOXOXXXOOXXXXOXOOXOXOXOOOOOOOOOXOXXOOXOOOOXOXOOOOOOOXXOXOXXOXOOOO
OXOOOOOOOOOXOOOOXOOOOXOOXXOOXOOOOXOXOOOXOXXOOOOOOXOOOXOOOOOXOOOOXOOOOXOOOXOOXXOOXOOXOOXOOOOOOOOOXXOOO
XOXOOOXOOOOOOXOOXXXOOXOOXXOOOOOOXOOOXXOXXOOOOOOOOOOOOOOOXOOOOOOOOXOXOOOOOOOOXOOOOOXOOXOOOOXOOOXOOXXXO
OXOOOXOOOXOOXXOOOXOOXXXXOOOXOOOXOOOOOOOOOOOOOXOXXOOOOOXOOXOOXOXXOOXOOOOOXOXOOOOOOOXOXXOXXOOOOXOXOXOOO
OOXXOOOXOOXOXOOOXOOOOOOOOOOXXOOOOOOOOXXXXOXXOOOXXOOXXXOOOXOXOXOOOOOOOXOOOXOXOXOOXOOOXXOXOOXXOOXXOOOOX
OOOOXOOOOOXXOXOXOOXXOOXXXOXOXXOOOOXXOOOOXOOOXOOXOOXXOOOOXOOOOOOOOOOXOOOOOOOOOOOOOOOXOOOXXOOOOOXXXXXOO
OOOXOOOOOOOXOXXOOOOOXXOOOOOOOOOOXXXOOOXXOOOOOOOOXXXOXXOOOOXXOXXOOOXOOXXOXOXOOOOOOOOOXOXXOOOOXXXOXOXOO
OOOXOOXOXOXOXOXXOOOOOOXOOXXOOOOOOOOOOXOOXOXOOOOOXXXXXOOXOOOOOOOOOOOOOXOOOXOXXXOOOXOOOOOXXOOOOOOOOOOOO
OOOXOOXXXOOOOXXOOXOXOOOOOOOOOOOOOOOOOXOXOOXOOOOOOOXOXOOOOOOXOXOOOOOOOXOOXOOOOOOOXOOXOXOOOOXOOOOOOOXOX
XOOXXXXXOOOXXOOOOXXOOOXXOXOOOOOOXOOXOOOOXOOOXXOXOXOXOOOOXOOOXOXXOOXXXOOXOOOOOOOOXOOXOXXOXOOOXOOOOOOOO
OOOXOOXXXOXOOOOOOOOOXXOOXOXOXOOOXOOOXOXOOOOXOOOOOOXOXOXXOXOOOOOOXOOOXXOOOOXXXXXXOXOOXXOXOOOOOXXOOXOOO
OOOOXOOOOOOXOXOOOOOOOOXOXOXOOOXOOXOXOOOOOOOXXXXOOOXXOXOOOOOXXXXOXOOOOOOXOOXXXOOOOXOOOOOOOOXOOOOOOXXXX
OOOOOOOOOOXOOOXOOOOOOXOXXOOOOOOOOOOOOXOOXXOOXOOXOOOOXOXOXOXOOXOOOOXOOOXOOOXOOXXOXXXOOOOOOOOOOOOOOXOOO
OOXOOOOXXOOOOOXOOOOOOOOOXOOOOOOOOOOXOOOOOOOXOXOOOOOOXOOXOOOOXOXOOXOOXXXOXOXOOOXOOOXOXXOOOOOOOOOOOOXOO
XXOXXXXOOXOOOOOOXXOXOOOOOOOXOXXXXOOOOOXOOOOOOOOOOXXOOXOOOOOOXXOOXXOOOOOOOOXOOOOOOXOXOOOOXOOOXXXXXOOOO
OOXOOOOOXOXOOXOOXOOXXOOOOXOXXOXOXOOOOOXXOOOOOOOXOOXOOOXOOOXOOOOOOOXXOXOOOOOOXOOOOOOOOOXOOOOOXOXOOOOOX
XXXXOOXOXOOOOOOXOOOOOOOXOOXOOOOXOOXOOOXOXOOOOOXOXOXXOOOOOOXXOOOXOOXOXOOXOXXOOOOOXOOOOXOOOOOOOOOXOOOOO
XOOOXOOXXOOOOXOOOXOXOOOOOOOXOOOOXXXOOOXOOOOOOXOOOOXOOOOXOOOOXOOOOOOXXOOXOXOXOXOOOXOXOOOOOOOOOOXOOOOOO
OXXOOOOOXOXXOXOOXOOXOOOXOOOXOOOOOOXOOOOOOOXOXOOOOOOXXOOOOOXXOOOOOOOOOOOXOOOOOOXOXOOXOOXOXOOOXOXOXXOOO
OOOOXOOOOXOOOOOXXOOXXOOOXXOOOXXXOXXXXOOOOOXOOXXXXXOOXXOOOOOOOOOXOOOXOOOOOOXOOOOXXOXOOOXXOOXOXOOOOOXOO
OOOOOXXXXXXOXOOOXOXOXOOOXOXOOOXOXOXOXOOOOXOOXOOOOXOOOXOOOXOXXXOOOOOXOOXOXOOXOXOOOXXOXOOXXOOOOOXOOOXXX
XOOOOOXOOXOXXOOXOOXOOOOOOOXOOOOOOOOXOXXOXXOXOXOOXOOOOXOOOXOOOXOXXXOXXOOXOOOOOOXOOOOOOOOOOOOOXOOXOOOXO
XOXOOXXOOOOXXOXXOOOOOOOOOXOXXOOOOXOOXOOOOOOXXXOXXXOOXOOOOOOOXXXXOOOOOXXOXOOOOOXOOXOXOOXOOOOOOOXXXOOOO
OOXXOXXXXOXOXXXOXXOOOXOOOXOXOOOOOXOOOOXXXXOOOOOOOXOXOOOXOOOOOXOOOXXXOXOOOXOOXOOOOOOOOXOOOOOOOOOXOOOXO
XXOOXOOXOOOOXOOOXOOOOOOOOOXOOXXOOOOOXOXXOOOOXOXXXOOOOOOXOOOOXOXOOOXOOOXXOOOOOOOOOOOOOXOOOOOOOOOXOOOOO
OOOXOOOOXXOOXXOOXOOXOOOOOXXXOOOXOXXXOXOOXOOOOOXOXOOOXXOXXOOOXOOOXOXOXOOOOXOOXXOOOOOXXOOOOOOXXOOOOXOOO
