OOOOOOXOOOOXOOOOOXOOOXXOOXOOXOXOOOOXOOXOXOXXOOXOOOOOOOOOOOOXOOOOOXOXOOOOOOXXOOOOOXOXOXOXXXOOXOXOOXOOX
OOXXOOOXOOOOOOOOOXOOOXOOOOOXXOOOOOOOXOOXOOOOXOOXXOOXOXXXOOOOOXXXXOOXOOXXOOOOOOOOXXXOOOOXOXOOOOOOOOOXO
OOOOXXXOOXXOOXOXOOOOXOOOXOXOXOXXOXOOOOOOXOOOOXXOXOOOOOOOOXOOOXOOOOXOOOOOOOOOOOOOOOOOXXXOOXOXXOXOOXOOX
OXOOOXOXOOOOOOOOOOOOOOOOOXOXOOOOOOOOOOOOOOOOOXOOOOXXOOOOOOOOOOOXOOOOOOOXXXOOOOXXXOXOXOXXOOOXOOOOOXOOO
OXOOOXOXOXOOOXXOOXOOXXOOOXOOXOXOOOXOXOXXXOOOOXOOOXOOOXOOOOOOXXOXOOOOOOXOXOOOOOXXOOOOXXOOOOOXXXOOXXXOO
OXOOOOOOOXOXOXXOOOOOXXOOOOOOOOOOOOXOOXOOXXOOOXOOOOOOOOOOOOXOXOXOXXOXOOOOOOOOXOOOOXOOXXOOXOOOOOOXXOOXX
XOOOOXOOOOXOOOOOOOXXXOXOOXXXOOOOOOOOXOOOOXOOOOXOOOOOOOOXOOXXXOXXOOOOOOOOOOOXXOXXOOOXXXOOOOOOOOOXOOOXO
XOOXXXOOOOOOOXOXXOOOXOOOOOOOOXXOXOOOOOOOOOOOOOOOOXOXXXXOOXOOXOOOOOOOXXOOOOOOOOXXOXOOOXOOOXOOXXOOOXOOO
OXOOOXXOOXOOOOXOOXXXOOOOOOOOOOOOXOOXOOOOOOOOOOOOXOOOOXOOOOXOXOXXOOOOOXOOOOOXOOXXOOOOOOXOOOOOOOXOOOOOO
OXXOOXOOOOXXOOXOOOOOOOXOOXOOXOOXXOOXOOXXXOXOOXXOXOOOOOOOOOXOOOXXOXXOOXOXOOXXOXOOXOXOOXOXXOOXXOXXXOXXO
OOOXOXXOOOOXXOOOXXOOOOOOOXOOOXOOXXXXXXOOOOOOXOOOXOXOOOOOXOXOOOOXOOOOOXOOXOOXXOOOOOXXOOOOOOXOXOOOXOOXO
OXOOOXXXOXXOOXOOOOXOOOOOOOOXOXXOXXXXOOOOXOXOOOXOOXXXOXOOOOOOOOOOOXOXOOOOOXXXOXOOXOXOXOXXXOOXOOXOXXOXO
OXOOOOOOOOOOXOOXXOOXOOOOXOOXOXOOOOOOOXOXXXOOXXXOOOOOOOXXOOOOOOOOOOOOOOOOOOXOOOOOOXOXOOOOXOOOOXOOOOOXO
OOOOXOXOOXOOXOOOOXOOXOXXXOXOOOOOOXOXOXXOOOXOXOOOOOOOXXOOXOXOXXXOOXOOXOOOOOOXOOOOXOOOXOOOOXXOXOXOOOOOX
OOXOOXOXXOXOXOXOOXXOXOXOOXOOXXXOOOOOOXOXOOOXOOOOXXOOXOOXOOOOOOOOOXXOOOOXOOXXOXXOOOOOOOOOXXOXOOXXXOOXO
OOXXOOXXOOOXOOOOOOOXOOOXXOXXOOOOOOOOOOXOOOOXOOOOOOOOXOOOXXOOXXOXOOXOOXXOOXOOOXOXOOOXOOOXOXOOXOXOOOOXO
OXXOOOOOOXOOXOOXOOXOOXXOXOXOXXOOOOXOXOOXXXXXOOOOXXOOOXXXOOXOOOOXOOXOOXOOOXOXOOOXOOOXOXOXOOOOXOXOXOOOO
OOXOOOOOOOOOOOOXXOOOXOOOOXXOXOXXXXOXXOXOOOOOOXXXOOOXOOOXOOXXOOOOOXXOOOXXOOOOOOXOXOXXXXXXXOOOXOOOOOXOO
OOOOXOOXOXXOOXOOXOXOOOXOOXOXOXOXOOOXOXOOXXXOOXOOXXOOOOOOXOOOOXOOXXXOOOXXOOOOXOOXOOOXOOXOOOOOXXOOOOXXX
OOOXOOOXOOXXXOXOOOOOOOOXXOOOXOOOOOOOXOOOXOOOXOXOXXOXXXOOXXXXOOOOXOXXOOXOOOOOXXOOXOOOOXOOOXXOOXOXOOOOO
OOOXOXOOXOXXOOOXOOOOOOXXOXXXOOOOOOOOOOOOOXOOOOXOOOOXOOOXXOOXOOOXOOOOXXOOXOXXXXOOOOXOOOXXXOXOOXOOOOOOX
OXOXOOOOOOOOOOOOOOXOXXOOXOOOXOOOOXOXOOOOOXXOOXXXOOOOXOXOOOXXOXXOOXXOOXXOOOOOOOOXXXOXOOOOOOXOOOXOXOXOO
OXXOOOOXXXOOOOOXOOOOXXOOOXOOOOOOOOOXXOOXOOOOOOOOOXXOOOOOOXXXOXXOOOOOXOXOOOXOOXXOOOOXOXXXXOOOOOOOXOXOX
OXOOOOOOOXOOOXXOOOOXOOOOOXOOXOOOOOOOXOOOOXOXXOOXOXOXXXOOOXXOOOOOXXXOOXOOXOXOOXOOOOOOXOOOOXXXOOOOOOOOX
OOXOOOOOOOXOOOXXOOOXOOXOXXOOXOOXOOXOXXOOOOXXOOOXOOOXXOOOXOXOOOXOXOOOXOXOXOOOXOXOOOOOOOOOOOOXOOXXXXXXO
OXOOOOXOOOOOXXOOOOOOOOOOOXOOXOOXXOOOOOOOOXXOOOOOOOXOOXOOXOOOXXOOOXOOXXOXXXOOXOXOOOOOOOXOOXOOOOOOOOOXO
XOXOXOOOOOOOXOOOOOXOXOOXXXOOXXOXOOOOOOXOOXOOXXOOOOXXOOOOOOXOXOXXOXOOOXOOXOOXXOOXXXOOOOOOOXXOOOOOOOOOO
OOXOOXXOXXXOOOOOXOOOOOOXOOOOOOOXOXXOOOOOOOOXXOOOOOXXOOXOOOXOOOOOXOXOOOXOXOXXXOOOOOOXOOOXOOOOOOXXXOOOO
OOOOXOOOOOOXOOOOOOOOOOOXOOOOOOOOOOOOXXOXOOXXOOOOOXOOOOXOXXXOXOOOOXOOOOOOOXXXOXOOXXOOOOOOOOXOOOOOOOXOX
XOOOOOOXOOXOOXOOOXOOOOOXOOXOXOXXOOOXOOXXXOOOOOOOOOOOXOXXOOOOXXOOOOXXXXOXOOOXOOXOOOOOOXOXOOOXXOOXXOXOO
XOOXXOOXXOOXOXOOOOOXXOXOOOOOXOOXOOXXOXOOOOXOXXOOOOOOOOOOOOOXOOOOOXOOOOXOOOOOOOOOOOOOXXOXOXXXOOXOOOOOO
XOXOOOOOXOOOOOOOOXOXOOOOOOXOXOOOOOOOOOXOXOOXOOOXOOOOOXOOOOOOOXOXXOOOXOOXXOXOXOOOOXXXXOOOOOOOOOXOOOOOO
OOOOOXXOOOOOXOOOOOOXOXOXXXOXOOOOXXOOOOOOOOOOOOXXXOXOOOXOOOOXOOXXXOOOXXOOXXOXOOXXOOXOOOOOOXXOOOOOOOOOO
OOXOXXXXOOOXXXOXXXOOOOXOXOOOOXXOOOOOOXXOXOXOXOXOXOOOOOXOXXXOOXOOXOOOOOOXOOOOOXXOOOOXOOOXOOOOOXXOOOOXO
OXOXOOOOOXXXXXOOXOXXOOXOOOOOOOOOXOOXXXOXXOOXOXXOOOOOOXOOOOXXOOOXOOOOOOOXXOOXOOOOOXOOOXXXOOXXOXOOOOXOO
OOOOXOXOOXOOOXOOOXOXOOOOOOOOOOOOOOXOOOXXOOXOOOOOXOOOOOXOOOOXOOXXXOXOOOOXOOOXOOOOOOOXOOOXXOOOOOXOOOOOO
XXOOOOOXOOXOOOOOOOXOXXXOOOOOOXOOOOOXOOOOXOOOOXXOOXXOXOXOXXOOOXXXXXXOOXXOOOXOOOXXOOOOOOXXOOOXXOXOOOOOX
XOOOXXXXOOXXOXOXXOXOOOOOXXOOOOXOOOOOXOOXOOOXOOXOOXOXOOXXOXOXOOOXOOOXOXXXOOOOOXOXOOXOOOXOOOOOOOOOOXXXX
OOOOOXOOOOOOOOXOXOOOXOXOOOOXXOOOOOOOXOOOXOOXOOXXXXOOOOOOXOOOOOOOOOOOOOXOXOOOOXOOOXOOXOOOOOOOXOOXOOOOO
OOXOXOXXOOOOOOOOOOXOOOOOOXOOOXOOXOOXXOXXOXXOXXOOOOOOOXOOOOOXOOOOXOXXOOOOOXXOXXOOOOOXOXOOOXOXOOXOOOOOO
OOOOXOXOXXOXXOOOOOOOXOOOOOOOOOOOXOXOXXOOXXOOOOOOOXOXOOOOXOOOOOXOOXOOOXOOXOXOXOOOXXOOXOXXXOOOOOOXOOXOX
OOOOXOOOOOXXXXXOOXOOXOOXOXOOOOOOXOOXOXXOXOOOOOOOOOOOOXOXOOOOXOOOOOOOOOOOOOXXOOXXXXOOOOXOXOXOXOXOOOOOO
OXXOOOOOXOOOOOOOOXOXOOOXOOOXOOOXXOOOOOXXOOXXOOOOOOOOOOXXXOOXOOOOOOOOOOXOOOOOOOOXXOOOXXXOXOOOOXXXXOOXO
XOOOXXOXOXOXXXOOOOOOXXOOXOOXOOOOOOXXOXOOOOOOXOOOOOOOOOOOOXOOXXOXOOXOOOXXOXOOOXOXXOOOXXOOOOOOOOOOOOOXX
OOOXOOOOOXOOXOOOOXOOXOXOOOXOOXOOOXXOOOOOOOOOXOOXOOOOXXXOOOOOXXOXXXXXXOOXOOOOXOOXXOOOXOOXOOOOOOOXOOOOX
OOOOXOOOOOOXOOOOXOOXOOOOOXOOOXOOOOOOXOOOOOOOOOOOOXOOOXOOOXOOOOOOXXXXXOOOOXOXXOXOOXOXXOOOXXOOOXXOXOOOO
OXOXOOXXOOOOOOOXOOOOOOXOOOXOXXOOXXOOXOOXOOOXOXOOXXXOXXXXOOXOOXOOOOXOOOOOOXXOXOOOOOOOOOXOOOOOOOOXXOXOX
OOXXOXOOOXOOXOOOOXXXOXXOOOOOXOOXOXOOXOXOOXOXOXOXXOXOOXXOOOXXOOOXOOXOOOOOOOOOOXOOXOOOOOXOXXXXOOXXOOXOO
OOOOOOOOOXOOXOOOOOOOOOOOOOXXOOOOXXOOXOXXOOOXOOXOOOOOXOOOOOOOOOOOOOOOOXOOOOXOOXXXXOOOXOOOOXOOOOOOOOOOX
XXXOXOOOOOOOOOOXXOOOOXOOXOXOOOOOOOOXOOOOOOXXOOOOOOXOOXXOOOXOOOOOOOOXOOOOOXOOOOXOOOXOOXOOOXOOOOOOOOOOX
XXXOOOOXOOXOOXXOOOOOOOXOOOXXOOXOOOOOOOOXOOOOOOOOXXXXOOOXOOOXOXXOOOOOOOOXOXOOXOXOXXOOOOXOXXOOOOXOXXOOO
XXXOOOOOOOOOOOOXOOXXOOXOOXOOOOXOOOOXOOOOOOOOOOOXXOOOOOOXOOOOXOXOOOOOOXOXOOOXOOOOOOXOXXXOOXOOXOOXOXOOX
OXOOOOOXOOXOXXXXXOOXOXXOOOOOOXXXOOOOXOOOOOOOOOXOOOOXOOOOOOOOOOOOOXXOXXOXXOOOXOXOOOOOOOOOOOXXOOOOXOOOO
XOOOOOOOOOXXXOOOXOOXOOOOOXOXXOXXXXOOXXXXOOOOOXOOXXOOOOXOXXOXOOOOOOOOOOOXXXOXOXOOOOXOXXOXOOOOOXOOOXOXX
OXOOOXXOOOOOXOOXOOOOOOOXOOOXXOXXOXOXOOOOOOOOOXXOOOOOXXXOOOOXOXOXOOOXOXOOXOOOOOXOOOXOXOXOXXOXXXOXXOOXX
OOOOOOOOOOXXOOOOXOOOOXOOOOXOOOXOOXXOOOOOOOOXOOOOOOOXOOOXXXOOOOOOOXOOXOOOOXOOOOOXXOOOXOOXOOOXOOXOOOOOO
OOOOOOOOOOXOXXOOOOOOOXOOOOOOOOOOOOOOOXOOOOOXXOOOOOOOOOXOXXOOXOXOXXXXOXOOOOXXXOXOOXXXOOOOXOOOXOOOXXXXO
XXOOOOXOOXOXOOOOOOOXOOOOXOXXOXOXXXOOXXOOXOOXOOOOXOXXXXOXXOOOOOOXOOOOOOOOXXOOXOOXOXXXOXXOOOOXOOOOOOOXO
OOXOOXXOXXOOOXXXXXOOOXOOOOXOXOXOOXOOOOXXOXOXOOOXOOOXXOOXOOOOOOOOOXXOXOOOOOXOXXOOOOOOXOOOOOOOXOOOXOOOO
OOOOOOOOOXOOXOXXXOXOOOXOXOXOOOOXOXOXOOXOXXXXOXXOXXOOXOOOOXOOOOOXOOOXOOOOXXOOOXOOXOOOOOOOXOXOOOOOOXOXO
OXXXOOOOXOOXOOOOOOOOOOXOXOXOXOOXOOXOOOOOOOOOOOOOXOOOXOOOOXXOXOOOOOOXXXOOXXOOXOOXXOOOOXOOXXOOOOOOOOOOO
OXOXOOOXOOXOOXXOOOXOXOOOOOOXXXXOOOOXXXXOOOOOOOXOOOOOOXOXOXOOOOOOXOXOOXXOXXOXOOOXOXXOOXOOOXOOXXXXOOXOX
OOOOOOOXXOOXXOOOOXXOOOOOOOOOOOOXOOXXOOOXOOOOOOOOOXOOOOXOOOXOOOOOOOXXOOXOOXXXOXOOOOOOXOOXOOOOOOOOOOOOX
OXXOXOOXXOOXXOOOOOOOXOOOOOOXOOOOOOOOXOOOOOOXOXOOXOOOOOOOOOOOOOOOOOXOOXXXOXXOXOOOXOOOOOXOOXOXOOOOOOOOO
OOXXXXOXOOOOOOOOOXOOXXOXOOOOOOOOXXOXXOOXXXOOOOOOXOOOXOXOOXOOXXOOXXOOOOXXOOOOXOOOXOOOXOOXOOXXXOOOOOOOO
OXOOXOXOOXOOOOOOOOOXOOXXXOOOXOOXXOOOXOOOOOOXOOOOOOXOOOOOXOXXOOOXOOXOOOOXOOOOOOOXOOXOOXOOOOXOOOOOOOXOX
OOXXOXOOOXOOOOOXOXOOOOOOOOXXOXOOOXOOOOXOOOOOOOXOXOOOOXXOXOOOOOXXOOXOOOOXOXOOOOOXOXXOOOOOXOOOOXOXOXOOO
OXOOOOXXXXOOOOOXOOOOOOOOOXOOXOOXOXOXOXOOOOOXXOOOOOOXXOOOXXXOOXOXOOOOOOXOOOOXOXOXOOXXOXOOXOOOOOOOOOOOX
XOXOOOOOOXXOXXOOOOOOOXOOXOXOOXOOOOXOOOOOXOOOXOXOOOXXOOXXOOOOOOXOXOOOOOOOOOOXOXXOOOOOXOOOOOOOOOOOXXXOX
OXOOXOOOXOOOXXXXOXXXOXOOOXOXOXOOOOOXOXXOOXXXOXXXOOOOOOOOXXXOXOXOOOOOXOXXOOOXOXOOXOOOOOXOXXOOOOXOOOOOO
OXXOOOXXOOOOOOOOOOXOXOOOXOOXOXOOOOOXXXOOOOOXXOOXXOOOXOOOOOXOOOOOXXXOXXXOXXOOXOXOXXXOOOOXXXOOOOOXXXOOX
OOXOXOOXOXOXOOOOOOXOOXOOOXOXOOOXOOXOOXOOOXXOOOOOOXXOXOOXXXOXXXXXXOOOOOOXOOOOOOOXOOXOOOOOOOOOXXOXXOOOO
OOOXOOXXOOOOOXXXOXOOOOXOOXOXOXOXXOXOOOOXOOOOOOOOOOXOXXOOXOOXOOOOOOXOOOOXXOXXXOOXXOOOOOOOOOOOOOXOOOXOX
XOXXOXOOOXOOOOOOOOXXXOOXOOOOOOXOOXOXOXOOOOOOOOOXXOXXOOOOOOXXXOOXOOOXXOOOOOXXXXXOOOOOOXXXXOOXXXXXOOXOX
XOOOOOOOOOOOXXOOOOOOOOOXOOXXOOOOOOXXOOOXOXXOOOOOXXXOOXOOXOOXOOOOOOOXOOOXOXOOXOXOXOOOXOOXOXXOOOOOOXOOO
OXOOOOOOOOXOOOOXOOOXOOXXOXOOOOOOOOOOXOXXXOXOOOOOOXOOXXXOOXOXXXXOXOOOXOOOOXOOXOOOXOOOOXOXXOOXXOOOOXOXO
OXOOOOXOOOOOXXXOXOOOOOOXOOOXOOOXOOOXOXOOXOOXOXOXOOOXXOXOOOOOOOXOOOOOOOXOOOOXXOXOOOXXOOXOOXOOOOOOOOXOO
XOOXXOXOXXXXOXOOOXOOOXOOOXOOOOOOOOXOXXXOXOOOOOOXOOXXOOOOXOOOOOXOOOOOOOXOOXXXOXOOOOXOOXOOOOXOOXOXXOXOX
OXXOOXOOOOXXOOOOOOXOOXOOOOOOXOOOOOXXOXXXXOOXOOXXOXOOXOOOOOOOOOOXXOOOOOOOOXOXOOOOOOXXOOOXOOOOOXOOOXOOO
OOOOXOOOOXXXXOXOOOOXXOOOOXXXOOOXOOOXXOOOOOOOOXOOOOOOXOOOXOOOOXOXXOXOOXOOOOOXXOXOOOXOXOOOXXOOOOOOXOXOX
OOOOXXXOOOOOXXXOXXOOXOOXOXXOOOOXOOOOOOOXOXOOXXOXXOOOXOOOXOXOOOOOOXOOOXOOOOOOOOOXOOOOOOOOXXOXOXOOOXXOX
OXOOXOOOXOOOXXOOOOOOXOOOOOOXOXOXOXXOOXOOOOXOOXXOOOOOXOXOOOOOXOXOXOOXXXOOXOOOXOOOOOOOOXOOXOXOOOOXXOOOO
OXOOOXXOOOOOOOOOOOOOOOOXXXXOOXXOOOOXOOXOOOOXXOOOOOOOOOOOOOXOXOXXOOXOOXOOOXOOOOOOXOOOXOOOXXXOXOXOXXOOO
XXOXXOOOOOXOOOXXOOOXOXXXXOOOXOOXOOOOXOOOOOOXOOOXOOOOOOXXOOXOXXXXXOOOOXOXOXOOOOXOOXOXOXOOOOOOOOOXOOXOO
OXXOXOOXOOXXOXXOOOXOOOXOOOOXXXOOOOOOOOXOXXXXOOOOOXOOOOOXOOOOOXOOOXXOOOXXOXOOOOOOOXXOOOOOOOXOXXOXXOOOX
XOOOOOOOOOXOXOXOOOXOOOXXOOOXOOOOOXOOOOOXOXOOOOXXXOOOOXOXXXOOXOOXOOXOOXOXOOOOOOOXXXOOXOOOOOXOOOOOOOXOO
XOOOXOOOXOOOOOOXOOOXOOOOXOOOOXXOOOOOOOOOOOXXOOOXXXOXOOXOXOOOOXOXXXOOOOOOOOXOOXOOOOOXXOOOXXOOOXXOXOXOO
XOOOOOXOXXOOOOOOXOXOXXOOXXOOOOOOOXOOOOOOOXOOOXXOOOOOOOOOOOOOOOXOXOXOOXXOOXXOXOXXOOOOXOOXOOOXOOOXOOOOO
XOOXOOXOOXOOOXOXXXXXXOOOOOXOOOOOXXOXOOOOOXXOOOOOOOOXOXOOOOXXOXOOOOOXOXXOOOOOOOXOOOOOXOXOOOXXOOOXOXOOX
XOOOOOOXOXOXXOOXOOOOOOOOOXXOOOOOOXXXOOOXXOOOOOOOXXXXXXOOOOOOOXXOOXOXOXOOXXOOOXOOOXOXOOOOXXOOOOXXXXXOO
XXXXOOXOOOOXOXOOOOXOOOOOOXOXXOXOOOXXXXXOOOOOXXXXOXXOOOOOOXXXXOOOXOOOOOOXXXXOOOOOOOOOXXOOOXOOOOOXOXOOO
OXOOOOOXOXOXOOOXOXOXOOOXXOOOOOXOOOOOOOOOOXOXOXOOXOOOOOOXXOOOXOXXOOXXOOOOOOOOOOOOOOOOOOOOOOOXXXXOXOOOX
XOOOXXOXOXOOOOOOOOOXOOOXOOXOOOOOOXOOOOOOOXOOOOOXOOOXOOOOXOOXXOXOOOOXXOXOOOOOOOXXOOOOOOOOOXOOXXOXXXOOO
XOOXOOXOOOOOOOXOOXOOOXOOOOXOOXOXXOXOXOOOXOXOXOXOOOOXOOOOXXOXOXOXOXXOOOOXOXOOOOXXOOOOOXOOOOXOOXXOOXOOX
OXXOOOXXXOXOXOXXXOOXOXOOXOXOOOXOXOOXXXOOOOXOOOOOOOXOOOOOXOXOXOOOOXOOOXOXOOOOXXOOOOOXOOOOOOXOOOOOOXXXX
OXOOXOOXXXOXOOXOOXXXOOOOOOOOXOOOOOOOXOOOOOOOOOOXOXOOXOOOOXOXXOOOOOOOOOOOOOOOXOOOOOXOXXOOOXOOOXOOXOXXO
OOOOOXXXOOOXOOOOOOOXOOOXOOOOOXXOOXOXOOXOOOXOOXOOXOOOXOXOXXXOOOOOXOXOOOOOXOXOOOOOXXOOXOXOOOXOOOOOXXOOO
OXOXXOOOOOXOXOOOOOOXXOOOOOOXOOOOOXXOOOOOOXXOOOOXOOXOXOXOOXXOXOXXXOOOOOOXOOOXOXOOXXOOOXXOOOOOOXOXXOOOO
XOXXXXXOOOOOXXOOOOOOXOOOOOOOOXXOXXXOOOOOOOOOOOOXOOOOOOOXOOXXOXOOOXOOXOOOOXXOOOOOOOOXOOOOOOOOXOXOOOOXO
OOOOOOXOOXOOOOOOOXXOXXOOOOOOOOOOOXOOOOOOOOXOOOOOOOXXXXOXOOOOOOXOOXOOOOOOOOXXOXOOOOXXOOOOOOOOXOXOOOOOO
XXOOXOXOOXOOOOXOOOOOOOXOOXOXOXOOOOOXXOOOOOOOXOOOXXOOOOXOOOOOXOXOXOOOOOOOXXXXOXOXXXXOOOOOOOOOXOXOXXOXO
