OOOOOOOXOXXOOOOOXOOOOXOOOXOXXXOOOOOOOXOXXOOOXXOOXOOOOOOOXXOOOXOOOXOOOOXXOOOXXOXOOXXOOXOXOOOOXOOOOOOOX
OOOOXOOXXOXOOOOOOOOXOXOOOOOOXXOOOOXXOOOOOOOOOOOOXXOOOOXOOOOOOOOOOOXOOOOOOXOXOXOOXOOOOXOOXXOOOXXXOOOOO
OOOXOOXOXOOOOOXOOOOOXXOOOXOOOOOOOOOXOXXXOOXOXXXOOOOOOOOXXXXOXOXOXXOOXXOXOOXOXOXXOOXXXOXOOOOOOOOOOOXOO
OOOOOOOOOOXXOXOXOXOOOXXXXOOOXOXOXXOOOXOOXXOOOXXOOXOOOOOOXXXOXOOOXOOOOOOOOXOXOOXOOXOXOOXOOOXXOOOOXOOOX
OOOXXOXXOOXOOOOXXXXOOOXOXOOOOOOOXOOXXOXOOOOOOOOOOOXXOOOOOOXXXOOXOOOOXOOOOOOOOOXOOOOOOXXOOOXOOOOOXOXOO
XOOOOOXXOOOXOXOOOOOOOOOOOOOOOOOOOXOXXXOOXOXOXXOXOOOOOOOOOOXOOOXOOOOOOOOOXXOOXOXOOOXOOOOOOXXXXOOOOOXOO
OXOOOXXOXOOOOOXOXOOXOOOXXOOOOOOXOOOOOOOOXOOOXOXOOOOOOXXOXOOOXOXOOOOOOOOOXOXOOXXOOOXOOOXOOOOOOXOXXOXXX
OOXOOXOOOOOOOOOOOXOXOOXOOOXOOOXOOOOOOOOOXOOXOOXOXOOOOOOOOXOXOOOXXOOOOOOOOOXXOOOOXOOOXXOOOOOOXOXOXXOOO
XOOOOOOXOOXOXOOOOOXXOXOXOOOOOOOOOXOOOOOXXOOXOOOXXXOOOOXOOOOOOOOOXXOXXOOOOOOOXXXOOXOOOXOOOXOXOOXOOXOOO
XOXOOOOOXOXOOOOOOXXOOOOOOXOXXOOXOOXXOOOOOOOOOOOOOXOXOOOOOXOOOOXOOOOXOXXOOOXOOOXOOOOOXXOXXXOOXOOOOOXXX
OXOOOXXXOXOXXOXOXOOOXOOOXOOOXXOOXXXXOOOOOOOOOOOOOOOOOOOXOXXOOXXOOOOOXOOXOOOOOXOXOOXXOOOOXOOXOXOOXXOOO
OOOOXOXOXOXOOOOOOOOOOOXOXXXOOOXOXOOOXOOOOOXOOOXOOOXXOOOOXOXOOOXXXOOOXOXOOOOOXOOXOOXOOOOOOOOOXOOXOXOXO
OXOOOOOOOOXOOOOOOOOXOXOOOOOXOOOXXOOXOOXOOXOOXOXOOXXOOOOOXXOOOXOXOXOXXXXXXOXOXOOOOOXOOOXXXXXOOOXOOOOXO
OOOXOOXOXOXXOXOOOOOOOOXOXOOXXOXOOOOXOOOOXOXXXXXXXXOOXOOOOOOOOXOXOOOOXXXOOOOOOXXOXOXOOOOOOOOOOXOOOXOOX
OOOOXOXXOOXOOOOXOOOXOOOOOOOXXOXOOOOXOOOOOOOOXOOOOXXOOOOXOOXXOXXOOOOOXOOOOOOOOOOOOXOXOOXXOOOXXOXOOOOOO
OXOOOXOOXXOOXOOOXOOOOXXOOOOOOXOOOOOXXOXOOXXOOXXOOXOOOOXOOXXOXOOOXOOXXOOXOXXOOXXOOOOXXOOXXOXOOXXOXOXOX
OOOOOXXOXXXXOOXOOXOOXOOXOOOOOOOOOOXOOXXOXOOOXOXXOXOOOOOXXOXXOOOXOXOOOOXXXOOOXXXOXXXXOOOXOXXXXOXOOOOXO
OOOOXOOXOOXOOOOXXOXOOOXOXXXOOOOOOOOOOOOOOOXOOXXOXXOOXXOOXXOOOOOOXOXOOOOXXOOOOOOOXOXOOOOXOXOXOXOOXOOOX
OOOXOOXXOOOOXXOOOXOOXOOXOOOOOOXXOOXOOOOOOXOOOOOOOOXXOXOOOOXXXOXOXXOXXOOOOOXOOOXOXOOOOXOOOXOOOOOXXOOOX
XOOXOXXXXOOOOOOXXXXOOOOXOOOOOOOOOXOOOOOOXOOOOOOOOXOXXOOOXOXOOOOXOOOOOOOOXOOXOOOOOOOOXOOOOXXXXXOOXOOXO
OXOOOOOOXOXOOXXOOOOOOXXOOOOOXOOOXOOXOOOXXXOOOOOOXOOOOOXOXOXOOOOOOOOOOOOXXOOOXOOXOOOOOOXOXOXOOOOOXXOXX
OOXOOXOOXOOOOOOOXOOOOXXXOOOOOOOOXOOXOOXOOXOOOXXXXXOOXOOXXOXOOOOOXOOXOXOOXOOXXXOOOOXXOOOOOOOOOOXXOOOXO
OOOOXXXOOOOOXOOOOOXOOOOXOOXOOOOXXXOOXXXXOOOOOOXXOOOOOXOOOXXOOOOOOOOOOOXOOOOXOOOOOOXXOOOOXXXXXXXOXOOOX
OOOOOOOOOOOOOXOXOOOOOOOOOOXOOOOOOXOOXOOOXOXOOOOOXOXOXOOOOOOXOXOOOOOOOOOOOXXXXOOXXOXOOOXOXOOOXXXOOOXOO
XOOXOXXOOOOOOOOXXOOOXXOOXOXXOXOOOXXOOOOOXOOOOOOXOXOOOXXOOOOOOXOXXXOOOOOOOOOOOXXOXOOXXOOXOXOXXOXXXXXOO
XXXOXOXOOXXXOOOXOXXXOXOOXOOOOOOOXOXOOXOXOOOOOOOOXOOOXOOXOOOXOXOOOXOXOOOOXOOOOOOOOOOOOOOOOOOOXOXXOXOOO
OOOOXXOOOOOOOOOXOXOOOOOOOOOOOOOXXOXOOOXOOOOXOOOXOOOOXOOOOXXOOXOOOOOXOOOXXXOXOXOOOOXXXXXOOXOOXXXOOOOXO
OOXOOOXOOOOOXOOOOXOXOXOXOOOXOXOOOOXXXOOXXOOOOXOOOOXOXOOOOOOOOXOOOOXOXOOOOOOOOXOOOOXOOOXOOXXXOXOOXOOXO
XOOOOXOOXOOOOOOOOOXXXXOOOXOXOOOOOOOXXXOOOXOXOOOXXOOXXOOOOOOXOOOOOXOOXXOOOOOXXXXXOOXOOOXXOOXOOXOOXOXOO
OOOOOOOOOOXOXXOOOOOXOOOOOOXOXOOXXOXOOXOOOOOOXOOOOOXXXXOOOXOOOXOOOOOOXOOOOOXXOXXOOXXOXOXXOXOXOXXOOOOXO
OOXOOXXOOOOOXOOOOOOXOOOOOXOOOOXOXOOOXOOOOOXXOOOOOXXOOOXOOXXXOOOXOOOOOOOXXXOXXXXOOOOOXOXOXOOOOXOOOOOOX
OOXOOXOOOXXOOOOOXXOOOOOOXOXOOOOOOOOXXOOXOOOXOXOOOOOOOOXOOOXOXOOOOXOOOOOOXXXOOOXOXXXOOXOXOOOOXOOOOXOOO
OOOOOOOXOOOOOOOXXOOOOOXOXXXXXOOOXXXOOOOOOXOXOOXXOOOOXXOOXOOXXXXOOXOXXOOOOOXOOOOOOOOOXOOOOXOOOOOOOOOOX
OXOXXOOXOOOOOXOOOXXOOOOXXOOOXXXOOOOOOXOOOOOOOXOXOXOOOOOXOXOOOXXOOOOOOOOOOOXXOOOOOOOOXOOOOOOOXOOOOOOXO
OOOXOOXXOXOOXXOOOOOOOOOOOOOXOOOOXOOOOOXOXXOOOOXOOXOXXOOOOOXOOOXOOOOOXXOOOXXOOOOXOXOOOOOXOOOOOXOOOOXOO
OXXOOOOOOOOXXOXOOOOOXOOOOOOOOOXOOXOOOOOXOOOOOOOXXXOOOOXOOOOXOXXOXOOXOOXOXXXOOXOOOXOOOOXXXOXXOXOXOXOOO
OOXXOOOOXXOOOXXOOOOXOXOOOXXXXOOOOOOOOOXOOXOXOOXOOXOOXOOOOXXOOXOOOXOOOXOOOXOOXXOXOOOOOXOOOOOOOOXXOOOOO
OOOOXOOXXXOOXOXOXOOOOOOOXOOOOOOXOXOXXOXOOXOOOOOOXXOOOOXOOOOXXXOOOXOOOOOXXOXOXOOXXXOOXOOOOXOOOOXOOOXXO
XOXOOOOOXOXOXXOXOOOXXXOOOOOXOOXOOOOOOOOXOOOOXXOXXOXXOOOOXOOOOOOOOOOXOOOOOOXOOOOXOOOXOXOOOOOXOOXOOXXOO
OOOOXOOOOOOXOOOOXOOOOXOXXOOOOOOOOXOOOOXOOOOXXXOOXXOXOXOOXOOOXOOOOXOOOOXOOOOOOOOXOXOOXOOOOOOOOOXOOXOOO
OOOOXOXXXOOOXXOOXOXXOOOOOOXOOOXOOOOOOOOXXOOOXOOOOOXXOOOOXOOOOXOXOOOOOXOOOOOOXOXOXOXXXOXOOOOXXOXOOOOOX
OOOXOOOOOOOOOOOOOOOOOOOXXOXOOXOOOOOXOOOOOOOOOOOOOXXOXXOXOXOXOOXOOOOOOOOOOXXXOOXOXOXOOOOXOOOXOOOOOOXOX
OOOOXXXXXOOOOXOOOOOOXOOOXOOOXOOOOOOOXOOXOXOOOXOOOOOXOXOOOOOOXOOOXOXXOOOOOOOXOOOOOOXOOOOXOOXXOOXOXXOXO
OOXOXXOOOXOOXXOOOOOOOOOXOXXOOOOOOXXXOOOOOOOOOOOXXOOOXOXOOOOOXOXOOXXOOOOOOOOOOXOXOOXOOOOOXOOOXXOXOOOXX
OXOOXXOOOOXXOXOXOOOOOOOXXXOXOXOOOXOOXOXOOXOXOOOOOOXOOOOOOOXOOXXOOOXOOOXXOXOOOXOOOOOOOOXXXOOXOOOOOOOOO
OOXOOXOXOXOXOXOXOXOOXOXOOOOOOXOOOXOOOXOXOOOOOOOOOOXXXXXXOOXOOOOOOOXXOOXXOOXOOOOOOOOXOOXOOOOXOOOOOOXOO
XXOOXOOOOXXXOOXOOOOOXOXOOOOOXOOOOXOOOXOOOOXXOOOXXOXOOOOXOXOOOOOXXOOOOXXOOXOXXOOOOOOXOOOOOXOXOXOOOXOXX
OXXXOXOXOOOOXXOOOXXOOOOOXXOXXXXOOXXOOXOOOXXXXXOXXXOOOOOOXXXOOXOXOOXOXXOOOOOOOXOOOXOOOXOOXOOOOOOOXXXOO
OXOXOXOOOOOOOXOXOOXOOXXOOXOOXXOXOXOXOOOOXXOOOXOXOOXXOOOOOOOXOOXXOOOXXOOOXOOOOOOXOXOXOOXOXXXOOOOOOOOOO
OOOOOOXOXOXOXOXOXOOOOOOOXOXXOOXOOOXOOXOOXOOXOXXOOOXOOOOOOOXOOOOOXOXOOOXXOOXXOXOOOXOXOOXXXXOOOOOXOOOXO
XOOOOOOOOXXOXXOOOXXXXOOXXOXOOOOOOOOXOXOXXOXOOOXOOXOOOOOOXOXOXXXOXOOOXOOOOOOOOOOOXOOOOXXOOOOOOOOOOXOOO
OXOOOOOOOOOOOOXXOOOOOXOOXXOXOOXOOOOOOOXXXOOOXXOXXOOOOOOXXOOOOOOXOOOOOOOOXXOXOOOOOXOOOOOOOOOOOOXXXOOXX
OOOOXOOOXOOOOOOOXOOOXOOOOOOOXOOOOXOOXXOOOOOOXXOOOXOOXOOXXOOOOXOXOXOOOOOOOOXOOOOOXOOXOXOXXXXOOOOOXXOOO
OOOOXOXOOOOXOOOXOOXXOOOOOOOXXXXXOXOOOOOOOOOOOOOOOOXXOOOOXOOXOXOOOOOXOXOOXOXXOOOOOXOXOOOXOXOOOXXXXOXOO
XXXXOXOOXOOOOOOOOOXOOOXOOXXOXOOXXOOOOXXXOOOOOOXOOOOOXOXXXXXOOXOOXOOXOOOXOOOOOXXOOXOOOOXOOOOOOOXXXXXOX
OOOOXOOOOXOOOXOXXOOOOOOXXOOOOOOOOXOOXXOXOOOOOXXXXOXXOOXOOOOOOXOOOOOOOOXOOOOOOOOOOOXOXOOOXOOOOOOOOOOXO
OOOOOXOOXOOOOOOXOOOOOOOXXOOOXOOOOOXOOOXOOOOOXXOOOOOOOOXXOXOXOOOXXOOOXXOXXOXOOOXXOOOXOOOOOOOOXOOOOOXOO
OOOXXOOXXOXOXXOOOOOXXOOOOOOXOOXXOXOOOXOOOXXOOOOXOOOXXXOOXXOXOOOOOXOOOOOOOOOOOOOOOOOXOOOXOXOOOOOOOOOOO
OOOXOOOXXOOOOOOOOOOOOOOOOXOOXOOOXOXOXOOOOOOOOOOXOOOOOOOOOXOXOXOOOOOXOOOOXOOOOXOOOXOOOOXOOXOOXXOXOOOXO
OOOXOOOXOOXXOOOOOXOXOXOOOOOXXXOXOOXOOOXOOOOOXOXOOOXOOXOOOXOXXOOOOOXOOXXOOOXOXXXOOOOOOOOOOOXOOOXOXXOOX
XOOXOXXXXXOOOXOXXOOXOXOOOOOOOXXOOOXXOXOOOXXXXOOXOXXOXOOOOOOOOOOOOXXXOXXOOOOXXXOXOOOXOOOOOOOXXOOOOXXOO
OXOOXOOXOOXOOOOOXXXOOOOOOOXXXOOXOXXXOXOXOXOXXOXXOXXXOXOOXXXXXOOOXOOXXOXOXOXOXOOOOOOOOXOOOOOOOXXOOOXXO
OOOOOOOOOXOXXOOOOXOOOOXOXOOXXOOXOOOOXOOOOOOXOOOXXOXXOOOOOXOOOOOOOXOXOXXXOOOOOXXXXXOOXOXXOXOOOXOOOOOOX
OOOOOXOXOXOXOXXOOOOOXOXOOOOOOOOOOOXXOOOOOOXXOOXOOOOOXOOOXOOOOOOOOXOOXOOOXOOOOOOOXOOOXOXOOXOOOOXOOOXXO
OXXOXOOXOOOXOXOOOOOOOOOXOOOOXOXOOOOOXOOOXOOOOOOXOXOXXOXOOXOOOXXOXXOXOXOOOXXOOOOOXOOXOXOXOXOXOOOOXOOOO
OXOOOOXOOXOOOXOOXOOOXXXOOOXOOOOXOOOOOOOOOXXXOOOXOXXXOOOOXXOOOOOOOOOOOXOOOXOOOXXOOXOXOXOOOXXOOOOOOOXXO
OOOOOOOXOOOOXOOOOOOOOXXXOOOOOOOXOOOOOXOOXXXXOOOXOOXOXOXOOXXOOXOXXOOOOXOOOOXOOXOOOXOOXOOOXOOOOXOOOOXOO
XOXOOXXXOXXXOOOXOOOOXOXOOOXOXOOOOXXOXXOOXOXOOOOXOXOXXXXOXOOOOXOOOOOXXOOOXOOOOOOXXOOXXXXOXXXXOOOXXOOOO
OOXOOXOOOOXOOOXOOXOXOOXXXOOOOXOOOOXXOOOOOOOOXOOOXOOOOOOOXOOOOOOOXXXXOOOXXOOOOOXXOOOXXOOXXXOOXOOOOOOOO
OOOOOOOXXOXXOXOOOOOOXXXXXOOXXXOOOXOOOOOOOOOOOOXOOOXXOOOOOXOOOOOOOOXXXOOOOOOXOXOXOOXOXOOXXOOXOXXOXOOOO
OXXOOXOOOXXXOXOOXXXXOOXOOOOOOOOOOXOOOXOOXOOOOOOOOOOXXOOXOOOOXOOOXOXOOXOXOOOOOOXXOOXXXOOOOOXOOOXOOOOOX
OOOOXOOOXOOXOOOXOOOOXXXOXOOOOOOOOOXOOOXXOOOXOOOXOOOXOXOOXOOOOOXOXOOOOOOOOOOOXOXOOOOOOOOOOXOOOXOXOOOOX
OOOOXOOOOXXOXOOOXOXXOOOOOOOOOOOOOXOOXOOOOOXXXOOXXOXXOXOOOXXOOXXOXXOOOXOOOXXOOOOOOOXOOOXXOXOOOOOOOOOXX
XOOXOOXOOOXOXXXOOOXOOOOOOOOOOOOOOOOOXOXOOXOOXXOOOOXOOOOOOOOXOXOOXOOOOOOXOOOOOOOOXOXXOOXOXOOOXOOOOOXXO
XOOOOOOOOXOXOOXOOOOOOXOXOXOOOXXOOOXOOOOXOOXXOOXXXOOXXOOXOOOXOXOOXXOOOOOOOXOOXOXOOXOOOOOOXOOOXXOOOXOXO
OXOXXXXXOOXOOOXOOOOOOOOOOXOOOOOOOXOOOOOOOXOOXOOOXOOOXOOOOOOOOOXXXOOOOXXOOXOOOOOXOOOOOXOOOOOXXOXOOOOOO
OOXOOOXXOOOOOOOOOOXOOOOXOXOOOOXXXOOXXOOOXXOXXXOXXXOOOOOOOOOXXXOOXOOOOOOXOOOXOOXOOXXOOXXXOXXOOXOOXOOOX
OOOXOOOOXOOOOXOOOOOOOOOOXOOXOOOOOXOOOOXOXOXOOXXOOOXOOXOXOOOOOOXOOOXOXOOXXOOXXOOOOOOOXOXXXXOXOOOOXXXOO
OXOXOXOOOOXOOOXOOOOOOOOOOOXOOOOOOOOXOOXOOOOXXOOOXXXOXOOXXOOOXOOOXXXOOXOOOOOOOOOOXOOOOXOXOOXOXXOOOOOOX
OOOXOOOXOOOOXOXOOXOXOOXOOOXXOOOXXOXOOXOOOOOXOOOOOXOXOOXOOOOOOOXXXOOOOXOOOOXOOOOOXOOXOOOOOXOOOOXOOXXOO
OXOXOXOOOOOXXOXXOXXXOOXXXOOOOOOXOXOXOXOOXXOOOXOOOOXOOOXOOXOOOOOOOOOOXXXXOXOOOXOOXOOOXOOOOOOXOOOOOOOOX
XOOOOXOXOOXOXXOOXOOOXOXOOOXOOOOOOOXOOOOOOOOXOXOXXOOXXXXOXXOXOOOXXOOOOXOOOOOOOOOXOOOXOOOOXOXOOXOXOOOXO
XOXOOOXOOOOXOXOOOXOOXOOOXOXXOXOOOOOXOOOXXOOOOXXOOOXOOOOOXOXOXOOOOOOXOOOOOOXOXOOOXOXOOOOXOOXOOXOOXOXOO
XOOOOOXOXOXOOOOOOOXOOOOOOOXOXXOOOOOOXOOOOOOOXOOXOOXOOOOXXOOOOXXXOXOOOOOOOOXOOOOOOOOOOXXOXOOXXXXOXOOOO
OXOOXOOOOOOOXOOOOOOOOXOOOOOOXOOOOOOXXXXOOOOOXOOOOOOOOXOOXOOOXOOOOOOXOOXXOXOOOOOXOXOXOXOXOOOOOOOOOOOXX
OOOOOOOOOOOXOXXXXOOOOOOOXXXXXOOOOOOXXOXOOOOOOOOXOXOOOOXOOOXOOXOOOOXOOXOXOOOOOOOOXXOXXOOOOOOOOOXXXOXOO
XOOXXXOOOOXOXOOOOOXOOOOXOXOOOXOXXOOOOOXXOOOOOOOOOOOOOOOOOOOOOOOXXOOXXOXOOOOOOOXOOXOOOOOXOOOOXOOOOXOOO
OOOOOXOOOOXXOOOOOXOOOOOXOOOOOOXXXXOOOOOOOOOOOOOXOOOOOXOXXXXOOOOOOXXOOOOOXOXXOOXXOXXOOXOOOXOXOXOXOXOOO
OOOOXOOOXOOOXXXOOOOOOOOOXOXOOXOXOOOOOOOXOOXOOXXXOOOOOXXOOOOOOXXXOOOOOXXOOXOXOXOXOOOOOOOXOOOOOOOOOOXOO
XOOXOXOOOOXOOXXOXXXOXOOOOOOOOXOOOOXOOOOOOOXXXOOOXXOOOXOOXXXOOOOOXXOOXXOOXXOOOOOXOOXOOOOOOOOOXOOOXXOOX
OOXXXXOOXOXXXXXOOOOOOXOXOOOXXXOOXOOXOXOOOOOXOXXXOOOOXOOXOOOOXOXXXOXXOOXOOOOOOOOOOXOOOXOXOOOOOXOOXXXXO
XXOOOOOXXXXOXXXOOOOOOOOOXXOOXOXOOOXXOXXOOOOXOOOOXOOOOXXOOOOOOXOXOOOOOXOOOOOOOOOOOOOXXOXXOOOOXOOOOXXOO
OXOOOXXOOXOOXXXOOOXXOOOOOXOOXOOXOOOOOOOOOOOOOXXOOOOOXXOXOXXXXXOXXOOOOXOOOXXXOOXOOXOXOXOOOXOOOOOXOOOOX
OXOOXOXOOXOOOOOOXXOOOOXOOOOXOXXXOOOOOOXOOOOOOXOOOXOXOXOOOXXOOOOOOOXXOXXOOXXOOOOOOOOOOOXOOOXXOOOOOOXOO
OXOOOOOOXXOOOXXXOOOXOXXXOOOOOXOOXOOOOXXOXOOXOOOOXXOOOOOXXOOOOXOXOOXXOOXOXXXXXOOOOOOOXOOXXOOXOOOOOXOXO
OOOOOOXOOOOOXOOOOOXXOXOXXOXOOXOOOXOOOXOXOXOXOOXXOOOOXOOOOXOXXOOOXOOOOXOOOOOOOOOXOOOXOOXOOOXOOXOOOXXOO
OOOOOXOOOXXXXOXOOXXOXXOOOXOXOXOOXXOXOOOOOXOOXOOOOXXOOOXOOXOOXOOXOXOOXOOXXOOOOOXXXOOOXOOOOXOOXOOOOXXOO
OOOXOOOOXOXOOOOXOOOXOXXOOOXXOXXOOOOOXOOOXOOOOOOOOOOXOOOOOOOOOXOOXOOXOOXXOOOOOOXXXXOOOOOXOXOXOXOXOOXOO
OOOOOOOOOOOOOOOOXXOXOOOOXOXOOOOXOXXOOOXXOOOOXXOXOOXOXOXOOOOOOXXXOOOXXOXOOOOXXXOOXXOXOOOXOOOOOOOOOXOOO
OXOXXXXOXOOOXOXXOOOOXOXXOOOOOXXOXXXXOOXOOXOOXOXOOOOXOXXOXOOOOXXXOOOOXOOOOOOOOOOOOOOOOOOOOOOOOXOOOOOOX
OXXXOXOXOOOOXOOOOOOOOXXOOXOOXOOOOXOXOOOOOOOXOOOOOOXOOOOOXOOOOOOOOOOXOOXOXOXOOOOXXOOOOOOXXOXOXOOXXXXOO
