OOOXOXOOXOOOOOOOOOOXOOOXOOOXOXOOOXOXOOOOOOXOOOXXOXOOOOXXOOXOOOOOXOXXOOOOXOXXOOOOXOOXOOXOOOXOOOOOXOOOO
OXOOXOOOOOXOOOOOOOOOXOOOOOOOXXOXOOOOXOOOXOOXOXOOOOOXOOOXOXOOXOXXOXOXOOXOOOOXXOOOXOOOOOOOOXOOXOXOXOOOO
XXXOOOXOXOOXOOOOXOOOOOXXOOOOXXOOOXOXOOOOOOXOOOOXOXOOOOXOOXOXOXOOOOOOOOOXXOOOXXOOOOOOOXXOOOXOXOOOXOXOO
OOXXXOOOOOOXOOOOXOXXOXOXOOOOXOOOOOXXOXOOXOOOXOOOXOOOOOOXXXXXXOOXOXOOXOXXXOXXOOOOOOOXOOXOOOOOOOOOOOOOX
OOOOOOOOOOOOXOOOOOOOOOOOXOOOOXOOOOOXXOOOOXXXXOOXOXOOOOXXXOXOOOOOOOXOOOOOOOXOOOXOOOOOOOOOOXOOXXOOOOOOO
OOOOOOOOOOOOXOOXOOOXOOOOXOXOOOXXXXXOOOOOXXOXOOXOOOOXOXOXXXOOOXOXXOOOOOOXOOOOOOOOXXOXOOOOOOXOXOOOOOOXO
XOXOOOOOXXOOOOOOOOXXOOOXOOXXOOOOXOOOXXOXOOOOOOXOOXOOOOOOOOXOXXOOOXOOOXOOXOXOOOXXOOOOXXOOOOOOXXXXXOXXO
OOOXOOOOXOOOOOXOOXOOOOOOOOXOOOOOOOXOOOOOOXOOXXXOOXOOOOOOOOXOXOOOXOOOOOOOOOOOOOOXXOOOOOOXXOOOXOXXXOXXO
OOOOXOOOOOXOXOOOOXOOXXOOOOOOOOXXOXXOOOOOXXOOXOOOOOXOOOOXOXOOXXXXOXOXOOOOOOXOXXOOOXOOOXXXOXOOOXOXXXOXO
OXOOXOOOOOOOXOXOXOOOXOOXXOOXOOOOOXXOOOOOXOOXOXXOXXOOOXOOOOOOXXOXOOOOXXXOXOOXOXOOXOXXOOXOOOXXOOOOOXOXX
OXXOOOOXXXXOOOOOOOXOXOOOXXOXOOOXOOXXOOOXOOOOOOOOOOXOXOXOXOOOOOOOXOXOOOOOXOXXOOOOOOOXOOOOOXOOOOOOOXOOO
OOOOOOOOOOXOOXXOXXXXOOXXXOOXOXXOOXOOOOOOOOOOOOXXOOOOOOOOXXOOOXOXOXXOXOXXOOXOOXOOXOOOOXXOOXOOXOOOOXXXX
XOOOOOOXOOXXOOXXXOXXXXOXXOXOOOXXOOOOOOXXOOOXXOOOOOOXOXOOXOOXOOOXOOXXOXOOOXOXOOOOXOOXOOOOOOOOXOXXOOOOX
XOOOOOXOOXXXOOOOXOOXXOOXXOOOXXXXOOOOXOOOOOOXOOOOOXXXOXOOOOXOOXOXOOOOXOOOOOOOOOOXXXXXOOOOOXXXOOOOXOXOX
OXOXXOOOXOXOOOOOOOOOOXOXXOOOOOOOOXOOOOOOOOOOXXOXXOOXOOOOOOOXOXXXOXXOOXOXOOXXOXOXXOOOXXOOXOXOXOOOOXXOO
OOOXOOXOOOOOXXOOOOXOXOOOOOXOOOOOXOOXOOOOOXOOOOOOOXOXOOOOOOXOOXOOOXXXOOOOXXOOXXOXXOOXOXOOXOOOOXOOOOOXX
OXOOXOOXXOOOXOXOOOOXOOOOXXOOOOOOOXOXOOOOOOXXOOOXOOXOXXXOOXXOOOOOOOOOOOXXOOOXOXOXOOOXOXOOOOOOOOOOOOXOO
XOXXOOXOXOOOOXXOOXOXOOOOOXXOXOOXOOOOXOOXOXOOOOXOXOXXOOOOOOOXOXOOXXXOOOOOOOOOOXXOXXOOOOXXOOXOXOOOOXOOX
OOOOOOOOXOOOXOOXOOOOXXOOOOOOXOOOOOOXOXOOXOOXOOXOOOOOOOOOOOOOOOXXOOOXOXOOOOOOOOOOOOOXOOXOOOXOOXXOOOOOX
OOOXXOOOOXOXOOXOOOOOOOOXXOXXXXOOXOXOXOOOOOOOXOOOOXOOXXOOOXOXOOOOXXOXOOOOOOOOOOOOOOXOXOXOXOXOOOXOOOOOX
OOXXOXOXOXOOXXXXOXOXXOOXOOOXOOXOOOXOOOXOOXOOXOOOOOXXOOXOOOOOOOOOXXXOOXOOOOOOOOXOXOOOXOOOXOOXOOOOXOOXX
OXOOXXOOOOOXOXXOOOOOOOOXXXXOXXOOOOOOOOOOOXOOOOXOOXXXOOOOXOOOOXOOXOOOOOOOOOXOOOOXOXOXOOOOXXOXOOOOOXOOX
OXXOOOOOOXOXOOXOOXOOXOOXOOOOXXOOOOOOOOOOOXOOOOOOXXXOXOOOOOOOOXOOXOXOXXXXOOOOOOOOOOOXOOOOXOXOXXOOXOOXO
OOXOOOXOOXOOOOOOOOXOOOOOOOOOOXXXOOOOOXXXOOOOOXXOOXXOOOOXOOOXOOOOOOXOOXOXOXOOXXOOOOOOXOOOXXOXOOOXOOOOO
OOOOOXOOXOOOOOOOOXXOXXOXXOXOOOXXOOOXOXXOOXOOOXXOOOOOOOXXOOOOOOXOOOOXOOOOXOXOOOOOOOXOOXOOOOXXXOOOOOXXO
OXOXOOOOXOXOOOOXOOOXOOOOOOOOXXOOOXXOXXOOOXOOXOOXOOOOXOOXOOOOOOXOOOXOOOOOXOXOOXOXOOOOOOXOXXOOOXOOOOOXO
OOOOOOOOOXOXXOOOOXOOOXOOOOOXOOOOOXOOOOOXXOXOOXXOXOXOXOOXXOXOOXXOXOOXXOXXXOXXOOOXOOOOOOOOOOOOXOXXOOXOX
OOOOXXXXXOOOXOOOOXXOXOXXOOOOXOOOOOXOOOXXOOXXOXOXOOXXOOXXXXXOXOOOOOOOOOXOOOXOXXOXOXXOXOXXOOOOOXOXXXOOO
XXXOOOOOXXOOXOXXOOOOOOXXOXXXXOXOOOOOXXOXOOXOOOOXOOXOXOOOOOOOOOOOXXXXOOXOOOOOOOOOOOOOOXXXOXOOOOOXOOOOO
OOOXOOOOXOXOOXXOOOOOOOOOXOOOXOOOXXXOXXXXOXOOXOXOOXOXOXOOOXXOOOOOOOOOOOXOXOOOOOOOOOOXOXOOOXOOOOXOOOXXX
OXXXOXOOOXOOOOOXOOXXOXOOOXXOOOOOOOXXOOOOOOOOOOOOXXXXOOOOXXOXOOOOXXOOOOXXXOOXOXXOXOOOOOOOXOOOXOOOOOXOX
XOOOOOOOOOOOXOOOOOXOXOOXOXOXOXOOOOXOXOOOXOXOXOXOOXXXOXOOOOOXXOXXOXOOOOXOOXOOXXOOXOXOOOOOOOOOXXOXOOOXO
OXXOOOXOOXOOOOXOXOXOOOOOOOOOOOOOXXXOOXXOOOOXOOOXOOOOOXOOXOOXOOOXOOOXXXOXOOXXOXOOXXOOOOOOXXOOOXOOXOXOO
OOOXOOOOOXOOOOOXOOOXOXOOOXXOOXOOOOXXOOOXOOXOXOOXOXXOOOXOXOOOOXXXOOXOOOOOOOOOOOOOXXOXOXOOOXOXXOXXXOOOO
OOXOOOOOOXOOOOXOXOXOOOOOXOOXOOOXOXOOOXXOOXOOOOXOOOOOOOOOOOOXXOOXXXXOXOOOXXOOOXOOXXOOOOOOOOOOOOXOXOOOO
OXOOOXOXOOXOXOOOOOOOXOXXXOOXXXOXOOXOXXOXOOXOXOOOOOXOXOOXOOOOOXXXXOXXXOOOOOOXOOXOOOXOXOOOOOOOOXOOXXOXX
OOOOOOOOOOOOOOOOXOXXXOXOXOXXOOOXOOOOXOOOXXXXOOXOOXOXOOXOXOOOOOOOXOOOOOOOXOXOOOXOOOOXOOXXOOOOOOOXXOXOO
OOXOOXOXOOXXOOOXXOOOOXOOXOXOOOXOOOOOOOOOOOOXXOOOOXXXOOXOOOOOOOOXOOOXXOOOXXXOOOXXOOXOXXXOXOOOXXOOOOXOX
OOXXOOOOXXXXOXOOOXOOOOXXXXXXXOOOOXOOOOOOOOOOXOOOXXXOOOOOOXOOOOXOOXOOOXXXOOXOOXOOOOOOOXOOXXOXOXOXXOXOO
OOOOOOOXXOXXXXOOOOXOOXOOXOOXXOOOOXOOXOOOOOXXOOOXXXOOOOOXXOOOOXOOOOOXOXOXXOOXOOOOOOOXXXXXXOOOOOOOOXOOX
XXXOOOOOXOOOOOOOXOOOXOXOOOXXOOOXOOXOOOOOXXOOOXOOXXOXXOOOOOOXOXOOOOOXOXXOOOOXXOOXOXXOOOXOOOOOOOXOOOOOX
XXXXOOOOOOOOXOXOOOOXOXOOOXOOOOOOOOXOOOXOOOXOOXXXXOOOXOXOXXOXOOOOXXOOOXXOOOOOOXOOXXOOXOOXXXOOOOOOOXOOO
OXXOXOOOOXOOOOOOOOOOXOOOOXXOOOOOOOXOXOXOOXXXOOOOOOOOOXXOOXOOOOOOOOOOXOOXOOXXOOOXXOXOXOOOOOOOOOXXOOOXO
OOOOXOOOXXOOOOOXXXOOOXOOOXOOXXOOOOXOOOOOOXOOOOOOXXOOOXOOXOOOOXXOOOXOXOOOOXOOXOOOOOOOOOOOOOOOXOXXXOXOO
OOXOOOOOOOOOOXOOXOOOOOOOOXOOXOXOOOXOXOOOOXOXOXXOOOXOXOOXXOOOOXOOOXOOXOOOOOOOOOOXOOXOOXOOXXOOOXOOXOOOX
XOOOOOOXOOOOOOXOOXOOXOOOOXOOXOOOOXXXXOOXOXOXOOOOOOOXOXOXXOXOXOOXXOOXXXOOXOXOOOOXXOXXXOOOOOOOOXXXXOOOX
OXXOOXXOOOXOOXOOOXXOOOOOOOOOOXOOOOOOXOOOOOOXOOXOOOOOOOOOOOOOOOOOXOXXOOXOOOOXOXXXOOOOOOOXXOOOOOXXOOOOO
OOOXXOOOOOXXOXOXOOXOOXOOXOOOXOXOOXOOOXOOOOXXOOOOOOOOOOOOXOXOXOOXOXOOXXOOOOOOOOOOXOOXOXOOOOOOOOOOOOXOX
OOXOOOOXOOOXXOXOXXXOOOOOXOOXOOOOOXOOOOOOOOOOOXOOXOXOXXOOOOXOXXOXOOOXXXXOOXXXXXOOOOXOXXOOOOXOOOOOOOOOO
OXXOOXXXOXOOXOXXOOOOOOOOXXXOOXOOOOXOOXOOOXXXOOOOOOOOOOOOXOXOOOXOXOXOOXOOOOOOOOOOOOXOXOOOOOOOOXOOOXOXO
OOOXOOOXOOXOXOOXXOOXOOXOOXOOOXXOXXOOOOXOOOOOOOOOOOXOXOOOOOOOOOXXXOOXOXOOOOXOXOOXXOOOOXXXOXOXOOXXOOOOO
OXXOOOOOXXOOOOOOOOOOOOOXXOOOOOOXOOXOOXOXXOOOOXXOXOOXOOOOOOOOXOOOOOXOOXOOOXOOOOXXOOOOOOOOOOXXOOOXOOXOO
XOXXOOXOOXOXOXOXOOOOOOOOOXOOOOOOOOOOOXXOOXOXOXOXXXOOOOOXOXOOXOXXXOXOOOOXOOOOOXOXOOOOOOXOXOOXOOXXXOOOX
XOXOOXXOOXXOOOOXOOOOOOOOOOXXXOOOXXOXOOXOXOOOXOOXOOOOOOXOOOXOOOXXOXXOXOXOOOOXOOOOOXXOOXOOOXXOOXOOXXOOO
XOOOOXOOOOXOOXOOOOOOXOXXOXOOOOOOOOOXOOOXXXXOOXOOXOOOXOOXXOOXOOXXOOOOOOOXXXOOOOXOXOOXOOXXOXOXOXXOXOXOO
OOOOOXOOOOOOOXXOXXOOOOOXOOOOOOOOOXXOOXOXXXOOOXOXOXOOOOXOOOOOXXOOOOOOOXOOOOOXOOOOXOOXOXOOOOXOXXOOXXOOO
XXXXXOOXOXXXXOXXXOOOXOOXXOXXOOOOOXOXXOOOOOXOOOOOOXOOOXXXOXOXOOXOXOXOOOOOXOXOOOOOOXXOOOOOOOXOOOOXOXOXX
OOOOOXOOOOOXOOOOOXXOXOOOXOOXOOOOOOXOOXOOOOOXOOXXOOOOXXXOOOOOOOOOXXOOOOOOOOOOOOOOOOOOXOOOXOOOXOOXXXOOO
OXOOOOXXXOOXXOOOOXXXOOXOOXOXOXOXOOOOOOOXXOOOOXOOOOXXOOOOOOOOOOOOXOOOXXOOXXOOOOXXOXOXOXXOOXOOXOXOOOOOO
XOOOOXOXOOOOOOOOXOOXOOOOOXXOXXOOOOXOOOOOOOXXOOXXOOOXOOOOXOOXOOXXXXOOOOOOXOXOXOOOOXOXOXOXOXOXOOOOOOXOO
XOOOXOOOXOOOXXOXOXOOOOXOOOXOXOOOOXXOOOOOXOOXOXOOOOOXXOXXOOXXXOOXXOOOXOXXXOOOOOXXXOXOOXOXXXXOOXXOOOOXO
OOXOOOOOXXOOOOOXOXOOXOXOOOXXOOOOOOOOXOOOOXOOOXXOXOOXOXOOOOOXOOOOOOOOOOOOOOOXXOXXXXXOOOOOXOOOXOOOOOXOO
XOXXOOXOXXXOOOOXOOOOOOOOXXXOXXXOOOOOXOXOOOOOOOOOOOOXOOOXXXXOOOXXXOOXOOOXOOOOOOOXXXOOOOXOOXOXOOXOXOOXO
XOOOXOOOOXXOOXXXOXXOOXOXOOXOOOOXXXOOOOOOXXXOXOXOOXXOXOOOOXXXOXXOOOOOXOOOOOOOOXXOXXOOOXXOXOOOOOOXXXXOX
OOXOXXOOOOOOOXOOOOOOOOOOOXXOOXXXXXOOXXOOXOOOOOXXXOOOXOOXXOOXOXXOOXOOXXXXOXOXOOOXOOXOOOOXOXXOXOXXXXOXX
XOOOOOXXOOXOOOXOXOOOOOXOXOXOOOXOOOOXOOOXOXOOOOXXOXXOOXXXOOOXOOOOOOXXOOOOOXOOOXOOOXOOXOOOOOOOXXXXOOOOX
OOOOOOOXOOOXOOOXOXXXXOOOOOOXOOOOXOOOXOOXOOXOOOOXOOXXOXXOOOOOOOOOXXOOXOXXXOXOXOOOOOOOOOOOOOOXOOOOXOOOX
XXXOOXOOOXOOOOOOXOOXOOXXXXXOOOOOOOOOOOOXOOOOXXOXXOOOXOOOOOOOXOXOXOOXXOOOOXOXOOXOOOOOXXXOOOOOXOOOOOOXX
OXOXOOOOXXOXOXXOOOOXOOXOOXOOOOXOOXXXOOXXXOOOOXOOOOOOOOOOOOXOOXOOOOXOOOXXOXOOOOOOOOOOOOXOXXOOOOOXXOXOO
OOOXOOOOOOOOXOXXXOOXOOOXOXOOXXXOXOOXXXOOOXOOXOXOOOOXOOOOXOOOOXOXOOOXOOOXOOXOXOXOOXXOXOXXOOOXOXXOOXOOO
OOOOOOOXOOXOOOOOOOXOXXOXOOOOOOXXXXOXOXOOOOXOOOXOXOOXOXOXOOXOOXOOOOXOOOXOOXOOOXXOOOXXOOOXOOOOOXOXOOOOX
OOXOOXOOOOOXOXXXOXXOXOOXOOOXOOOOOOOOOOOOOOOOOOOXXOXOOOOOXOOOXOOOOOOOOXXOXOOXXOOXOOOOOOXXOOXOOOOOXOOXO
OOOOOOXXXXOXXOXOOOOXXOOOOXOOXXOOOOOXXXOOOOXXOOOOOXXOOOOOXXXOOOOXOXOOOXOOOOXOXOOOOOOOOXOOOOXOOXOOOOOOO
OOXOXOXOXOOXOOXOXXOOXOOOOOOOOOXOOOOOOOOOXOXOOXOOOOOOXOOOXOOXOOOOOOOXXOXOOOOOOXOXOOOOOXOOOOOOOOOOXOXXO
OOOOOXXOOOOOOOOOXOOXOOOOOOOOOOXOOXOOOOOXXXOXXOXOOOOOOOOOOOOOXOOXOXOOOOOOOXOOOOOOOXXOOOOXXOOOOXXOOOOXX
OXOOOXOOOOOOOXXOOXOXXOXOOOOOOOOOXOXOOOOOOXXOOXOOXOOOOXXXXXOOOXOXXXOXXOOXOOOOOOOOOXXOOXOOOOOXXXOXXXOOO
OXOOOOOXXOOOOOOXXOOOOOOOOXOXOOXOOOOOOOOOOOXOOOOOOXOOOOOXOOOOOXXOXOOXOOXOOOOOXOXOOOOXXXOOXOOXOOXOOXOOX
OOOOXXXOOOXXOXOXOOOOOOOXOOOOOOXOXOOOOOOXOOXOXOOXOXOOOOXOXXOXOOOOOXXOOOXXOXXOOOOOOXOXXXXOOOXOOXXXOOXOO
XOOXXOXOOOXOOXXOXXOXOOOXXXOXOOOXOOOOOOXXOOOOXOOOXOXOOOOOXOXOOOOXXOOOOOXXOXOOOOOXOOXXOOXOOOXOXOOXOXXXX
XOOOOOOOXOXXOOOOOOXOOXXOOOOOOOOXOOXXOOOOXOOXOOOXOOOOOXXOOOOXOXOXOOOOXOXOXXOOOOXXOOXXOOOOOXOXXOOOOXOOX
OXOXOXXOOOOXOXOXOOOOOOXXXOOOOOOOOOXOOOOOXOOOOOOOOOOOOOOXOOOOOXXXOOOOOXOXOOOXXOOXXOOXOOXOXOOXXXOOOOOOO
OOXOOXXOXXOOOOXXOOXXOOOOOOXOOXOXXXXOOOOOOOXOXOOOOOOOOOOOXOOOOOOXXOOOOOOXXOXOXOOOXXOXXOXOOXOOOOOOOOOOO
OOOXXXOOXOXXOOXOOOXOOOOOOOOOOOOXXOOOXXXOOOXXXOOOXOOOOXOOOOOXOOXOOOOOOOXOOOOOOXOXOOOOOOOOOXOOXOOOOOOOO
OXOOXXOXXXXOXOOOXXOOXXOXOXOXOOOOOOXXOOXOOXOOOXXXOOOOXOXOOOXOOOOXOOXOOOXXOOXXOXOXOXOOOOXOXOXOOOOOOXOXO
XOXOXOXOXOOOOXOOOOOXOXOOXOOXOOOXOOOOXOOOXOXOOOXOXOOXXXOOXOOXXOXOOXOXXXOOOOOXXOOOOXOOXOXOXOOOOXOOOOXOO
OXXOOOXOOXXOOOOOXXOXXOOOOXXXXXOOXOOXOOXXOOOXOOOXXOOOOOOXOXXOXOOXXOXXXOOOOOXXOXOOOOOOOXOOOXOOOOXOXXOOO
OXOOOOXOOXOXOOXOOOOOOOOOXOOOOOOXXOOXXXOOOOOXOOOXOXXXOOOOOXOXOXOOXOOOOOXOOXOXOOOOOOXXOOXOOOOOOOOOXXXXX
OOOXXXOOOXXXOOOOOOOOXOOOOOOXOOXOOOOXOXOOOOOXXOOOXXOOOOOXOXXOXOXXXXOOXOOXOOOOOOXOOOOOOOOOOOOOXOXXXOOXO
XOXOOXOXXXXOOXOXXOOOOXOXOOOOXXXOXOOXXOOOOOOOOOOXXOOXXOOOOXOOXXOXOXXXOXXOOOOOOXOOOOOXXOXOOXOXXOOOOOOOX
XOXOOXOXOXOXOXOOOOOOOOOOOOOOXOOOXOXOOOOXOXOOXOXOOOOXOXXOXOXOOOOOXOOOOOOOOXOOOOOXOXXOOXOOOOXOOOXOXOOOX
OOOOOOXOOXXOOOXOOOOOOOXXOOXOOOOOXOOOXOOOXOOOOOOOOOOXOOOOOXOOOOOOOXOXOOXOOOOOXXOXXOOOOOOXOOOOOOOOOXOOO
XOOXOOOXOXOXOOOXOXOOOOXXOOOOOOOXOOXOOOOXOOOOOOXOOOOOXOXXXOOOOXOOXOOOXOXOXOOXOXOOOXOOOOOOOOXOOXOOOOOXO
OXOOOOOOOOOOOOXOXXXXOOXOOOXOOOOXOOOOOOOOOOXOOOOOOOOXXOXXXOOOOOXOOOOXOXOXXOOOOXXXOOOOOXXOOOXOXOOOXXOOX
OOXXXXXOXOOXOOOXOOOOXOOXXOXOOOXOOXOOXXOXOXOXOOOOOXOOOXXXXXOOOXOOXXOOOXXOXXXXOXOXOOOXXOOXXOOOOOOXOOOOO
OOXOOOXOOXXOXXOOOOOOOOXOOXXXOOOXXXOXXOOXOXOOOXOXOOOXOOOOXOOOXXOOOXOXXXOOOOOXOXOOOOOOOXOOXOXOOOOOOOXOX
OXOXOOOOXOXXOOXOOOOOOOXOOXOOOOOOOOOXXOOXOOXOOXOXOOOOOXXXXXXXOOXXOOOOOOOXXOXOXXOXXXOOXXOOXXOOXXOOOOOXO
XOOOXOOXXXOOOOXOOOXOOOXOXOXOOOOOOOOOOOXOOXOOOOXOOOOXOOXOOOOOOOXOOOOXOOOOOOOXOOOOOXOOOOXOOOOOOOOOOOOOO
OOXXOXXOOOOOOOOOXXOOOXOXXOXXOOXXOXOXXOXXXXOXXOOOOOOXOXOXOXXOXOXOOOOOOOOOOOXXOOOXOOOXOOOOOOOOXOXOOOXOO
XXOXOOXOOOOXOOXOOOOOOOXOXOOOOOOOOOXOOOOOXOXOXOOOOOOXXOOOOOOOOXOOOXOXOOOOXOOOOXOXOOOOOOOXXXOOOOOOOXXOO
OOXXXOXOXXOOOOOOOOOOOXXOOOOOOOXXOOOOOOXOXOOOOOXOOXOXXXOXOOOXOXOOOXOOOOOXOOOOOOOOOXOOOOXOXOXXOOXOOOXXX
OOOXOXXOXXOOOXOOOXXXOXOOOOOXXOOOOOXOOOOXXOOOXOOOOOOXXXOOXOOOOXOOOOOXOOOXXOXXXOXOOXOOXOOXOOOOOXXOOXXOO
