OOXXOOOXXXOXOOOOOOXOOXOOXOOXOOOOOOOOXXXOOOOOOOOXXXOOOOOOXXOXOOOOOOOOOOOXXXOOXXXOOOXOXOOXOOXOXOXOXOOXO
XOXOOOOXXOOOOOOOOOOOOOOOXOOXOOOOOOOOOOOXXOOOXXOOOXOOXOOOOOXOOXOXOOOOOXOOOOOXOOXXOOXOOOOXXOOOOOOOXOOOX
OOOOOOXOOOXOOOOOOXOOOOXXOXOOOXOOOXXOXOOXOOOOOOOOXOOOOOOXOXOOOXOOXOOXOOOOXOOOXOOOOOXOXXXOXOOOOOOXOOXXO
OOXOOXOOXOXXOXOOOOOOOOOXOOOXOXOOXOOOOOOOOOOOOXXOOOOOXXOOOXOOOXXOOXOOOOXXOXOOXOOXOXXXOOOOOOOOOOOOXOOXO
OOXXOXOOXXOOOOOOOOOXOXOOOOOOXXOXOOOOOOOOXOOOXOOOXOXOXOXOOOXOOOOOXOOOOOOOXXOXXXOXOOOOOOOOOOXOOOXXXOXOX
XOOOXOOOOOOOOOXOXXXOXXOOOOXXOXXXOXXOXXXOXOXOOXXXXXOOOOOOOOXOOOOXXXOXOOOOOOXOOOOXOXOOXOOXOOOOOXOOXOOXX
OOOOOOXOOOOOXOOOOOOOXOOOXOOOXXOXXXOOOXXXOOXOOOXOOOOOOOOOOOOXOOOXOXOOOOOOOOOXOOOOOOOOOXXXOOXOXOOXOOOOX
OXXOOOOOOOOOXXOOOXOOXOOXOXOOOOOXOOOOOOOXOOXOOOOXXOXXOOOOOXOOOOXXOOOOXXOOOOOOOOXOXOOOOOOXOOOXOXOOXOOOX
OXOXOOXXOOXOOXXOXOXOXOOXXOOOXOOOXOOOOOOXOOOOOOXOOOOOOXOOOOOOOOOXOOOXOOOOOOXOXXOOXOOOOOOOOOOOOOOOXOXOO
OOXOOOOOOXOOOXOOOXOOXOOOOOOOXXOOOXOOOXOOOOOXXXOOOXXOXXXOOXOOOOXXOOOXXOXOXOOXOOOOXOOOOXOOOOOOXXXOOOOOX
OOOXXOOOOOOOXOOOXOOOXXXOOOXOOXOOXOOOXXXOOXOOOXOOXOOOXOOOOOOXOOOXOOOOOOXXXOXOOOOOOOOOOXXOXOOOOOOOOOOOO
OOOOOOOXXOXOOOOXOOOXOOOOOXOOOOXOXOOOXOOXOOOOXOXOXOOOOOXOOOXOOOXOOXXOOOOOOOXOOOOOXOOOOXOOOXOOOXOOXOOOX
XOOXOXOXOOOOOOXXOXOOOXOOXOOXOOOOXOXOOXOXOOOOOOOOOXOOOOXXOXOOOOOOOOOOOOOOXOXOOOOOOXOXOOXOXOOXXOOOXOOXX
OOOXOOOOOOOXOOOXOOOOXXXOXOOOOOOOXXOOOOOOXOOXOOXOXOXXOOOOOXXXXXXOOOOOOXOOXOOOOOOOOXOOXOOOOOOOXOOXOXOXO
OXXXOOXOOOOOXOOXXOOOXOOOOOOXXOOXOXOOOXXOXXOOOOXOXXXXXOOOOOXXOXOOOXOXOOXOXXXOXOXOOXOOOOOOOOOOXXOOOOXOO
XOOOXXXOOOOOOOOOOOOOOOOOOOOOOOOOOXXXOXOOOOOOOOOOOOOOOOOOXOOOOXOXXOOXOOOOXOOOXOOXOOXXOOXXOOOOOOOXOOOXO
XOOXXOOOXOXOXOOXOOOOOOOOOOOXOOOOOXOOOOXXXOOOOXOXOOOXOXOOOOOOXOXXXOOOOOXOOXOOXXXXOOXOXXXOOOOOXXXXXOOOO
OOOOOXOOXOXXOXOXXOOOXOXXOOOOXXOOOOOOOOOOOOXXOOOXOOOXOOOOOXOOOOXOOOXOXXXOOOOXXOOOXXOOOOOOXXOOXOOOOXOOO
OOXOOXXXXOXOOOOXXOXOOOOOXOOXOOOOOOXXXOOOXOXOXOOXOOOOOOOOXOOXXXOXOXOOXOOXOXOXOOOOOOOOOOOOOXXOOOXOXOOXO
OOOXOXOXOOXXOXXOOXOOOOOOOXXOOXOOXXXOOOOXOOXOOOXOOOOOOOOXOXOOXOOOOXOOXOOXOOOOOOOOOOOOOXOXOXXOOOXOOOOOX
OXXOOXOOOXOOOOOOOXOOOXXOOXOOXOOOXXXOOOOOOOOOOOOOOOOOOOOOOXXOOXXXXXXOOXOXOOOOOOXXXOOOOOOOOXOOOOOXOOXXO
XOOXXOOOXOOOXOOXOXOOOXXXOXXOOXXOOOOOOOXOOXXOOOXXOOOOOXXOOOXOOOXXOOXOOXOOXOXXOOOXOXXOOOOOOOOOXOOXOOOOX
OOOOXOOOXXXOOOOOOOOOOOOXXOOOOXOOOXOOXOXOXOXOOXOXOOXOOOOOOOOOXXOXXXXXOXOOOXOOXXOOXOOOOXOOOXOXOOOOOOOXX
OOXOOXOOOXXOOXXOOXOOXOOOXXOOOOOOOOXXOOXXXXOOXXXOOOXOOOOOXOXXOOXOOXXXOOXXXXOOOOXOOOOXOOXOXXOOOXOOXXXXX
OXOOOOXOOOOOOOOXOOOOXOOOOXOXXXOOOXOOOXOOOOXOOXOOXOOOXOXXXXOOOOXOOOOOOOOXXOOOXOOOXOXOOOOOOXOOOXOOOOXOO
XXOOOOOXOXOXOXOOXXXOOXXXXOXOXOXOXXOOOXOXOXOOOXOOOOOXXOOXXOOOOXXXOXXOXOXXXOOXOOOOOOOOOOOOXOOOOXOXOXOOO
XOOOOXOOOOOOXOOXOXOOOOOOXOOOXOOOOOXOOOOOXOXXXOOXOOXOXOOOOOOOOOOOXOXOOOOOOOOOXXXOXXXOOOOXOOXOXOXXOOOOO
OOXOXOXOOXXXXOOOXXXOOXXXOOOOXOXXXOXXOOOOXOXOXOXOOOOOOOOXXOXOOXOXOXOOOOOOOOOXOOOOOOXOOOOXOOOOXXOXOOOOX
OXOOXXOOOOXOXOOXXOOOOOOOXOOOOXXOXXXOOOOXXOOOXOOXXOOOOOOOXXOOOOXOOXOOXXOXOOOOOOOXOOXXOOOOXOXOOOOOOOXXO
OOOOOXOXOOOOOOOXOOOOOOOOOOOOOOOXOOOXXOXOOOOOOOXXXOOOXOOXOOOOOOXXOOXOOOOOXOXOOOOXOXXOOXOOXOOXOOXOOXOOO
OOXXOOXXXXOOOOXOOOXOXOOXOXOOXOOOXOOOXOOXXOOOOXOOOOXOOXXXXOOXOXOOOOOOOOOOOOOOXOOOXOOOOOOOXXOOOXOOXOOOO
OXOOOXOOOOOOXOOXOOXOOOOOOOXOOOXOOOOXXOOOXOOXXOOOXOOXOXXXXOXOOOOOOOXOXXOXOOOOXOOXOOXXOOOOXXOOOOOOXXXOX
XOOOOXXXXOOXOXOOOOOOOOOOOOOXOOOOOOOXOOXXOOXOOXXXOOOOOOOOOOXXOXXXOOOOXXOOXOXOOXOOOOOXXOOOOOOXXXXXOOXXX
OOOOOOOXOOOOOOXOOXOOXOOXOOOXOOOOXOOXXXXOOOOOXOOOOOOOOOOOXOOOOOOXOXOOXXXOXOOOOOOOXXOXOOOOOOXOOXOXXXXOO
OOOOOOOOOOXOOOOOOXXOOXOOOOXXXXXXXOXXOOOXOXOXOOXOOXOXOOXOOOOOOOOXOOOXXOOOOOXXOXOOOOOXXOXOXXOXOOXOXOOOO
XOXOXOOOOOOXOXOXOOXOOOXOOOOOOOXOOOXOXOOOOOOOXOOOOOOXXOXOOOOXXXXOXXXXOOOXOOOOOOOOXOOOOOOXOOXOOXXXOOXOO
OOOOOOOOOOOOXXOOXOOOOOXXOOXXOOOOOXOOXXOXOOOOXOOOXOOOXOOOOOOOOXOOOXOOXOXOOXOOXXOOOOOOOOOOOOOOXXOOXOOOO
XXOOOOOXOOXOOOOXOOOOOOXXXXOXOOXOOOOOOOXOOOOOXXXXXXOOXXXOXOOXOOOOOOOOXXOOOOXXOOOOOOXXOOOOOOXXOOXXOOOXO
XXOOOXOXXOOOOOOXXOOOOOOOXXOXXOXOXOOOXOOOOOXOOOOOOXXOXOOOXOOOOOOOOXOOXOOOOOXXXOOOXXOOOOOOOXOOXOOXOOOXX
OOXOOOXOOOOOXOOOOXXXOXOXOOXXOOXOXOOOXXOOXXOXOXOOOXOOOOXXOOOOOOOOOOOXXXXOOOOXOOOXOOOOOOXOXOOXXOOOOOOXO
XOOOOOOOOOOOXOXOOOOXOXOOOOOOOOXOOXOOOOOXXXOOXOOOOOOOOOXOXXOOXOXOOXOOXOOOOXOOOXOOOOOOOXOXXOXXXOXXXOOOO
XOOOOOXOOXXOOOOXOOOOOOXOOOOOXOOOOOOXXOXXXOXOOOXOOOXOOOOOOOOXXOOOOOOOXOXOXXOXOOXXOOOOXOXOOOOOXXOOOXXOO
OOOOOXXOXOOOOXOXOXOOOXXOOOOOOOOOXXXOXOOOXXOOOOXOXOXXOOOXOOOXOOOOXXOOOOOOOOXOOOOOOOOXOXXOOOOOOOOOOOOOX
XOOOOXOXOXOOOOXXOOOOOOOOXOXOOXXXOXOXOXOOOOOOOOOOOOOXOOOOXXOXOXOXOXOXOXXOOXOOOXOOXOXOOOOOXOOXOOXOOXXXO
XXXOOOOXOOOOOOOOOOOXXOOOOOOOXOOOOOOOOOXOXOXOXXXOOOOOOOOXOOXOXOOOOOOOOOXOOOOOOOXXOOOOXXOOOXXXXOXOOXOOO
OXOOOXXOXOOOOOOXOOOOOOOOOOOOOOOOOOOXOOXOOOOXXOOOOXXOOXOOOOOOOOOOOOOXOXXOXOXOOOOXOOOOOOXOXOOOXXXOOOOOO
XXOXXXOOOOXOOXOOOOOXOXOXOXOOOXXOOOXXXXXOOOOXOXXXOOOXOXOXOOOOXOOOOOOOOOOOOOOXOXOOXXXXOOOOOOXOOOXOXXXOX
XOXOOOXOOOXXOXXOOOXOOOOXOOOXXOOXOOOOOOXOXOOOOOOOXOOOXOOOXXXOOOXOOOOOOOOOOXOOOXXOOOOOOXXOXOOXOOXOOOXOO
OOOOXOOOXOOOXXOOOOOOOOOOOOXXOOOOOOOXOOOOXXOXXOOOXOOOOOXOOOOOOOXXOOXOOOXOOXOOOOOOOOXOXOXXXOOOOOOOXOXOO
OXXOOXOOXXXXOXOOOOOXXXOOOOOXOOOXXXOOXOOOXXOOOOOOOOXOOOXXXOOXOOOOOOOXOOOOXXXOOOOOOOOOOXXOOOOXOOXOOOOXO
XOXXOOXXXOOOOXOOOOOOXXOOOXOOXXOXOXXOOXOXOOOOXOOXXOOXOOOOOXOOOOOOXXXOOXOXOOOOXOOOOXXOOXOXXOOOOXXOXXOOO
OOOOOOOOOOOOXXOOXOOOOXOOXOOOOXOOOOXOXOXXOOOXOOOOOOXOOOOOXOOOOOOOOXOOOXOOOOXOOOXXXOOXOOOOXOOOOOOOOOXOO
XOOOOOOOOOXXOOOXOOXOXOXOXOXOXOOOOOOOXOOOOOOOOOXOOOOXXOXOOXXOOXXOXOOOXOOOOOOXXOXOOXXOOOOOXOOOOOOOXXOOO
OXOOOOOOOOOOOOXXOOXOOOOXOOXOOOOXOOOXXOOOXOXOOOXOOOOXOOOOOOOXOOOOOXXXXOOXOOOOOOOOOOOOXXOOOXXXOOOOOXOOO
OOOOOOOOXOXOOOOOXOOOOXOOOOXOOOOXXOOOOOXOXOOOXXOOOOXOOOXOOOOOXOOOXXOXOOOOXOXOOOOXOOOXXOXXOXXOOXOOOOXXO
OOXXXOOOXOOXXOOOXXOOOOOOOXXOXOXOOXOXOXOOOOOOOOXXOXXOOOXOOXOOOXOOOOOXOOXOOXOOXXOXOOOOXXOOOXOXOXXOOOOOO
OOOOXOOXOOXXOOOOOOOXXOOXOOXOOOOOOXOOXOXOOOOOOXOOXOOOOXXOXXXXXXXXOOOOXOOOOOOXOXOOOOOOOOXOOOOOOXOOXOXOO
OOOOOOOXOOOXOOXOOOXOXXXOXXOOOOOOOXOXOXOXOOXOXOOXOXXOXOOOOOOOOOOXOOOOXOOOOOXXOXXOOXOXOOOOOXOXOOOOOXOXO
OOOOOOOOXXXXOOXOXXXOOOOOOXXOOOXOOOOOOXOOOOOOOOXOOXXOOOOOOOOOOOXOOOXXOOOOXOOOOOOXOXXOOOOXOOOOXXXOOOXOO
OOXXOOXOOXOOXOOXOOOXOXXXOXOOOOOOOXOOOXOOXOXOOOOOOXOOXOOOXOXOXOXOOXOOOOXOXOOOOOOOXOOOOXOOOOXOOXOOOXOOO
OXOOOOOXXOOXXOXOOOOOXOOOOOXOOXXXOOOXOOXOOXOOOOOOXXOXOXOOOOOXOOOOOOOXOOXOXXOOOXOOOOOOOXOOOOOOXOOXXOOOX
OXOXOXOOOXOOOOXXOOOOOXOOOOOOOOOXOOOOOOOXOXOOOOXOOOOXXXOXOXXOOXOOXOOOOOOXXOOOOXXOOOXOXOOOOOOOOOXOOXOOX
OOOOOOOXXOXOXOXOOXOOOXXOXXOXOOXOXXOOOXOXOOXXOOXOXOOOOOOOOOOOOOOXOOXOOXOXOOXOXXOOOXOOOOOOXXXXOOOOOOOOX
OOXOOOOXXOOOOOXXOXOOOXOXXOOXOOOXOXOOOXXOXOOOOXOOOOXOXOOOXOOOXOXOOOOOOXOXOOOXOOOXOXOOOOOOXXXXOOXOOXOOX
XOOOXOOOXOOOOOOOOOOOOXOOXXOXXOOOOOXXOOOOOOOXOXOOOXOOOOXOOXXOOXXOOXOOOOXOOXOOXXOOXOOOOXXXOOOXOOOXXXOOX
OOOOXOOOOOXOOOOOOOOXXXOOXOOOOOOXXOXOXOOOOOOXOOXOXOOOOXXXOXOXOOXOXOXOOOOXXOOXOXXXXOXOOOXOOXOXXXOXOXXOX
OXXXOOOXXOOOOOOXOOOOOOXOOOXOXOOXOOOOOOOXOOOXOXOOOOOOOOXXOOOOXXOOXOXOOXOXXOOXOOXOOXOXOOOXXOOOXXOXOXOXO
OOOOOOOOOXOXOOXOOOOOOXOXOOOOOOXOOOOOOOOXOOXXOOOOOOXOOOOOXOOOXOOXOXOXOOOXOXXOOOXXOXOXOOOOXOOOXOOOOOXXX
OXOOOOXOOXOXXOOXOOOXOXOOXXXOOXOOOOOOXOOOXOOOOXOXXOOOXOXXXOOOOOXXXOOOOOXOOXOOXOOOXXOOOOOOXOXOOXOOOOXXO
OOXXOOOXOOOXOXOXXOOOOOOOXXXXOOOOOOOOOOOXXXOOOOOOXOOOXOOOXOOOOOOOOOOXOOOOXOOOOOOOOOXXOOOOOOXOXOXOOXOOX
OOOXXOOOOOOXOOOXOOOOOOOOXOOOOOOOOOXXXOOOOXOOOXXOOXOOXXOXOXOOOXOOOXXOXXOOXOOOOOOXOOOXXXOOOOOOOOOOOXOOO
OXXXOXXOOOOOXXXOOXOXXOOOOOXOOXOOOOOOXOOOOXOOOOXOXOOOOOOOXOOXOXXXXOOOOOXOOXXOXOXXOOOXOXOOXOOXOOXOOOOXO
XOXOXOOXOOOOOOOOOXOXOOOOOXXOOOXOXOXOOXXOOOOOOOXOXOOOOOXOOOXOOXXOXXOXOOOOOOXOOOOOOOXOOXOOOOOOXOOOXOOOX
XOOXOOXOOXXXOOOXXOXXOOOXOOOOOOXOOOXOOOXOOOXOOOOXOOOXXOOOOOOXOOOOOOXXXXOOXOXOOOOOOOOXOXOOOXOXOXOOOXXOO
XXOXOOOXOOXOOOXOXXOOXOXOOOOOOOOXOXOOXOOOOOXXOXOOXOXOOXOXOOOOXOOOXOXOXOOOXXOOOOOXOOXXOOOOXXOOOOXXXOXXX
OXOXOOOXOOXOXXXXOOXOOOOXOOXXOOOXOOOOOOXXOOOOXOXOOOXOOXOOOOOXOOOOOOOOOXOOOXOOOOXOOOOOOOXOOOOOXXOXOOOOO
OOOXOXOOOOXXOXXXOOXXOOOXOXXOOXOOOOXOOXOOOXXXOOOOXXOOOOOXXOOOXOOOXXOOOOOOXOOOOOXOOOOOXXXOXOXXXOXOOOOOO
OXXOOOOOXOOXXOOOOOXXXXXOXOOOOOOXOOXOOOOOOXOOOOXXXOOXOXXOOOXOOOXOOOOOOOOOXXOOOOXXOOOXOXOOXXXOXOOOOOOXO
OXOOOOXOOXOOOXXOOXOOOXXOXXOXOOOOOOOOOOXOOOXOOOOXXOOOOXOOOOXOOOOOXXOOOOOXXXXXXOOXXOOOXOOOOOOXOOXOOOOOO
XOXXOOOOOXOXOOXOOOOXXOXOXXOOXOOOXOXOOOOOOOOOOOXXOXXXXOOOOXOOOOXOXOOOOOXOOOOXOXOOOOOOOOOOOXXOOOXOXOOOX
XOXOXOOOXOOXXOOXXOOOOXOXOOXOOXXOOOOOXOXOOXXOOXOOXOOXOXOOOOOOOXOOOOOOOXOOOXXXOXOOXXOOOOOOOXXOOOOXOXOXO
OXOXOOOOOXXOOOOOOOXXOOOXXOXOOOOOXXOXOOOOOOOOXOXOOOXOXOOOOOOOOOXXOOOOOOOOOXOXXOOXOOOXOOOOOXXXOXOOOXOOO
XOOOOXXOOOXOXOXOOOOOOXXOXOXOXXOXOOOXXOOXXXOOOXOOOOOXOOXXXOXOXOOOOOOXXOOOOOOXXOOOOOOOOOOOOXOOOOOOXOOXX
OXOXOOXXOOOXOOOOOXXOXXOXXOOOOOOOOXXOOOXOOXOOOOXOOOOOOOOOXOOOXOOOXOXXXXXXOOOXXXOXXOXOOOOOOOOXXOOOOOOXO
XXOOOOOXXOOOOOOOOXOOOOOOOOXOOOXXXOOXXOOOXOOXOOOOXXXOOXOOOXOOOOOOOOOOXOOOOOOOOOOOOXXOOXXOXXOOOXOOOOXXX
OOXXOOXXOOOOOOOOOOXXXXOOXOXXOXOOOOOXOOOOXOXXOOOOOXXOOOOOOXOOOOXXXOOOXXOOXOOOOOOXOOOXXOXOOOOOOXXXXXOOO
XOOOXXXOXXOXOOOOOOOOXOXOOOOOOOOOXOXOOOOOOOOOXOXOOOOOXOOXOOOOOXOOXXOXOXOXOOOOOXOOXXOOOXXOOXOXOXXXOOXOX
OOXXOOOOOOOXXXXOXOXOOOXOXOOOOOOXXXOXOOOOOXOOXOOOXOOOXOOXOOOOXXOXXOXXXOXXOOOOOOOOOOOXXOOXOOXXOOXOXOOOO
OOOOXOOOOXOOXOOXOOOXOXOXOOOOOOOOXOXXXOOOXXOOOOOXXXOOOOXOOOOXOOXOOOOXOXOOOXXOOOOXOXOOOOOXOOOXOXOOXOXOO
OOOOOOXXOOOXOOOXOXXOOXOOOOXOOXOXXOOOOXOOXOOOXXOOXOOXOOOXOXOXOXXOXOXOXOXXOOXOOOOOOXXOOOXOOXOXOXOOXXOXO
XOXXOOXOXOOXOXXOOOXOXOXOOOOOXOOXOOOOXXOOOOOOXOOOOOOOXOOXOOXOXOOOOOOOOOXOXXXOOOOOXXOXOOXOOOOXXOOXXXOOO
XOXXXOOOXOOOOXOXOXOOOOOXXXOXOXOOXOOXOXXOOOXOXOXOXOOOXOOOOXOOOOOXOOXXXXOOOOXOOOOXXOOOOOOOXXXOOXOOXXOXO
XOOOOOOOOXOOOOXOOOOOXXXOXOOOOOXOOOOOOXOOOOOXXOOXOXOXOOOXOOOOXOOOXXOOOOOOXOOOOOOOXXOXOOOOOOXOOOOOXOXOO
XOXOOOOOOOXOXOOOOOOOOOOOXOXOXOOOOOOOOOOOOXXOOOXXOOOOXOXOXXOOOOOXXOOOOXXXXOOXXOOOXOXOOXOOXXOOOOXOOOOOO
XXOXOOOOOOOXOOOOOOOOOXXXOOOOOOXOOXXOOOXOOXOOXOOOXXOOOOOOXOOXOOOXOOOOOOXXOOOOOOXOXOOOOXOOOOOOOXOOXOOXX
OOXOOOXOOOXXOOOXOOXXOOOOOOOXOOOOXOOOOOXOOOXOOOOXOOOOOOOOOOOOOOOOOOOOOXXOOXXOOOOOOOOOXOXOOOOXXOOOXXOOO
OOOXXOOOXXXOXXXOOOXOOOXXOOOOXXXOOXOXOOOOOOXXOOOOXOXXOXXOOOOOOOXOOOOOXOXOOXXOOOOOOOXXOOXOOOOXOOOXXXOXX
OOXXOXOXXXOOXXOOOOXXXXXOXOOOOOOOOOOOXXOOXXOXOXOOXOXOOOXXOOXOOOOXOXOOXOOOXXOOOOOOOOOXOXOOOOOXXOOOOOOXO
OOOOOXOOXOOOOXXOOXXOOOOOOXXXOXOOOOOOXOOXOOOOOOOOOOOXOOXXOOXOOOOOOOXXOOOXOOOOOOOOXXXXXOOOOXOXOXOOOOOXO
OXOOOOOXOOOXOOXOXOOXOOOOOOOOXOOXXOOOOOXXOOXOXOOOXOOOOXOOXXXOOXOOOOOXXOOOOOOOOOOXXOXOXOOOOXOOXOOOOXOXO
OOXOOOOXOXOOOOXOOOOOOOXXOXXXOOOXOOXOOOOXOOXXOOOOOOOOXXOOOOOOOOOXOOXOXOOOOXOOXXOOXOOOOOOOXOXOOOOOXOOOO
