XOOOXOOOXOOOOXOXOOXOOOXOOXOOOOXXOOXOOOOOOOXOOXOXOOXOOOXOOOOOXOOXXOOXOXOOXXOXXXOOOOOOOXOOOOOOOXXXOOXOO
XOXOOOXXXOOOOOOOOOXOOOOOOXXXOOOXOOOXOOXXOXOOOXXOOOXOOXXOOXOOXOOOXXXOOXXOOOOXOOOOOOOOOOOOOOXOOXOOOOXOO
XOOOOXOOOOOOXXXXOOOOOOOOOOOOOOOOOOOOOOXOXOOOOOOOOOXXOXOXOOOOOOOXOXOOXOOOOXOOXOXXXOOXOOOXOXOXOOXXXOOOX
XOXOOXXOOOXXOOXXOXOOOOOXOXOOOXOOOOXXOXXOOOOXOOOXOOXXXOOXOXXOOOOXXXOXOOOXXXOOOXOXOXOOOOXOXXXOOXOOOOXXO
OOOOXOOXOOOOOOOOXOXOXOOOXOOOOXXOOXOOXOOXOOOOOOXOOXXXOXXOOOOOOXXOOOOOOOOOOOOOOXOOXXOXXXOOOXOOXXOXXXXOX
OOOOOOOOXOOXOOOXOOOOOOOXOOOOXXXOOOXXOOOXOOOOXOXXOOOOXXOOOOOOOOXOOOOOXOOOXOOOOOOXOOOXXOOOOXOOOOXOXXXOX
XOOOOOXXOXOOOOOXOOOOOOOOOOXOOOOOOXOOXOOOOOXXOXOOXOOOXOOXOOOOOXOXOXOOOOXOOOOOOOOXXXOOOOOOOOOXOOXXOOOOO
OOXOOOOXOOOOOXXXXOOOXOOOXOOXOXOOXOOOXOOOOOOOXXOOOXOXXOOOOOOOXOXXOOOOOOOOOOXXOOOOOOOOOOOOOOOOOOOOXOOOO
XOOOXOOXOXOOXXOOOOOXOOOXOOOXOOXOOXOOXOOOXOOXOOXOOXOOOXXOOOXOOOOOOOOOOXOXOOOOXXXOXOXOOXOOOOOXOOOXOOOOO
OOOOOXXXOOOOXOOOXXOXOOOOOOOOOXOOXOXXOXOOOOOOOOOOOOOXOXOOOOXOOOXOOOOXOOOXOOXXOOXOOOOOOOOXOOXOXOOOOXOOO
XXXOXXOOOOOXOOXOOXXXXOOXOOOOOXOOOXOOXOOOOXXOXXOOXOXOXOOOOXXOXOOOOOOOOOXXOOOOOOOXOOXOOOXOOXOOXXOOOOXOO
OXOXXXOXXXOOOOOXXOOOOOOXOOXOXOOOOOOOOXOOOXOOOOOXOOXOOOXXOXOOOOOOOXOOOXXOXXOXXOOOOOXXOXOOOOOOOOOXOOOOO
XXOOXOXOXXOXOOOOOOOOOOOOOOXXOOOOOOOXXXXOOOXXXXOOOXOOOOOOOOXOOXOOOXXXXOOXXXOOXXOOXOOOOOOOOOXOOXXOOOXOO
XXOXOOXOOOOOOXOOOOOXOOOOOOOOOOXOOOXOOXOXXOOOXOOOOOXOOXOOOOOXOOOOXOXOXOOOOOOOXOOXOOOXOOXXXXXOOXOOOOOXO
XXXXXOOXOOOOOOOXOXOOXXXOOOOOOOOOOXOXOOOXOOXXOOOOOOOOOOXOOOOOOOXOOXXOOOXXOOOOOXOOOOOOOOOXOOOOXXXXOOOOX
OOOOOOOOXOOXOOOXXOXOXXXOXOOOOXXXOOOOOOOOOOOXXXXOXOXOOOXOOXOOOOOOOXOXOOOOXOOXOOXOOXXOXOXOOXOOXOOXOOOOO
OOOOXOOOXXXOXXOXOOXOXOOOXXXOXOOOOOXOOOXOOOOOOOXOOXXOXOXOOOXOOOOOOOOXOXOOXXOXXOXOOXOXXOOOOXOXXXOOXXXOO
OXOXOXOXXOOOOOOOOOOOOOOOXXOOOXOOOXXOOOXOOOOOOOOXOOOOOOOOOXOXXXXOXOOXOOOXXOXOOXXOXOXOXOOOXXOOXOOXOOOXO
OXOOXOOOXXOOOOOXOOOXOOOXXXOOOOOOOOXOOOOOOOXOOOOOOOOOXXOXOOOOOOXOXOOOOOOOXXOXOOXXOOOOOXOOXXXOOOXOXOOXO
OOOOOOXOXXOOOXOXOOOOOXOOXOOOOOXOOOOOOXXOOXOOOOOOXOXXOOOXOOXOOXOOXXXOOOOOXOOOXOXXOOOXOOOXXOOXOXXOXOOOO
OOXOXXOOOOOOOXOOOOXXXXOXXXXOOXXXOXXOOOXXOOXOOXOOOXXOXOOOOOOXXOXOXXXOXOOOXOOOOXOXOXOOOXXXOOXOOOXOXOOXO
XOOOOOXOXOOXOXXOXOOXOOXOOOOOXOOOXXOXXOOXOXOOOXOOXOOOOOXXXOXOOOOOOOOXOOOOXOOOOOOXXOOOXXOXOOOXOXOXOXOOO
XXOXOOOOXOOOOXOOOOXXOOOXXXXOXOOXXXOXOOOOOOOXOOXOXXOOXOOOXOOOXOOOXOOOOXOOXOOOOOXOOXOOXOOOOOOXOXOOXOOXX
OXOOOOOOOOXOOOXXXOOXOOOXOXXOOOXOOXOOOOOOOXOOXOOXOOOOOXOOXOOOOOOOOOOOOOOXXOOOOXOXOXOXOOXOOOOOOOOOOOOOO
XOXOOXOOXXOOOOXXOOOOXXXOOOOOOXOOXOXXXOXOOOXOOOOOOXOOXXOOXOOOOOOOXOXOOOXXXOXOXOOXOOXOXOXOOOXXXOOOOOXOO
XXXOOOOOXOXXOOOOOXXOXXXOXOOOXOOOOXOXOXOOOXOOOOOOOOOOXXOOOXOXOOOOOOXXOXXOOOOXOXXOOOOOOOOOXOXOOXOXXOOOO
OXOOXXOOXOXXXOOOOOOOOOOXXXOXOOOOOXXOXOOOXOOXOOOOOXOOXOOOOOOOXXOOOXXOXOOOXXOOXOXXOXXOXOOOOOOOOXOOOOOOO
OOXOXOOXOXOXOXOOOOXOOOOOOOXXOOXXOOXOXXXOXOOOOOOOOOOOOOXOXOOOOOOOXOXOOOOOXOOOOOOXXOXOXOXOOOOXOXOOOOOOO
OXOOXOOOXOOOOOOOOOXXOOXOOOXOOXOXOXOXXOOOOXOOOOXXOXOXXOXOOOOOXOOOXOXOOOXXOOOOOOOOXXOXOOXOOOOOXOOOOOOOO
XOOOXOOXOOOOOOOXOOXOOXXOOOOOOOOOXOOOOOOOXOOXOOXOXOOOXOOXXOXOXOXOXXOOOOOOXOOOOOXXOOOOOOOXOOXXOOOXXXOOO
OOOOOOOOOOOOXOOXOXOOOOOOOOXXOOOOOOXXXOOXOXOOOXOOXOOOOXXOOXOOXOOOOXOOXXOOOOXOOOXOOXXOOXOOOOOXOOOOOXOXO
OOXXOOOOXOXOXOXOOOXOOOOOOOOOOOOXXOOOOOOOXXOOOOOOOOXXOOXOXOOOOOXOXXXXXXOXOOOOOXOOXXOOXOOXOXOOOXOOOOOOO
OXOOXXOXOOOOOXOOOXOOXOXOOOXOXOOXOOOOOOXOOXXXXOOXXOOOXOOXOXOOOOOOXOXXXXXXOOOOXXOOOOOOXOXOOOOOOOOOOOXOO
OOOOXOOOOOOXOXOOOOOOXOOOOOOOXXOOXOOOOOOXOOXXXXOOXOOOXOXOXXOXOOOOOOXOXOXOOXOOOOOOXOXOOOOOOOOOOOXOOOXXX
XOOXXOOXOXOOOOOOOOXXXXOOOXOOXXOOXXOOOOOOOOOOOOOOOXXOXOOOXOXOOOXOXXXOOOOOOOOOOOOOOOXOOOOOOOOOOXOOOOXOX
OOOXXOOXOOXOXOOXXOXOXOOOOOOOXXXOOOOOOOXOOXXOOOOOXOOOXOOXOOXOOXXOXOOOOXOOOXOXOOXOXXXOXXXOXOXOOOOOOOOXO
OXOXOXOOOOOOOOOXOXOOOOOOOOXOOOXOOOOOOXOXOOOOOOOOOOOXOXXOOOXOOXOOOOXOOXOOOOOOOOXOXOXOOOOXOXXXOOOXOOOOX
OOOOOOOOOOOXXOOOOXOOOOOOOOXXOXOOOOXXOOOOXOXXOOXOXOOOXOOOOOOXOOOOXOXOOOXOOOOXOXOOOXOOXOOXOXXOXOXOXOXOO
OOXOXOOOXXXXOXOOOXOOXOXOXOOOOOOOOXOXOOXOXXXOXOOOOOOOOXOXOOOXXXOXOXXOOOXXOOOOOOOXOOOOOOOOOOOOOOOXOOOOO
XOOXXOOOOXOOXOOOOOOOOXXOOOXOOOXXOOXXOOOOXOXOOOOOOOOOOXOOOOXXOOXXOOOOOOXOOOOOOOOXOOXOXOOXOOOOXOOOOOXXO
XOXOOOOOOXXXXXOOOXOOXXXXXOXXXOOOXOXOOOXOXOOOOOOOOOOOOOXOOOOXOXOXOXOOOOOXXOOXOXOOOOOOXXOXOOOXOXOOXXXOO
OOOXXOOXXOOXOOXOXXOOXXOOXXXOXXXOXXXOOOXOOOXOOOXOOOXXOXOOXOOXOXOXXOOOXXOXOXOXXOOOXXXXXXOXXOOXXXXOOOXXO
OOXXXOXXXOOOXXOOOXXXOXOOOXOXOXXOOOOOOOOXOOOOOOOOXOOOXOXOXXOXOOOOOOOXOOOXOOXOXOOXOOOOXXOOXOOOOOXXOOOOX
OXOOXXXOOOOOXXOXOXXXXXOOOOOOXOOOOXOOOXXXOOOOOXXXXXXOXOOOXOOOOXOXOOXXXOXXXOOXOOXOOOXOXOOOOOOOXOOXOOXOO
OOOOOXOOXOOOOOOOXXXOXXXOOXOOOOOOOXOXOOOOOXOXOXXXOOOXOXOXOOOOOOOXOOOOOOOOOOXXXOXOXOXOOOXXOOOOXOOOOOOOO
OOOXOOOXOOXOOOOOOOOXXXXOOOOOOXXXOXOXOOOXOOXXOOOXXOOOOOOXOOOOXOOOOOOOOOOOOOOOOOOOXOXXOOOOXOOOOOXOOXOOO
OXXXOOOOOOXOOOOOOOOXOOOOXOXOOXOOOOOOXOOOXOOXOOOXOOOOOOXOOOXOXOOOXOOXOOOXOOOXXOOOOOOOXXOXXXXOXOOOOOOOX
XOXOOXXOOXOOOXOOOOOXXOOOOOOXXOXXOOOOOOXOOOOOOOOOOOOOOOOXXOOXXOOOOOOXOOXOOOXOOOXOXXOOOXOOOOXXXOXXOXXOO
OXXOOOXOOOOOOOOOOOXOOOXOOOXOOXOOOXOOOOXOOOOOOOXXXOOOOOOOXOXOOXOXXXXXOOOOOOOOXOOXOXXOOOOOOOXOOOXOXOOOO
OOXXXOOXXXOOXOOXOOOXOXOXXXXOXOOXXOOOOOXOOOOOOOOXOOOOXXXOOOOOXOOOOOOOXOOXXXOOOOXOOOOXXXOOXOOOXOXXOOOOO
OOXOOXOOOXOOOOOXOOXOOXOOOXOOXOXOXOXOOOXOOOOXOOOXOOOXOXOOXOOOXOOOOXXOXOOOOOOXOXOXXXOXXXOXXOXOOOOOOXOOO
OXOXXOOOXXOOXOOXOOOXOOOOXOXOOXOOOOOOOXOOXOXXXOOXOOXOOOOOOOXOXOOXXOOOXXOOOOOOOOXOOXXOXOOOOXXOOOOXOOOOO
OOXOOOOOOOXOXXOXOXOOOOOXOXOXOXOOOXXOOOXXXOOOOOXOOXOOOOOOOOXXXOOOOXXOOOOXOXOXXOOOOOOOOOOXXOXXXOOOOOOXO
XOOXOOXXOOXOOOOXOXOOOXXOXOOOOXOOOOOOOXOOOOXXOOXOOXOOOOOXXOOOOXOXOOOOOXOOOOOOXXOOOOOOOOOXOXXOOXOOOXOOO
XOOXXOOXOOXOXXXXOOOOXXOOOOXOOOXOXOXOOOOOOOXXOXOOOOOOOOXOXOOOXOOOOXXOXOXXXXXXOXXXOOOXOOOOXOOXOOXOXOOXO
OOOOOXXXOXOXOXXOXOOOXOXXOOOOOOOXOOOOOOXOXOOOOOOOOOXOOOOXOOXXOOOOOOXOOXXOOXOOOOOOOXXXXOXOOXOXOOOOXXOXX
OXXOOXOXXOOOOOOXOOOOOOXOOOOXOOXOOOOOOOOOOXOOOOOOXXOOOOOOOOOOXXXOXXOOOOXXOXOOOOOOOXOOOOOOOOXOXXXOXOOOO
XOOXXOOOOXOOOXXOOXOXOOOOOXOXXXOOOXOOOXOOOXOOXOOXOOOOOOOOOOOOOOXOOXOOXOXOOOXOOOXOOXXOXXOOXOOOOOXXOOXXX
OXXOXOOOOOOXXOOOXOOOXOOOXXOOXOXXOOXOXOXOOXOOOOOOOXXXXOXOXXOOOXOOOOXXOXOOOXXOOOOXOOOOOOOOXXXXOOOOOOOXO
OOOOXXOXOOOOXXOOOXOOXOOOOXXOOOOOOOXOOOOXOOXOOOOOOXOOOXOOOOXOOOOOOOOOOOOOOXOXOOOXOOOOOOXOOOXOXOOOOXXOX
OOOOOOXOOXOXOOXOOOXOOOOXOOOOXOXOXXOOOXOOXOOOXOOOXOOOOOOOOXOOOOOXOOOXXOOXOOOOOOOOOOOOXOOOOOXOOOXXOOXOO
OOOXOOXOXXOXXXOOXXXOOOOXXOXXOOOOXOOOOOXXOOXOXXOOOOOOOOOOOOXXOOOOOXOXOXOXXOOOXOOXOXXXOOOXOOOXXXOOOOOXO
XXXOXOXOOXXOOXXOXOOXOOOXOOOOOOXXOOOOXXXOXOXOOOOOOXOOOXOOXXOOXXOXOOXOOXOOXOOOOOXXOOOXOOOOOXXOOOOOXOOOO
XOOOXOOXOOOXOOOXOOXOOOXOXOXXXOXXXOOOXOOOOXOOXOXXXXXOXXXOXOOXOXOXOOOOOOOOOOXOOXOOXOXOOOXOOOOXXOXOXXXXO
XXOXOOOOOOOOOOOOOOOXOXOXOXOOOOXOXOXOOOOOOXOXOXOOOOXXOOXXOXOOOOXOXXXOOOOOXOOOXOOOOOOOOOOOOOOXOOOXOOXOO
XXOOOOOOOXOOXXOOXOOOOXOOXXOOOXOOOXOOOXOOOOOOXOOOXXOOOOOXXXOOOXOXXXXXXXXOOXXOOOOOOOOXOOOXOOXOXOOOOOOOO
OXOOOOOXOXXOXOOOOOOOXOXOXXOOOOOOXXXOOOOXOOOOOXOOXXOOOOOOOOOOOOOXOOOXOOOOOOOXOOXOXOOOOXOOOOOXOOXOXOOXO
XXXOOOOXXXXOOOOOOXXOOOXXOOXOOXOOOOOOOOOXOOOXOOOXOXXOXOXOXOOOOOOOOOXOOXXOXXXXOOXXXOOXOXOXOOOOOOOXOOOOO
OXOOOOOOOOOOOXXXXOOXOOOXOOOOOOOOXXOOOXOOOOOOOXOXOOOOOXXXOOOXOOXOOOOOOXOOOOXXXOOOOXOXXOOOOXOOXXOOXOOOO
OXOOXOXOOXXOOOXOOXOOXOOOOOXXOOOOOOOOOOOOXXOXOOOOOXOOOOOOOOXXOOOOOOOXOXOXOXOXXXOOOXOOXXOOOOXXOOXXOXOOO
XOOOXOOOOXOXXOOOOXOOOXOOXXOOXXOOOOOXXOOXOOOOOOOOXXXXOXOOOOOOOOXOOOOXXOOOOXXOOOOOOOOOOOOOOXOXOOXXOOOOO
OOXOOOOXOOOOOXOXOOOOXOXOXXXOXOOOOOOXOXOOOOOOOXOOOXOXOOOOXOOOOOXOOOOOOOOXXOOOXXOXXXOOOOOOOOOXOXOOOOXOO
OXOXOXOOXOXOXOOOOOXOOOOOOOOXXOOOOXOOXOOOOXOOOOXOOOOXOOOOOOOOOOXOOXOXOOOXOXOOOOOOOOOOOXOXOOOXXOOOOOOOO
OOOXOOXXXOOXXOOOXXOOOOOXOOOXOXOOOXXOXOXOOOOOOOOOOOXOOXOOXOXXOXXOOOXOOXXOOXOOOOXOOOOOOXOXOXOXOOOOXOOOO
OXXOXXXOOXXOXOOXOOOXOOOOXXXXXOOOOOXXOOOXOXXOOXXOXXOXOOOOOOXXOOOOXOOOXOXXXOOOXOOOXOOOOXOOOXXOOOOXOXOOO
XOOOOXXOOOXOOXOXOOOOXOXXXOOXXOOXXOXOXXXOXOOOOOOXOOOOXOOOOXOOOOOXXOOOOXOOOOOXOOXXOOOXOOOOOOXOOOOOOOXOO
XOOXOOOOOOXXXXOXOXXOOOXXXOXXOOOXOOOXXXOOOOOOXOOXOOOXOOOOXOOXXOXXOXXOOOOOOXOXOXXXOOOOOOOOOOXXOOOOOXOOX
OOOOOXOOOOOXOOXOOOOOOOOOOOOOOOOOOOOXOOOXOOXXOOOXXOXOOOOOOXXXOOOOOOXOOOOOOOOXOOXOOOOOOXOXOOXOOOOOOOOOO
OOOXOOOOOXOXXOXOOOOOOOOOOOOOOOOOOOOOOOXOOXOOOOOOOOXXOXOOOXOOOOOXOOXOOOXOOXOOOOOOOXOOOXXOXXXOOXOOOXOXX
OOXOOOOOOXOOOOOOOOOXOOOXOOOXOXOXOXXOOOOOOXOXXOXOOOOOOOOXOOOXOOOOOXOOXXOOOXXXXOOOOXOOOXOOXOOOOOOOOOOOO
OOXXOOXXXOXOXOOXOOOOXXOOXXXOOXXOOOOXOOXOOOOXOXOXXOOOOOOOXOOXOOOOXOOOOOOOOOOXXOOOOXXOOOOOXOOOOOOOOXOXO
OOOXXOOOOXOXXOXOXOOXOOOXXXOOOXOOOOXOXOXXXOOOOOOOOOOOOOXXOOOOOOXXXXXOXXXXXOXOOOOOXXOXXOOOOXXXOOOOXOXXO
OOOXOXOOXXOOOOOOXOOOOOXOOOOOOXXXOOOOOXXOOOOOOOXOXOXOXOOOXXXXOOOOXOOOXOXXOOOOOXOOOXOOOOOOOXOOOOXXXOOXO
OOOXXOOXOXXXOOOXOOOXOOOOOOOOOOOOXXOOOOXOOXOOOOOOOOOOOXOXOXXOOXOXXOOXXOOXOOOXOXOOOXXOOOOOOOOOOXXOOXOOO
OOXXOOOOOXOOOOOOOXOXOOXOOOOOOOOXOOOOXXXOOOOOOOXOOOOOOOOXOOOOXOOOOOOOOXOOOOXOXXOOOOOXOOXOXOXOXXOOOOOOO
OOOOOXOOOXOOXOOOXOOOXOOOOOOXXOOOXXXOOOOOOOOOXXOOXOOOOOXOOOOOXOOOXXOXOXOOXOOOXOOXOOXOOXXOOXOOXOOOOOXXO
XOXXXOOOOXXXXOOOOOOOXOXOXOXOOOOOOXOOXOXOXOOOOOOOOOXOXOOXOXOOOOXOXOOOOXXOOOOXOOOOOXXXOOOOOOOOOOOOOOOOO
OOOOOOOOOXXOOOOOXOOOOOOXXXXOOOXOOOOOOOXXOXOOXOXOOOOXXXOXOXOOOOOXXOXXOOXOOOOXOOXOXXOOOOOOXOOOOOOOOXOOO
OOOXXOOOXOOOOXOOXXXXXOOOOXOOXOOOOXOOXOOOOOOOXOOOOOOOOXXOXOOXXXOOXOXOXXXOOOOXOOOOOOOOXOXOOOOOXOXOXOOOO
XXOXOXXOXOOOXOXOOOOXOXXOOOOOOXOOXOOOOOOXXOOXXOXOXXXOOOOXOOOOOOXOOXOXOOOOXOOOOOOXOXXOXOOOOOXOXOOOXXOOX
OOOOOOOOOXXXXXOXOXXOXOOOXOOXOOOOOOOOOOOOOOXOOXOXOOXOOOXOOXOXOOOOXOXXOXXXOXOOXOOXOOXOOOOOOOOXOOOXOOXXO
XXOXOOOOOOOOOOXOOOOOOOOOOOOOOXXOOXOOXOOXOOOXXOOXOOOXOOXOOXOOOOXOOOOXOOOOOXOOXOOOXOXOXOOOOOXOOOXOXOOOX
XOOXOXOOOXXOOOOXOOOOOOOXOXOOOOOOXXOOOOOOOOOOOXOXOOXOOOOOOOOOOOXOOXOOOOOXOOXOOOOXOXOXXOXXOXOXXOOOOXXOO
OOOXOOOOOOOOOOOOOOXXXXOOOXOOOOXXOXOOXOOOXXOOOOOOOXOOOXOOOOXOOXOXOXOOOOOXOXXOXXOXOOXOOOXOXOOOOOOOOXOOO
OOOXOOOXXOOOXOXXOOXOXOOOOOOXXOOXOOOOOOOOOOXOOOOOXOOOXOOOXOOOOOOOXXXOXOOOOOOXOOOOOXXXOOXXOOOOOOOXOXOOO
XXOXXOOOOXXOOOOOOXOOOOOXOOOXXOOXOOXOOOOOOXOOOXOOOOOOOXOOOOXOXOXXXOOOXOOXOXOXOOOXXOOOOXOOXXOOOOXXOOXXO
OXXOXOOXXOOXXOOXOXOOXOOOXOXXOXOOXOXXOOOOOXXOOOXOOXOXOXOOOOXOOXXOOXOOOOOOOOXOOXOXOOOXOOXXOOOXOXXOXOXOX
OOXXOOXOOOOOXOXOXXOXXOXOXOOOOOOOOOOOOOOOOOOOOXOOOOXXOOOOXXOXXXOXOXOXOOXOOOXOOXOOOXOOOXOOXXXXOXOXOOOXX
XOXXXXOOXOXXOXXXOOOOOOOXOOXOOOXXXOOOOXOXXOOXOOOXOXOOXOXOXOXOXXXXOXXOXXOOOXOOOOOOOXXOOOOOXOOOXOOXOOXXO
OXOXXXOXOXOOOOXOXOXOOOXOXOOOXOOOOOOXXOXOOOXOXXOOOOOXXXOXOOXOXXXXOOOOOOOOOOOOXOXOXOOXXOOOXXOXOXXOOOOOX
OOOXOOOOOOOOOXOOOOOOOOXOOOOOOXOOOOOOXOOOXXOOOOOOOXOOXXXXOOXXOXOXOOXOOOXOOXXOOOOOOXOXOXXOOOXOOOXXOOOOO
