OOOOOXOXOOOXOXXOOXXXOOOOXOOXOXOXXOXOOXOOOOOOXOOXOOOXXOOOOOOOXOOXXOOXOOOXXOOOOXOOOXOOOOOOOXOXXXOXOOOXO
OOOOOOOXXOOOXOOOOXOOXXXXOOOOXOOOOOXXOXXXOOOXXOOOOOXOOOOOOOOOOXXXXOOOOOOXOOOOXOXXOOXOXOOOOOOXXXOXXOOOX
OOXXOOXXOOOXXXOOOOXOOOOOOOOOOOOOXXOOOXOOOXXXOOOOXOOXOOXOXOOXOOOOXOOOOOOOOXOOOXOOOOOOXOOOOXXOOOOOOXOOX
XOOOXOOXXOXXOXOXOOOOOOXOXOOOOOXOXOOXOOOOXXOXOXXOOXOOOOXXOXXXOOXXXOOOOXXXOOOOOXOXOOOXXOOXXXOOXXOOXXOOX
OOOOOXOOOOXOOOXOXOOXXOOXOXOXXXOOOOOOOOXXXOOXOOOXOOOOXXXXXOOOOOOXOOOXOOOOOOOOOOXXXOOOOOOOOXOOOOOXXOOXO
XOOOXXXOXXOOXOOOXOOXOXXOOXOOOOXXXOOOOOOXOXOOOXOXOOOOOXOOOXOOOOOXOOOOOXXOOOXOOOOXOXXOOOOXOOXOXOOOOOOOO
OXXOOOOXXOXOXXOOXXXXOOOOOOOOOOOOXOOXOOXXXOOXOOXOOOXXOXXOXOOXXXOOXXOOXOOOOOOOXOOOXOXOXOOXOXXOOOXXXOOXO
OOOOOXOOXOXXXOOOXOOOXOXOOOOOOOOOOOOOOXXXOOOXOOXOOOOXOOXOOXOOOXXXOOOOOXOXOOOXOXOOXOOOOXOOOOOXXXXXOOOOO
XXOOOOOOXOOOXOOOOOXXXOOOOOOOOXOOOXOXXOOXOXOOXOOOXXOOXXOOOOOOXXXOOOOXOXXOXOOOOXOOXXOOXOOOOXOOXOXOOOOOX
XOOOOOOOXOOOXOXOXXOOOOOOOOOOXOOXXOOOOOXXXOOXXOXXOOOOOXOXXXOOOOOOOXOOOOOOOOOOXXOOXOOOOOXXOOOXOOXXXXOOX
OXXOXOOOOOOOXOOOOOXXOOOOOOOXOXXOOOOOOXOOXOOOOOOXOXOOOOOOXOXXXOOXXXOXXOOXOXOOOOOOOOOXOXXXXXXOXXXOOOXXO
OOOXOXXOXXXOOXOOOOXOXOXXOOOOXOOOOXOOOXOXOXOOOOOOXOOXXOOXXXOOXOXXOOOXOXOXOXOOOOOOOXOXOXOOOOOOOXOOOXXXX
OOOOXOOOOOOOXOOXOOOXOXOOOOOXOXOOXOXOOOOOOOXOOOOOOXOOOOOOXOOOOXOOOOXOOXOOOOOOOOXXOXOOOOOXOXOOOOOOOOOOO
OOOXOOXXOXOOXOXXOXOOXOXOXOOOOOOOOOOOXOXOXOOOOOOOXOOOOXOOXOOOOOXOOXOXXOOOOOOXXXXOOOOOOXOOOOOOOOOOOOXOO
OOOXOOOXXOXOXOXOOXOOOOOOOXOXXOOOOXOXOXXOOOOOOOXOOXOOOXXOXOOOOOOOOOOOOOOOOXOOXXOOOOXOOXOXOOOOXXOXOXXOX
OOOOOXOOXOOOOXOOXOOOOOOXOOOXXOOXOOXOXXOOXXXOOOXOOOOXXOXXXXOOOOXOXOXOOXXOOOOOOOOOOOOOOXOOOXOOOOOXOOOOO
XOXOXXOOOXXXOXXOOOOOOOXOOXXOXXOOXOOOOXOOXXOOXOXOOOXOOXOOOOXXOOOOXOXOXOXOOOOOOXOOOOOOXOOOOXOOOXOOOXOOO
XXXOOOOXXOOXOOOXXOOOXOOOOOOXXOXOOXOXXOXXOOOOOOXXXOOXXOOXOXOXOOOOOOOOOXOXOOXOXOXOOOXOXOXOXOOOOOXOXOOXO
OXOXOOOOOOOOOXOOXOOOOOXXOXXXXOXXXOOOOOOXOOOOOOOOOOOOOXXOOXOXXOOOXOOOOOXOOOOOXOXXOXXOOXXXOOOOXOOOOOOXO
OXOOOXOOXOOOOXOXOXOOXXOOOOOOOOOXOOOOOXOOOXXXOOXOOOOOOXOXXOOOOOOXXOOOXXXXOOOOXOOXXOOOOXOOXOXOOXOOOOOXO
XOXOXOOOXXOOXXOOOOOOOOXOOXXXOOOOOOXXOOOXOXOOXXOXXXXOOXXXOOOOOXXXOXOOOOOXXXOXOXXOOXOXOOXXOXOXOOOOOOXXX
OXOOOXXXOOOOOOOOXOOXXXOXOOOXXOOOOOOXOXXOXOOXXOOXOOOXOOOOXXOOXOXXXOXOOXOOOOXOOOXOOXOOOOOXOOOOOOOXOOOXO
OXOXOOXOOXOXOXXXOXOOOOOOOXXOOOOOOXXOXOOOXOOOOOXOOXXOOOOOOOOOOOOOOXXOOOOOOOOOOOOXXXXOOOOXOOOOOOXOOXOXO
OXXOOOOOXOOXOOXXXOOOOOOXOOOOOXXOOOOOOOOOOOOXXXOXOXXXXXOOXOOOOXXXOOOOOXOOOXOXOOOXOOOOOXOXOOOXOOOXOOOOO
OOXOXOOOOOXOOXXOXXOOOOOOOOOXOOOOOOXOOXOOOOOXOOXOXOXXXOXOXOOOOXOOXXXOOOOOOXOOOOXOOOOOOOOOOOOXXOOOXOOXX
OOXXOOOOXOXOXOXOOXOXXOOOOXOOOXOXOOXOOOXOOOOOXOOOOOXOXOOXXOOOOOOXOOOOXOXOOXOOOXOXXOXOOOOOXXXOOOXOXOXOX
OOOXOXXOOXOOOOXOOOXOOOOOOOOOOOXOXXXOOXOOOOOOOOOOXOOOOOOOXXOXOOXXOOOOXOOOOOOXOOXOXOOOOOXOOOOOXOOOXXOOO
OOOXXOOOXOXOOOOOOOOOOOOXOOXOXOXOXXXOOOOOOOXOOXOOOOOOOOOXOXXOOOXOOOOOOXOOOXOXOXOOOXOOOOXOXXOOOOOOOXXOO
OOXXOOOOOOXOOOOOXOOOOOXOOOOXXXXOOXOXOOOXOOOXOOOXOOOXOOXOOOOOOXOOXXOOXOXOOXXOOOOXOOOOXOOOXXOOOXOXXXOOO
OOXOXOOXOOOXOXOOOOOOOOXOOOOXOOOOOXOXOXXOOOXXXOXOOOOOXXOOOOXOOXOOXOOOOOXOOOOOOOXOXOOXOOOXOOOXOOOXXXOXO
OOOXXOOOOOOOXOOOXOOOOOOOXOOOOOOOOXOOXXOOOOXOOOOXOOOOOOOOOOXXXXXXOOOOOOOOOXOXXOXOOOOXXXOOOOOOXXOOXXXOO
OOXXOXOOOOOXOOXOXOOXOOOOOOOOOXOOOOOXOOXXXOXXXOXOOOXOXOOOOOOXOOOOOOXXOOOOOXXXXOXOOOXOOOXOOXOXXOOXXOOXO
OOOXOOOOOOOOOOOXOOOXOXXOOOXOOOXOXOOXOXOXOXOOXOOOXOOXOOOOXOXXOOOXOOOOXXXOOXOXOOXOXOOXOOOXXOXOXOXOOOOOO
XXXOXXOXXOOOOOXOXOXOOOOOOXOXOOXOOOXXOOOOOOOOOOOOXXOOOXOOXOOOOXXOOOOOOOOXOOOOOOXOXOOOOOXOXXOXOXOOOOOOX
XXOOXOOOXXOOOOOOOXXOOOOOOXXOOOOOOOOXXOOOOOOOOOOXOOOXOXOOOOXOOOOXXOOOOOOOOOOOOOOXXOOOOOOXOOXXOXOXOOXOX
XOXOOXOOOOOXXXOOOOOXOOXOXOOOXXOOXXXOOOOOXXOOXOXOOOOXOOXOOXOOOOXOXXOOXOOOOXOOOOOOOOXXOOXOOXOOOOOOOXOOO
XXOOOOXXXOOOOXOOOOOOOOOXOOOOOXOOXOXOXOOXOXOOOXOXOXOXOOXOXOOOOXXXOXOXOOOOOXOOOOXXOOXXOOOOXOXOOOOOOOOXX
OOOOOOOOXXOOOOXOXOOOOXOOOXXOOOXOOOOOXOXXXOXOOOOOOXOXXOOOOOOOXOOOOOOOOOOOOOOOOOOOOXOOOXOOOOOOXOOOOOOOO
XXOXOOOOOOOOXOXOOXOOXXOOOOOOOOXXOOOXOXOOOOOOOOOOOXXOOOOOOOOXOOOOXOOOOXOOOOOXXOOOOOOOXOXOOXOXOOXOOXOOO
OOOXOXXOXOXXOOOXOXOOXOOXXXXXOOOOOOXXOOXXOOOXOXOOOXOOXXOOOOXXOXOXOOOOOOOOOXXOOXOOOXOOOOOXXOOXXOXOOOOOX
OOOXOOOXOXOOOOXXXOOOOOOOOXOOOXOOOOOOOOOXXOXOOOXXOOXXOXOOOOOOXOOXOOOXOOOOOOOOOOOOOXOOOXOOOOOXOXXXOOOOO
OOXOXXOOOOOXXXOOOOXXXXOOXOOOOXXOOOOOXOOOOOOXXXOOXOOOOOOOOOOOOOOOXOOOOOOOOXXXOOOXOOOXOOOOXOOOXXOOXOXXO
XOOOOOXOOOXOOOOOOOXOOXOOXOOXOOXXOXOOOXOOOOOOOOOXOXOOOOOOOOXXOOOOOXOXXOXXOOOOOOXXXOOOOOOXOXOXOOXOOOOOO
OOOOOOOOXXXXXXOOOXXOOOOOXOOOOXXOOOOOOOOXOOOXOOXXOOOXXOOXOOOOOOOOXOOOOOXXOOXOXOOXXOOXOOOXOOOOOXOXOOXOO
OXXOOOOOXOOOOXOOOXXOOOOOXOXOOOOOOOOOXOOOXOXOOXOOXOOOOXXOXOXXXXOOOOOXXOOOOOOOXXOOOXOOOXOOXXOXOOOOOOOOX
OXOOOXOXOOOOOOXOXXOOOXXOOXOXOOXXOXOXXOOOXXOOOOXOOOOOOOOOOXOOXXOOXOOOXOOOOOOOXXOOOOOOOXOXOOXXOOXOXOXXX
OOXOXOOXXOOOOOOOOOOOOOXOXOOXOOOOOOOXOOXOXOXOOXXOXOXOXOOOXXOOOXOXOXXOOOOOXOOOOOOOXOOOOXOXOOOXXXOOOOOXX
OXOOOXOOXOXOOOOXOXOOOOXOOXOOOOXOOOOOOOOOOOOOXOOOOOOOOXXOOOXOOOXXXOXOOXOOXOOXOOXOXOOXOOXOOOOOOXXXOXOXX
OOOOXXOOXOOOOXOOOOOOXOXXOOOOOOXOOXOOOOOXOOXOOOOOXOOOXOOOOOOOOXOXOOOOXOXOOXOXOOOOOXXOOOXXOOOOOOOOXXOOO
OOXOXOOXXXOOOOOOOOOOXOOOOXXOOXOOXOXOOXOXXOXOOOXOOOOXOOOOOOOOOOOOOOXXXOOXXOOXOOOXOOOOXXOXOOOOOXXOOOOXX
OOOOXXOOOOOXOOXOOXXOXOXOOOOXXOOOOOOXXXOXXOOOOOOOOXOOOOOXXOOOOXOOOOOOOOOOOOOOOOOOOOOOXOOOOOOOOXOOOOXXO
OXOOOOXXOOOOOXOOOXOXOXOXOXOXXOOOOOOXOOOOOXOOOOOOOXOXOOXXXXOOXOOOOOOOOOOOOOOOOOXOOOXOOXOOOOOOOOOOOXXXO
OXOXOOOXXOOOXOXXOOXXXXOOOOOXOOXOXOOXOOOXOOOXXXXOXOOOXXOOOOXXOOOOOXXOOOOOOXOOOOOOXOOOOOOXOOOOOOOOOOOOO
OOXXOOOOXOXOOXOXOOOOOXOOXOOXXOXOOOOOXXOOOOOOXXOOXXOOOOXOOOOOXOOOOOXXXXOOOOXOOXXXOOOOOOOOXOOOOXOOOXOOO
OOOOOXOOXOOOOXOOOXOOXOOXOXOXOOOOOXOOOXOOXOOOXXOOOOOOOOOOXOOOOOOXOOOOOXXXOOOXOOXOOOOOOXOOXXXOXOXOOOXOX
XOOXOOOOOOOXOOOOXOXXXOXOOOOOOOXOOOXOOXOOOOOXOOXOOOXOOOXXOOOXOOXOXOOXXXXOOOOOOOOXXOOOOOOXOOOOXOOOOOXXO
XXOOOOOOXOXXOXOOXOOXXXOOXXOOOOOOXOOOOOXOOXOOXOOOOXXXOOOXOOOOXOOXOOXOXXOXOOOXOOOXOOXOXOOXXOOOOOOOXOOXO
OOXXXXOXXOOXXOOXXOOOOOOOOOOOXOOXXOXOXXOOOOOOOXOOXOOOXOXOXXOOOOOOOOXOOOOXXOXOOOOXXXOOOXOOOOOXOXOXXOOOO
OXOXXXOOOXXOOOOOOOXXXOOOXOOOXOOOOXOXXXXXOXXOXOXXOOXOOXOOOOXOOOXOOOOOOOOOOOOXOOXXOOOOOOOOXXXOXOOXOOXOO
XXOOOOOXOOOXOOOXOOOOOXXXOOOXOXOOOOOOOOOOOOOOXOOOOOOOOOXOOOXOOOOOOXXOOOOOOOXOOOOOOOOOOOOOOXXOOXOXXOOOX
OOOOOXOOOOOOXOXOOXOOOOOOOOXOOXOOXXXOOXXOXXXOXXXXOXXXOOOOOOXOXOXXOOOOXXOOXXOOOOXXXXXOXOOOOOOXXXOXOOOOX
OXOOOOXOXOOOOXOXOOXOOOOXOXOOOXOOOXXOOOOOOOXOOOOOXXOXOOOXOXOXOOXOOXXOXXXOXOOOXXOOOXOXOOXOOOOOOXOXOXOXO
OXXOOOOOOXOOOXOXXOXOOOOOOOOOXXOXOOXOXXXOOOOOOOOOOOXXXOOXOOOOOOOXOOXOOOXXOOXOXXXXOOOOXOOOOOOOOOXOOOXOO
XOXOXOOOOOOOOOOOOOOXOOOOOOXOOOXXOOOXOOOOOOOOOXXOOOXOOOXXOOOOOOOXOXXOOOOOOOOXOOOXOOOOOXOXOOXOOOXOOOOOO
XOXOOOOOOOOOOXOOOXXOOOOOOOOOOOOXXXOOXOXXOOXOXOOOOOOOOOOOOXOOOXOOXOOOOOOOOXOOOOXOOOXXOOXOOXOXOOXXOXOOX
OXOOOOOOOOOOOOOOOOOOOOXOXXOOXXXOOOOOXOOXOOOOXOOOOXXXOOXXXOOOOOOOXOOOOOXOXOOOXOXXOOOOOOXXXOOOXXOOXOOOO
OOOXOXOOOOXOXOOOOOOXXOOXOOOOOOXXOXOOOXOOXOXOOOOOXOXOOOOOOOOOOOXOOOOOOOOXOXOOXXXOOOOOOOOOOOOXOOOXOXXOO
XXOOXXOXXOXOOXOXOXOOOOOOOOXOOOOOOOOOOOXOXOXOOOOXOOOOOOXOOXXOOOOOOXXOOOXOOOOOXOOXOXXXOXXOOOXOOOXOXOXXO
XOOOOOOOOOOOOOOOOXOXOXOXXOOOOOXOOOOOOXOOXOXOXXOOOOOOXOOXOOOOXOOXOOOOOOOXOOXOOOOOXOOOOXXOOOXOOOXOOOXOO
OOOXOOOOOOOOOOXOOOOXXOOXOXOOOOXOOOXOOOOOOXXOXXOOOOOXXOXOOXOOXXXOXXOXXOXOXOOOOXOOOXOXOXOXOOXOOOXOOXOXO
OOOXXXXXOXOOOOOOOOXOOOXOXOXXOXOOOXXOXOXXXOXOXOOOOOOOXXOOOOOOOXXOOOOOOXOOOOOOOOOOOXOOOOOXOXOOOOXOOOOXO
OOXOOOXOOOOXOXXOOOXOXXOXOXOOOOOOOOOOXXXOOOXXOOOOOOXXOXXOOOXOOOXOOOOOXXOOXOOXXOOOOOOOOXXOOXOXOOOOOOXOO
OOOOOOXXOOOOOOOXOOOOOOOOOOXOOOOOOOXXOXOXOXOOOOXXOOOOOOOXOXOOOOOXOOOOXOOXOOOOOXOXXXXOOXXOOOOXOOOOXXOOX
OXOXOOOOOOOOOXOOOOXXOOOOOOOOOXOXOXXOOOOXOOOOXXOOOOOOOOXXOOOXOOOOOOOXXOOXOOXXOOOXOOOXOOOOXOOOOXXXXOOOX
XOOOOXOOXOOOOXOOOXOOOOOOXOOOOXXOOXOOOXXOXOXOOOXXOOOOOOOOOOXOXOOOOOXOXOOOOOXOOOOXOXOOOOOOXXXOOOOOOOOOX
XOXOOOOXOXXOXXXXOOXOXXXXOOOXOXOXOOOOOOOXOXOXOOOOXOOXOOXOOOOXOXOXXOXOOOOXOOOXOOOOXOOOXOOOOOOOOOXXOOOOO
OXXOOOOOXXOOXOOXOOOOOOOXOOXXOOOXOOOXOXOOOOOOXOXOOXOOOOOXOOOOOOOOOXOOXOOOOOOOOOXOOOOOOXOXXOOOOXOOOXOXX
OOOXOOOXOOXOOOOXXXOXOOOXOOOXXXOXXXOOOOXXOOXOOOXOOXOXXOOOXOXOXOXXOXOOOXXOOOOXOOOOXOOOOOOOXOXOOOOXXOXOO
OOXOOXXOXXXOXXOOXOXOXOOOOOOOXXOOOOOOOOXOOXXOXXOOOOOOOOOXOXXOXOXOXOXXOOOOXXXXXOOXXOOOXOOOXOXXOXXOOXXXO
XOOOOOOOOOXOOOOOXOOOXOOOOOXOXXOOOOOXOOOOXOOXXOOOOOOOOXOOXOXOOOXXOOOOXOOOXOOOOOOOOOOOOXOXOOXXOOOOOOOOO
OXOOOOOXXOOXOXOOXOOOOOOXXOOOXOOXOOOOOOXOOOXOOXOOXOOOOXOOOOOOOOXOOOXOXXXOOOOOXOOOXOOOOXOOOOOXOXXOXOOOX
XOOOOOXOOOXXOOOOOOXOXOOOOOOOOOOOOOXOOOOOOXXXOXOXOOXXOOOOXOXXOXXOOXXXOOOXOOOOOXOXOOXOXOOOOOXOOOXOOXOOO
XOOOXOOOOXXOXOOOOOOOOOOOOOOXOOXOOXOXOXXOXXOOOXOOOXXXOXOOXOOXOXXXOXOOOOOXOXOOOOXOOOOOXOXXXXOOOOOOOOOXO
OXOXXXOOOXXXOOXXOOXOOOOOOOOOOOXXOXOOOOOOOXOOOXXXOOXXOXOOOXOXXXOXOOXOOOOXXXOOXXOOXOOOOOOOOXOOXOXOXXOXO
OOOOXOXOOXOOOOOOOOXOOOOOOOOOOXOOOXXOOXOXOOOOOOOOOOOOOOOOXOOOOOOXOOXOOOOOXOOOOOXOXXOXOOOXOOXOOOOOXXOOX
XXOOXOOOXOXOOOOOOOOOOOXOXXOXOOOXOOXXXOXXOXOXOXXXOXOOOOOOOOXOOOXXOOOOOXOXXXOOOOOOOOXXXOXXOXOXXOOOXXXOO
OOOXOOOOXOOOXXOOXOOOXOOOOOXOOOOXXOOOXOOOXOXXXXOOXOOXXOOOXOOOOOOXOOOOOOOOXOOXOXOOOXOXXOOOOOXOOXOOXOOOO
OXOXOXOOXOOOOOXOOOOOOOXOOXXOOOOOOXXOOOXXXOOXOOXOOOOOXXOOXOOOOOXOXXOOOOOXOOOOXOOOXOXXOOOOOOOOOOXXOOOXO
OXXXOXXOOXOOOXOOOOOOOOOXXOOOOOOXOOXOXOOOXOXOOXOOOOXXOOOOXOOOOOOOOXOOOOOOOOOOOOOOOOOOXXXXOOOOXOOXOOXOO
OXXOOOXOOOXOOOOOOOOOXOOOOOOOXOOOOOOOOOOXOOXXOOOOXOOOOOOOOXOOOOXOOXXOXOOOOOOXOOOXOOXOXOOOOOOOOOOOOOOXO
OXOOOOOOOXXOOXXOOOOOOXOXXOOOOXOXXXXOOOOOOOXXOOXXOOXOOXXOOOOOOXXXOOXXOXXOOXOOXOXXOXOOOXOXOOOXOOOOXOOOX
XOOOOOXOXOOXXOOXXXOXOOOOXXOOOOOXOOXOOXXOOXXOOOOOOOXOOOOOXOOOOXOOOXOOOOOXOXXXXOOOOOXOOXXOOOOXOOOXOOXOO
OOXOOOXOOOOOOOOOXOOOOOOOOOOOXOXXOOOOOOXXXXOOOOOXOOOXOOOOOOXXOOOXOOOXXXXOXOXOOXOOOOOOXOXOXXXOXOOOOOXXX
OOOOOOOXOOOOXOOXXXOOXOXOXXOOOOXOOOOOOXOOOOOXXOOXXXOOOXXOOOOOXOXOOOOOOOOXOXOXOOOOXXXOOOOOOOOOOOOXOXXXO
OOOOOXXXOOOXOOXOOOOOOOOOXOOXXOOOOXXXXOOOOXOOOOXOOOXOOOOXOOXOOXOOOOOXXOOOOXOOOOOOXOOXXXXOOOXOXOXXOOOXX
XXOOOXOOOOOOOOOOXOOOOOOXOOOOOXOOXOOOOOXOOOOOOOOXXOOOOOXOOOXOOXOOOXXXXOXOOOOOOOOOOOOOOXXOOOOOXOOOXOOOO
XOOOXOXOXXOXXXXOXOOXOOOOOXOOXOOOOOXOXOOOXOXXOXOOOXOXOOOOOXOOXOOXOXOXOOOXXOOOXOXXXOOXXOXXOOOOOOOOXOOOO
XOOXOXOXOOOOOXOOXOXOXOOXOXOOOOOOXXOOOOOOOOOXOOOOOOXOOOXXOXXOOOOOOOXOOOXOOXOXXOOOOOOOXXOOOOOOOOOXOXXXX
XOOOOOOOXOXOXOXOXOXXOOOOOXOXXXXOOXXOOOXOOXOOXOOOXXOOOOOOXOOOXXOXOOOXOOOOXXXOOOOOOOOXXXOXXOXOXXOOOOOOX
OOOOOXOOOOOXXOXOOXXXOOXOOOOOXXOOOOOOOOOXXOXOXOOOOOOOOXXXOOOOXOOOXOXOOXXOOOOXOOOOOOXXOOOOXXOXOOOOXXOXO
XOXOOOOOXOOOOXXOOXOOOOXXXOXXXOXOXOXXOXOOOXOXXXXOOOOOXXOOOOOOXOOOOXOXOOXXOXOXOXXOXOOOXXXXOOOOXXXOXOOOX
