OOXOXXOXOXOOOXOOOOXXOOXOOOXOXOOOOXOOOOXOXXOOXOXOOXXOXOOXXXOOOXOXOXXXOXOOOXOOOOOOOXOOOOOXOOOOXXXXOXOOO
OXOXXOOOOOOOXOOOXXXOOOXOXOOOOXOOOOOOOOOOOOOXOOOXXOXXXOXOXOOOXOXOOOOOOXXXOOXXOOOXXOOXXXOOOOOOOOOOXOOXX
XOOOXOOOOOOOOOXXOOOOOXOOXXOOXOOOOXXXXOXOOOOOOOOOOXXOOOXXXOOOOOOOOOXXXOOOOXOOOOOXOXOOOOOOOXXOXOOOOXXXO
OOOOOOOOOXOOXOOOOOXXXOOXOXOOOOXXXXOOXOXOOXOOXOXOOOOOXOOOXXOOOOXOOOOXXOOXOOXOXXOOXXOOXOOOOOOOOXOXOOOOO
OXXXOXOOOOXXXXOOOOXXOOOOOOXOOXXXOOXOOOOOOOOOOOOXXOOXXOXOOXOOXXOXOOOXOOOOXOOOXXOOXOOXXOOXOXXXOOOOOXOXO
XXXOOOXXOXOOXOOOOXXOOOOXOOOOOXOOXXXOOOOXOOOXOXOOOOOOOOOOOOOXOXOXOOXXOOOOOOOOOOOXXOXXOXOOOXOXOXXOOXXOO
XXOXXOOOOOOXOOOXXOXOOOOOOOXOOXOOOXOOOOOOOOOXXOXOOOXOOOOOXXOOOOOXOOXOOXOXOXXOOOOOOOOOXXXXOOOOXOXXOXXOO
XOXXXOOOOOOOOOOOOOXXOOOOXOOOOXXOXOXXXXOOOXOOXXXOXOOXOXXXOXOOOOOOOOOXOOOOOOOXOXOOOXXOXXOOOOOOXOXXXXXOX
OOOOXXOOOOOXOOOOOXOOOOOOOOOOOOOOXOXOOXOOOOXOOXOOOXOXXOOOOOOXOXXOXXOXOOXOOOOXOOXXOOOOOXXXOXXOOOOXOOOXO
OXOOXOOOXXOXOXXOOXOOOOOOOOOOOOOOOOOOOOXOOXOOOXOXOOXXOXOOXOOXOXOXOXOXOOXOXXOOXOXXOOXOOOOOOXOOXOXOOXOOO
XOOOOOXOOOOXOOOOXOXOXOXOOXXOXOOXOOOXOXOOXOOOXXOOOXOOOOOOXOXXOXXOOOOOOOOOOOXOOOOXOOOOOXOOXOOOXOOXOOOOX
OOOOOOXOOXXXOOOOOOOOXOOOOXXXXOXXOXOXOOXXOXOOOXOXOOXXOOOXOXOOOXOOOOXOXXXXOOOOOXOOOOXOOOOXOOOXOXOOOOXOO
OXXOOXXOOXXXXOOOXOXXOXOOOXXOOOXOXXXOOOOOOOOXXOXOOXOOOOOOOOXXOOXOOOOOOOXOOOOOOOXOOXOOOOXOXOOXXOOXXOXOO
OOOOXOOOOXOOOOOXOXXXOXOXXOOOOXOOXOOXXXXOOOOOOOXOOXOOXOXXOOXOXXOOOXOXXOXOXOOXOOOOXXOOOXOOOXOOOOOOOOXOX
OOXXOXOOOOXOOXOOXXOOOXOOXOOXOOXOOXOOOOXOOOOXOOOOOXXOOOXOOOOXOOOXOOXOXOXXOOOXOXOOXOOOOOXOOOOXOOXOXOXXX
XOXOOOXOOXOXXXOXOOXOOXOXOOOXXXXOXXOOOOOOOXOOXXOOOOOOOOOOOOOXXXOXOXOXOOOOOOOOOOOXOOOOOOXOOOOXOOOOOOXOO
XOOXOXOOOOOOOXXOOOOOOOOOOOXOOXOOOOXOXOOXOOOOXOOOXXOOOOOXXOOOXOOXOOOOOXOXOXOXOOOXOXOXOOOXXXOOOOOXXOOXO
OOOOOOXXOOOOOOOOOOOOXXXOOOXOXOOOOXXOOOOOOOOXXOOOXOOXOOXXXOOOOXOOXOOOOXXOXOXOOXOXOOOOOOXXXOOOOOOOOOOXO
XOOXOOOOOOOOOXOXXOOOOOOXOXOXOXOOOOXOXOOXOOOXOOOOOOOOXOOOOOOOXXOXOOOOOXOXOOXXOOOOOOOXXOXOOOOXXXOXOOOOO
OOOOXOOOOOOOOXOOOOOOXXOOOOOXXXOOXXOXXOOOOOOOOXOOXOXXOXOOOOOOOOOOXOOXXOOOOXXOOOXXOXOXOOXOXXOXOXXXOOOOO
OXOXXOOXOXOOOXOOXOOXOOOOXOOXOOOOOOOOOOXOOXXOOOXOOXXOOOXOXXOOXOOOXOOOOOOOXXOXXXOXXOOOXOOXOXOOXXOOOOOOO
XXOOOOXXOXOOOOOOOOOOOXOXOXOOOOOXOXOXXXXXOOOOOOOOXOXOOXOOOOXOXOOOOOXOOOOOXOXOOOOOXOOXOOOXOOOOOXXXOOOOO
XXOOOXOOOOXOOOXOOXOXOOOOOXOOOOOOOOOXOOXOXOOXOOOOOOOXXXOOXXOOOOXOXOOOOOXOOOOOOXOOXXXOXOOOOXXOXOXOOXXOO
OOXOXXOOOOXXXOXXOOOXOOOXOXOOOXXOOXXOXXOXOOOOXOXOOOOOOOOXOOXOOOXOXOOXOOOOOXXOOOXOOOOOOOXXOOOOOOOOOOOXO
OOOXOOXOOOOOXOXOXXOOOOXOOOOOOXXXOXOOOXOOXOXXOXXOOXOOOXXOXOOOXOOXXOOOOOXOXOXOOOXOOOOXOXXOOOXOXOOOOOOOO
OOOOOOOOOXOOOXOOOXXOXOOOXOXOOOOXOOOOOOOOOOOOOOOXXOOOOOOXXOXOOOXXXOOXOOXOOOXXOXOXXXXXOOOXOOOOOOXOOXXOO
OOXOXXOOOOOOXXOOOOOOOXXOXOOXXOOOOOOOOOOXXOXOXOXXOOOXOOOOOOXOOOXOOXXXXOOOOOOOOOXOOOOXOOOOOOOXOXOOXOXOO
OOXXOOXXOOOOOOOOOOOXXXXOXOOXOOOXXOOXXXOOXXXOXOOXOOOOXOXOOOOOXOOXOXOXOXOXOXOOXXOOOOXOOXOOOOXXOOOXOXOOO
OXOOOOXOOOOXOXOXOOXOXXXOOOOOOOXOOOXOOOOOOOOXOOOXOOOOOOOOOOOOXOOXXOXOOOOXOOOOOOXXOXXOXOOOOOXOXOXOOXXXO
OOOXXOXOXOOXOOOOXOXOXOXXOOOXOOXXXOOOOOOOXOOXOXXXXOXOXOXOOOXOOOOOOOOOOOOOXOOXOOXOXOOXOXOOOXOOOXOOOOOOO
XOXOOXOXOOOXOOXOXOXOXXXXOOXOXOOXOOXXOOOOOOOOXOOOOOOOOOOOXOOOXOOOOOOOOXXXXXOOOXXOOOOOXOXXXOOOOOOXOOOOX
XOOOOXOOOXOXXXOOXOOOXXOXXXOOOOOOXXOOOOOOXOOXOOOOOXXOOOOOOOXOOOOXXOOOXOOOOOOOOOOXOOOXOOOOOXXOOOOOOOOXO
OOOXOXXOOOOXXOOOOXOXXOOOOOOOOOXOXOOOOOOOOXXXOOOOOXOOOOOOXOXXXOXOXOXOOXXOOOOOOOXOOOOOOOOOXOOXOOOOOOOOX
XOOOOXXXOOOOOOOOOOXOOOXOOOOXXOXXOOOOXOOOOXXOXOOOOOXOXXOOXOXOOXOXOXXOOOOOOOOOOOOOXOOOOXXOXOOXOXOOXOOOO
OXOOXXOOOOXOOOXOOXOOOOOOXOOOXOXOOOOOOOOXOXOXOXOOOOOOOXOOOOOOXOOOOOOOOOXOOOOOOOOOXOOOOXOXOOOXOXXOOOXXO
XOOXXOOOXOXOOXOXXXXOOXXOOOXOXOXOOOOOXXOXOOOOXOOXOOOOOOOOOOOOOXOXOOXOXOOOOOXOOOXOOOOOOXOXOOXXOXOOOOXOO
OOXXOOOOOOXOXOOOOOOOOOXOOOOOOOOOOOOOXOXOXOOXXOOOOOOXXXOXXOXXOXOXXOXOXOOOOOOOOOXOXXOOXXOOOXOOXOXXXXXXO
OOOXOOOOOOXXOOOOXOOOXOXOOXOOXOOOXXOOOOOOOOOOOOOOOOXOXOXXOXOOXOOXOXXXOOXOOXXXOOOXOOOOXOOXOOXXXOOOXOOOX
OOOXOOOXOOXXXOOXOOXXOXOOOOOOXOOOOOOOXXOOOXOOOOXOOOOOOOXOOXOOOXOXOXOXOOOOOOOOOOOOOOXXXXOOOOOXOOXXOXXOO
OXOOXOOOOXOOOOXOOOOXOOXOOXOOOOOOOXOOXXOOOOOOOXOOOXOXXXOXXOOOXXOOOOOOXOOOXOOOOOXXXXXXOOOXXXOXOXOOOOOOO
OOOOOOOXXOOOOOOOOOOOOOOOOOOOOOOXXXOOOOOOOOXOOOXXXOOOXOXOOXOOOOOOOOOXOOOOXXXOOXXXOOOOXOOOOOOXXOOOOOOOO
OOOXOXOOOOOXOOOOOOOOOOOXOOOOOOOOOOOXOXXOOOOOOXOOOOOOOOOOOXXOOOOOOXOOXOOOOOXXOOOOOOXOOOXOOOXXXOOXOXOOX
XOOOXOXXOOOOOXOOOOOOOXOOXOOOOOOOOOXOOXOOOXXOOXOXOOXOOXOOOOXOXXXXOOXOOOOXOOXOOOOOOOOXXOOOOOOOOOOOOOOOO
XOXOOOOOOXOOOOOXOOOOOXXOXXOOXOXOXXXOXOOOOOOXOXOXOOOOOOXXXOXXXOOOXXOXXOOXOXXOOOXOOXOOOXOOOOOOOOOOOOXOO
OOOOXXOXOOOOOXOXXXOOOOOOOOOOOOOOOOOXOXOOXOOOOOOOOOXOOOXXOOXXXXXXOOOXOOOXOOXXOXOOXOOOOOXXOOOOOOXOXXOOO
OOOOOOOXOOOOOOOOXOXOXOOOOXOOOOXOOOOOOXXOOOOXXXOOXOOOXOOOOOOXOXOOOOOOOOOOOOXXXXOOXXOOOOOOOOOOXOXOOOXXO
OOOOOOOXOXOOXOOXXOOOOOOOXXOXOXOOOOOXOOXOOXXOOOOOXXOOOXXOOXOOXOOOOOOOXXXXXXXOOXOOOOOOOOOOXXXOXXOOOOXOO
OXOOXOOOOXOOXXOOXOOOXOXOOOXXOXOXOOXXOOXXOOXXOOOOOXXOXOXXXXOOOXOOOOXOOXXOOXOXOXOOOOOOOXOOXXOOXOOXXXXOX
OOOOOOOXOOXXXXXOXOOOOXXXXOOXOOXXOOOOOXOOOOOXOOXOOXOOOOOOOOXOOOOOXOOOOOOOOXOOOOOOXXOOXOOXXOOOOOOOOOXOX
OOOOOOOXOOOOXOOOXOXOOOXXOOXOXOXOOOXXXOXXOOOOOOOOOOOOOXOXOXOXOOOXOOOOXOXOOXXOOXXOXOXXOXOXOXOOOOOXOXOOX
OOOOOOOXOOOOOOXOOOOOOOXXOOOOOXOXOOXOOOOXXOOOXOOOOOOOOOXOOXOOOOOOOXXOOXOOOOXOXOXOXXXOOOOXXOOOOXOXOOXOX
XOOOOOOOOXXOOOOOOOOXOXOXOOOOXOOOOOOOOOOOXOOXXXOXXOXXOOOOOOOOXOOOXXOOOOXOXOXXOXOOXOOOOOOOOXXOOOOXXOOOO
XXXOOOXXOOOXOXOOXOOXOOOXOXXOOOXOXOOOOOOOOOOOOOXOOXOOOOXOOXOOOOOOOXOOOXXOOOOXOXOOOOOOOOOOOXOXXXOOOOOXX
OOOOOOXOXOOXOXOOOOOOOXOXOXXOOOXXOOOXOXOXOXXOOOOOOOXOOXXOXXOXOXOOOOOOXOXXXOXOOOXXOOOOOOOOOOOOXXXOOOOOX
OOOOXOXXOOOXXOOOOOOXXOXXXOXXXXOOOXOOOXOOOOXXOOOOOXOOOOOOOOXOOOOXOOOOOOXXOOXOOOOOOXOXOOXXOOOOXXXOXOOOX
XOOOOOOOXXXOOOOOXOOOOOOOXOOOOXXOOOOOOOXOOOOXXOXOOOXOOOOOOXOOXOOOXOOOOOXOOOOXOXOXOOOOOXOOOOOOXOOOXXOOO
OXOOXXOOOXXOOOOOOXOXOOOOOXXXXOOXOOXOOOOOOOXOOOOOOXXXOOOOOXOOOXXOOOXOOOXOOOXOOXOOOOXXOOOOOOXXOXOOOXOOX
OXXOOOOOOOOXXOOXOOOOOOOOXOOOOOOXOOOOOOOOOXXOOXOOXOXXOXOOOOOOXOOOXOOOOOOXXXOOOXOOOOOOOXOOOOOOOOOOOOOOX
OOXOXXOOOOXOOOXOOOXXOOXXOOXOOXOXOOOXOOOOOOXXOOOXOOXXXOOOOOXXOXOOOOOOOOOXOXOOOXOOOXXOOXOOXOOXOXOXOOOOX
OOOXOOXOOOOOXOOOOXOOOOOXXOOOXOOOOOOOOOOOOOOXOOOXOOOOOXOXOXOOOOOOXXXXOOOXXOXOOXOXXOXOOOOOXOOOOOXOOOXOO
OOXOOOOXOOXOOOOXXOXOOOXOOOOOOOXOOOOOOOXXXOXOOOXXOOOOXOXXXOOXOXOOXOOOOOOOOOXOXOOXOXOXOOOOXOXOOOOOOOOXO
OOOXXXOOXOOOOXXOXOOOXXOOOXXOOXXOOOOOXOOXOOOOOOOXXOOXOOXOOOXOXOOXOOOOOXOXOOXOXOXOXOOXOOOOOOOOOOOOOXOXO
XXOXXXOXOOOOOOOXOOXOOOOOOOOOOXXXOOOOOOOOOOOOOOOOOOOOOXOOXOOOOOXOXOOOXXOOXOOOXXOOXOOOOOOXOOOOOOOOXXOXO
OOOOOOOOOXOXOXOOOXOOOOOXOXOOXOOOOXOOXOOOOOXXOOOXXOOXOOXOXOOOXXOOOXOOOOXXOOOOOOOOOOOOOOOOOOOXXXOXOOOOO
OXOXXOOXOOOOOOOOOOXOOOOOOXXOOOOXOXOXOXOOOOOOOOXXOXOOOOOOOXXOOOXOOXOOOOOOOXXOOXXOOOOXXOXOXOOOXXXOOXOOX
XOOXXOOXXXOXOOXXOXXXXXOOOXXOOOOXOOOXOOOOOOXXOOOOOOOOXOOXOXOOOOOXOOOXOOXOOOOOOOOOOXOOOXOOOOOOOOOXOOXOO
OXOOOXOXOOOOXXOOOXXOOXXXOXOOOOOOOOXOOOOXOOXOXOOOOOXOXOOXOOOOOXOOXXXOOOOOOXXOOOXOXOOOXOXXXOXOOOOOXOOOO
OOOOOOOOOOOOOOOXXOXOOXOOXXOOOXOOOOOOOXOOXOOOOXOOXOOOOOXOXOOOOXOXXOOOOXOOXXXOOXXOOOXXOOXOXOOOXOOXOOOOO
OXOXXXXOOOOXOOOXXOOXXOXXOOOXXOXXOOOOOOXOOOOXOOXXOOOOOOOOXOXOOXOOOXXOOOOOOXXOOXXOXXOXOOOOOOOOOXOOOOOOX
OXOOOXXXOOOOOXOOXOOOOXXOOOXOOOOOOOXOOOXOOXOOOOOXXOXXOOOOXOOOXOOOXXXOOXOXOXOOXOOOOOOOOOOOOOXOOOXOOOOOO
OOXXOOOOXOXOOOOXXOXOXXOXXOOOXXOOOOOOOXXOOOXOOOXOOXOXOOOOOXOOXOOXXXXOOOOXOXXXXXXOXXOOOOXOXOXOOOOXXOOOO
OOOOOOOOXOOXOOXXOXXOXOOXOXOOOOOXOOOOOXOOXXOOXXXXOXOXOXOOOOOOXOXOOXXOOXXOOOOOOXOOOOOXXXXOOOOXOXXOXOXOO
OOXOOXOOXOOOOOOOOOOOOOOXOOOOXOOOXOOXOXOXOXXXOOOOOOOOOOXOOOXXOXOOOOOXOXOOOOOOOOOXOOOOOOOXOXOOXOXOOXOOO
OOOOOOXOOOOOOXXOOOOOOOOOOXOOOOOOXOOOOOOOOOOXOOXXOOXOOOOOOOOOXOXOOOOOOOOXOOOXXXOOOOOOOOXOOXOOOOOOOOOOX
OOXXXOOXOOOXOXXOOXXOOXOOXOXOOOOOOOXOOOOOXOOXXXXOOOOOOOOOXOOOOOOXOOXXOOOOXXOOOXOOOXOOOXXOOXOXOXOOOOXOX
OOOXOOOOXOXOOXOOOOXXXOOOXOOOOOOOOXOOOOOOXOOXXOOOOOOOOOOOOXOOOOOXOOOOOXXOXOXXOOOOOOOXXOXOXOXOOOOXXXXOO
OOXOOOOOOOOOOXXXOXXOOOOOXOOXOXXOXOOOOXOOXOOOOOOOXOOXOOXOOOXXOXOOOOOXOXOXOXXOXXOOOOOOXOXOXOXOOOOOOOOXO
OXXXOXXXOXOOXOOXOOOXOOOOOOXOOOOOOXOXXOXOOOOOOOOOXOOXXOOOOOXOOOOOXOOOOOOOOOOOXOXOXXOOOOOXOXXOXOOXXOXOX
OXOXOXOXOXOXXOOOOXOOOXOOOOOOXOOOXOOOOXOOXOXOOOOOOXOOOOOOXOOOOOOOXOOOOOOXXXOOOOOOOXOOOOXXXOOOOOOOOXOOX
XXXOXXXOOXOXOXOOOOOXOOXXOOOOOOOXOOOOOOXOOXXOOXOOXOOOXOOOXXXOXXOOOOOOOOOXOOXOXOXOOOOXOOOXXXOOXOOOOOXXX
OXOOOXOOOOOOOXOOOOOOOOOOOOOOXXOXOOOXOOXXOOOOOOOXOXOXOOOOOOOXXOXXXXOOOOOOOOOOOOXOOOOOOOOOOOXOOOXOOOOOX
OOOOOOOOOOXOOXXOOOXOXOOOOXXOXOOOOOOXOXOOXOOOOOOOOOXOOXXXOOOXXOOXXOOOOOXOOOOOOOOOOOXOXOOXXOOOOOOXOOOOO
OOOXOOOXOOXOOOXOOOXOOXOOOOOOOOOOXOOOXOXOXOOXXOOXOXXOOOOXOOXXOOOXOOOXOOXOOOOOXXOOXOXOOOOXOOXXOOXOXOOOX
OOOXOXOXOXXOOOOXXXOOOOOOOOOXXOOOXOOOOOOXXOOOOOXXOOOXOOOOXOXOXOXXOXOOXOXXOOOXOXOOOXXOOOOXXOOOOOOOOXOOO
OOOOOOOOXXOOOOXXXXOXOOOXOXOXOOOOOOOXXOOXOOOXOOOXXOXOXXOOXOOOOOOOOXOXOOOOOOOOOOOOOOOOOXOXOOOOOOOXXOOOX
OXOXXOXOOXOXOXOOOXOOXOOXOOOOXOOOOOOOOXOOOXOOOOOOOXXXXOOXOXOXXOOOXOOOXOOOXOOOXOOOXXOXOXXOOOXXOOXOXXOOO
XOXOXXXXOOOOOOOXOXOOOOOXOOOOOOOXOOOOOXOXOOOOOXXXXOOOOOXOOOXOOOOOXXXXXOOOXOOOOOOOXXOOXOOOOOOOOOOOOOOOO
XOXOXXXXOXOOOOXXOOOOOXXOXOOOOXOXXXOXXOOOOOOOOOOOOOOOXOOOOOOOOOOOOOXXOXOOOXXOOOXOOOXOOXOXOOOXXXOOXOOOX
XOOXOOXOXOXOOOOOOOOOOXOOXOXOOXOOOXOOXOOOXXOOOOXOOXOXXOXOOXOOOOOXOXOXOOOXOOOOXOXOXOOOOOOXOOOOOXOOOOOOX
OOXXOXOOXOOOOXXXXOXXXOXXOOOXOXOXOXOOOOOOOOOOXOXOOOXOOOXXOOOOOOXOOOOOXOXOOXOOXOOOOXOOXXOOOXOXXOOOOOOOO
OOXOOOXOOOOXXOXOXOOOOXOXXOOOOOOOOXOXOOXOOXOOXOXXOXOXOOOOOXXOXOOXXOOOOOXXXXXOOXOOXOOOOOOOOOOXXOOXOOXOX
XXOOOXXXXXXOOOOOXOXOXOOXOXOOOOXXXOOXOOOXOOOOOXXXOXOXOOOOOOOOOOOOOOXXOOOXXOOOOOOXOOXOOOXXOOOOOOOOOXOXX
OOOXOOOOOXOOOOOOXOOOOXOOOOOOXXOOOOOXOOXOXOOOOOOOXOOXOOOOOOOOOXXOXOXOOXOOOXOXOOOOXOOXOOXXOOXOOOOXXXOXO
XOXOXOOOOXOOOOXOXOXOOOOXOOOXOOOXOXOOOOXOOXXOOOOOOXOOXOOOOXXXOOOOOOOOXOOXOXOXOOOXOOXOOOOOOOOOOXOOOXOOO
OOOXOXXOOXXXOOXOXOOOOOOOOXOOOXOOOOXXOOOXOXOXOXOOXOOXOOOXXOXOOOOOXXOXOOOXOOOOOXXOXOOOOOXXOOOOOXOOOOOOX
OOOXOXXOOXXOOXXXOOOOOXOXOXOOXXXOOOOOXOXOOXOXOOXOOOOOOXOOOXOOOOOOOOOOOXXXOOOOOOOXXOOOOOXXXOOOOXOOOOOOO
OOOXOXXOOOOXXXOOOXXXOXOOOOXOOOOOOOOOOOXOOXOXOOOOXOOOOOOXOXOOOOOXOXOXOOOOOOOXOOOOOOOOOXXOOOOOOOOOOOOOX
OOOOOXXXOOOOXXOXOOXOXOOOOOOOXOOOOOOOOOXOXOOOOOOOOXXOOOOOXXOXXOOOXOOOXOXOXXXXXOOXOOOOXOOOXOOOOOXXXOXOO
OOXXOOOXXOOOOXOOXOXOOXOOXXXXOOOOOOOOXOOXOXOXXOXOXXXOXXXOXOOOOOOXOXOOOOXXOOOOOOOOOOXOOOOOXXXOOOOOXOXXO
OOOOOOXXOXXOOOOOOOOOOOXOXOXOOOXXXOOXXOOOOOXOOXOOOOXOOOOOOOOOOOXOOOXOOXOOOXOOXOOOOXOOOOOOXOXOOXXOOOOXX
OXXXOOOOOXOOOOXOOOOOOXOXOOOXOOOOXOOOOXOOXOOOOXOXOXOOOOXOXXOXOXOOOOOOXOOOOOOXOOOOOOOXOOOOOOOOOOOOOOXOO
