XXOXOXOXOOOOOOOOOXOXOXOXOOOXXOOXOXOOXOOOOOOXOOOXOXOOOXOOOOOOOOOOOOXXOOOXOOOOXOXXOOOOOOOOOOOOOOOOXOOOO
OOOOXOOOOXOOOXOOOXXXOOXXXOOOOOOXXOXOOOOOOXOXOOXOOOOOOOXOXOOXXOOXOOOOXOOOXOXXXOOOOOOOOOOOOOOOOOOOOOOOX
OXXOOOXOOOOOOOXOOXXOXOXXXXOXOXOOOOOXXXXOOOOOOOXXOOXXOOOOOXOXOOXOOXOOOOOOXOOOOOOOXOOOOOXOXOOXOOXXOOOOO
OOOXOOOXXXOOOOOOOXXOOXXXOOOOOOOXOOOOOOXXOOXXOOOOXOOOXOOXOOOOOOOOXXXXOOXOOXOXXOXOOXXOOOOOOXOOXOOOOOOOO
XOOXOOOOXXOXXOOOXOXOOXOXOXOOXOOXOOOOXOOOXOXOOOOOOOOOOOOOXXXXOOXXXXOOOOXOOOOXOXXOOOXXOXOOOOOOOOOOOOXXO
OXXOOXOXOOOOOOXXOOOOOOOOOOOOOOOXOOOOOXXXOXXOOXOOOOOXXXXXOXOXOOXOOOXOOOOXOXXOXOXXOXXOOOOXOOOXOXOXXOOXO
OOXXOOXOOOXOOOOOXXOXXOOOOXOOOXOOOOOOOOOOOXOOOOOOOOXOXOXOOOOOOOOXOXOOOXOOOXXOOOOOOOXOXOOXOXOOXOOOXOOOO
XOOOXOXOOOOXOOXOXOOOOOXXOOOOOXOOOOOXXOOOOXXOOOXXOOXXXXOXOXOXOOXOXOOOOOOOXOOOOXOXOXOOOOXOXOOOOXOOXOOOO
OOOOXOOOOXOOXOOOOOOXOOXXXOOXXOOOXOOXXOXOXOOOXOOOXOOOOXXOOXXXXOOOXOOOOOXOXXOOOOOOOOXOXOXOOOOOOXOXOOXOO
OXOOXOXOOOOXOXXXOOOXOXOOOOXOXOXXOXOOOOOOOXOOOOOXOXXOXOOXOOOXOOOXOOOOOXOXOOOOOOOXOXOOOOOOOOOOOOOOOXXOO
OOOXOOOXOOOOXXOOXOOOOOOOXOOOOXOXOXOOXXOXOOOOOOXOXXOOXOOOOOOOOOOXOOOXOOXXXOXOXXOOOOOOOOOOOOXOOOXOOOXOO
OXOOXOOXOOXOOOXXXXOOOOOOXOOXOOXOXOOOOXXOXOOOOXOXOOOOOXOOXXXXXXXOOOOXOOXXOOXOOOOOOXXOXXOOXOXOOOOXXXOOX
XOXOOXXOOXOOOOOOOOOOOXOOOXOOXOOXXXOXOOOOXOOOOXOXOXOOOOXXOXOOXXOXOOOXOXOOOXOXOOOOOOOOXOOOOOOXOXOOOOXXO
OOOOXOOOXOXOOXXOOOXOOXOOOOXOXOOOOXOXOOXOXOOXOOOOOOOOOOOOOXXXOOXOOOXOXOXOOOOOXXOOOXOOOXOXOOXOXOOOOOOOO
OOXXOOOOXOOOOXOOOOOOOOOOXOXXOOOOXOOXXOOOOXOXOOXOXOOXOOOXOOXOOOOOOOXOOOXOXXOOOOXOXOOOOXOOOOOXXOOXXOOOO
OXXXOOOXXOOXOOXOOOOOOOOXXOXOOOOOOXOOOOOOOOXOOOOXOOOOXXOOOXOOOOOXOOOOXXOXXOOXOOOOXOOXXXXOXOOOOOXOOOOOO
XXXOOXXOOXOOXOOOOOOXOOOOOOOOXOXOOOOXOOOOXOOOOXOOOOXOOXOOXXXOXOOXOOOOOXOOOOOOOOOOOOXOXXOOOOOOOOOOOOOOO
OXXOOXOOXOOOOOXXOOXOOXOOOOOOOOXXXOOOXXOXXOXOOOXOOOXOOXOOXOOOXOOOXOOOOOXOOOXOOOXXOOOOOOOXOXOXOXOOOXOOX
OOOOXOXOXOOOOOOOOXXOOOOXOXOOOXOOOXOOXOOXOOOOOXOOXOXXOXOOOXOXXOOXXXXOOOOOOOOXOOOOOOOXOXOXOXOXOOOOOOOOX
XOOOOOOOOOOOXXOOOOOOOOXOOOOXOOOXOXOXOOOOOOOOXOOOOOOOOXXXXOOXOOOXOXOXOOXXXXOXOOXOOXOOOOOOXXOXXOOXXOOOX
OOOOXOOOXOOOXOXOXXOOOXXOOOXOXOOOOOOOOOOOOOOOXOOOOOOXOOOOOOXOOXXOOOOOOXOOOXOOXOOOOOXOXXXOXXOOXOOXXXOOX
OXOOXXXOOXOXOOOXOXOXOOOOXOXOXOOOXOOXOXXXOOOOOOXOOOXOXOXOXOXOOOOOXXOOOOOOXOXXOXOOOOOXXXOXOOOXOOOXXOOOO
OXOXXOXOOXOOOXOXOOOXXXOOXXXOOOOOOOOOOOOOOXOXOOOXOOXOOOXOXOXOOOOOOXXOOOXOOOOOOXOXXXXOOOOOOOOXOXOOOOOOO
XOOXOXXOXOOOOXXXXXOOOOXOOOOOOOOOXOOOOOOOOOOXOOXOOOOOOOOXOOOOOOOOXXOXOOXOOOOOXOXOOXXOOOOOOOOXOOXXOOOOO
OXXOOOXOXOXXOXXOOOOXOOOOOOOOOXOOOOXOOOOOOXOOOOOOOOOOOXOOOXOXOOOOOOOOOOXOOOOOXOOXOOXOOOOXXOOXOXXXXOXOX
OXOOOXOOXOXOOOXXXXOOOOOOOXXXOOOXOOOOXOXOOXXOOXOXXXOOOOOOOOOXOOOOOOOOXXOOOOOOOOOOXOOOOOOOOXXXOOOOOXOOX
OOOOOXOXOXOOOOOOOOOOOOXXXOXOXOXXOOXOOOXOOOXOOXOOOOOXOOOXXXOOOOXOOOXOOOOXOOOOOOOOOOOOOOXXXOOXOOXXOOOOO
OOXOXOXOXOXOXXOOOOOXXOXXOOOOXOXOOOOXOXXOOOOOOOXXOXOOXOOOOOOOOXXOOOXOOOOXOOXOOOXOXOOXOOOXOOXOOXOXOXXOX
OOOOOOOXXOXOXXOXXOOOOOOXOOOOOOOOXOXOOOXXOOXOOOOXOOXOOOOOOOOOXOOOXOOOXXXXOOOOOOXOXXXXOXOXXXOOOXOOOOOOX
XOOXXXOOOOOOOOOOXXOXOOOOXOXOOOOXOOXOOXOOOOOOOOXXOXOOOOOXXOXXOOXOXOXOOOOXOOOOXOOOXXOOOOOOXOOOOOOXOXOOX
OOOOXOXOOOOOOOOOOOOOXOOXOXOOXOXOXOOOXOOXXOOOXOOOXOOXOXOOXXOOXXOXOXOXOXOOOOOXOOXOOOOOOOOOXOOXXOOXOOXOO
OXXOXXOXOOOOOOOXOXXOOXOOOOOOOXXOXOOXOXXOOXXOOXXXOOOOXOOOOOXXXOXXOXXOOOOOXOOOXOOOOOOOXOOXOXOOOXXOOXOXO
XOXXOXXOXOOXOOXOOOXXOOXOXOXXXOOOOXOOOXOXOOOOXOOOOXOOXXOXOOOOOOOXOOOOOOXOOXOOOOOXOOOOOOXOXXOOXXXOOOOOO
XOOOOOOOOOXOOXOOXXOOOOXOOOOOOOOOOOOXOOOXOOOXOOOOOOOOOXXOOOOOXXOOOOXOOOXOXOXXOOOOOOOXXXOOXOOOXXOOOOOOO
OOXOOOOOOXOXOOOOOOOOXOOOOOOXOOXXOOXOOOOOXXOXOOXOXOOOOOOOOOOOOOOOXOOOOOOOOOOOOOOXOOOXOOOXOOXOOOOOXOOOO
OOXOXOOOOOOXXOOOOOOOXXOOOOXOOXXXOOOXOOOOOXOOOXOOXOOOOOOOOXXOXOOOXXXXOOOOOXOOXOOOOXOXOOOOOOOOXXOOXOXOX
OOXOXOXOOXOOOOOOXOXOXOOOXOXXXXOOOOOOXOOOOOXOOOXXXOXXOOXOOXOXOOXOXOOOOOOXOOOXOOOOOXXXOOOOOOXXOXOOOOOOO
XOXXOXOOOOXOOOXOXOOXOXOXOOOOXOOOXXOOXOOOOXXOXXXXOOOOXXOXOOOOOOOOOOOXOXOOOOXOOOOOXOOOXXXOXOOOXOOXXXOOO
OOOOXXOOOOOOOOXXOOOOOOOOOXXOOOXOXOXOOOXOOXOOOOXOXOOXXOXOOXOOXOOXOOOOXXOXOOOOXOOXOOOOOOOXOXOOOOOOXXOOO
OXOOOOXXOOOOXOOXXXOOOXXXXOXOOOOOOOOOXXXXXOOOXOOXXOOXOXOXXOOOXOXXXXOOXOOOOOOOOOOOOOOXOXXOOOXOOOOOXXXOO
OOXXOOOOXXOXOXOXXXOXOOOOOOOXOOXOOXOXOXOOOXXOXOXXOOOOOXXXOXOXXOXXOOOOXOOOOOOOOOOOOOXXOXXOXXXXXOOOOOOOX
OOOOOOXOOXOXOOOOXOOOXOOXOOOOOXXOOOOXXXOOOOOOXOOXOOXXOXOOOXOOXOOOOXOOXOOOXOOOXXXOOOXXOOOXXOXOOOOOOOOOO
XXOOOXOOOXXOOXXOOOOOOXOOXOOOXXOOOXOOOXXOOOOOOOOOOOOXXOXOOOOXXOOOOOOOXXOOXXOOXOXOOXOOXXOOOXOOXOXXOXOOO
OOXXXOOOOOXOXOOOOOOOOOOXXOXXXXXOXXOXOOOOOXOOOXOXXOXOOOOOOOXXXOOOXXOOOOOXXOXOXOOOOOOXXOOOOOOXOOXOOXXOX
XXXOXXOOXOOXOXOOOXOOXOOOOOOOXOOOOOXOXOOXXOOOOOXOOOOOOOXOXXOOOOOOOXOOOXOOXXOXOOOOOOOOOXOOOOOOOOOXXOXXX
OOOOOOXXOOXOOOOXOXXOOOXOXOXXXOXOOOOXOOXOOOOOXOOOOOOOOOOOOXOOOOOXOOOXOOOXOXOXXOOXOOOXOOXOOXXOXOXXOXOOX
XOXOOOOOXXOOXOOOOOXXXOOXXXOOXXXOOOOOXXOOOOOOOOOOOOOOOOOOOOOOOXOOOOOOOOOOOXXOOOOXOOOOOXXOOXOXOOOOXXOOO
OXOOOOOXOXOXXOOOOOXOXXOXXOOOOOXOOXXOOOXOOOOOXOOXOOOOOOOXOOOXXXOOOOXXXOOOXOOXXXOOOXOOOOOOOOOXOOXXXOXXO
OXOOOOOOOOOOOOOOOOOXOOXOXXOXOXOOOOOXXOXOOOOOOOOXXXOOOOOOOXOXOXOOOXOOOXOXOOOXOOXXXOOXXXOOOOXOOXOOOOOOX
XOOOXOXOXOOOOOOOOOOOOXXXOOOXXOOOOXXOOXXXOOOOOXOOOOOOXOOOOOOOXOOOOOOOOOXOXOXOOOOOOXOOXXXOXOOXXOOXOXOXX
OXXOXXXOOXXOOOOXOOOOOOOOXXXXXOOOXOOOOOXOOXOOOOXOXOOXOOOOOOOXOXOOOOXOXOOXOOOOXOXOOXOOOOOOOOOOXOOOOOXOO
OOOOOXXOXOOOOXOOOOOOXXOXOOXOOXOOOOOOOOOXXOOOOOOOOOXOOOXXOOXOXOOOOOOXOOOOOXXOOXOOOOOOOOXXXXXOOOXOOXOOO
OOOOOOOXXOOOOOOOOOOXXXOOOOOOOXXOOOOOOXOOOOOOOOOXOOOOOXOOXOOOXXXXOOOOOOOOOOOOOOXOOOOXOOOOOXXOOOOOOOOOX
XOOOOOOOXOOXXOXOOXOXOXOXOOOOXOOXOOOXXOXOOOOOOOOOOOOOOOOXXOOXXOOOOXXXOXXOOOXXOOOOOOOXOOXOOXOXOXOOXOXOX
OOXOOOOOOOOXXXOOOOOXOOXOOXOOOXXOOOOXOXOOOOOXXOOOXXOXXOXOOOOOOOOOXOOOXOXOXOOOXXOOOXOXOOOOXXOXXOXXXXOOO
OXXOOOOOOXXOXOXOXOXXOOOOOOOOOOOOOOOOXOXOXOOOOOOOOOOOOOOOOOOXOOOXOOOXOOOOOOOOXOOXOXOOXOOXXOXOOXOXXOOOO
XOXOOXXOOOXXXXOOOXXXOOOXOXOOOOOXXOOOOOXOOOXOXXOOOOOOXXOOXOXOOOOOXOXOOXOOOOOOXXXOXXXXOOOOOXOOOXOOXXXOO
OOXXOOOOOOOOOOOXOOOXOOOXOOOOXXXXXOOXXOXOOXXOOOXOOXOXOOOOOOOXOOOOOXXOOOOOOOOXXOXOOXXOOOOOXOXOOOOOOOOOO
OOOOOOOOXXOOOOOOOOOOOXOXOOOXOOOOOXXOOOOOOOOXOOXOOOXXOOOOOOOOOXOOOOOXXXOOOXOXOOXOOXOOXOOXOOOOOOOOXOOOX
OOOOOOXOOXXXOOOOXOXOOOOOXOOXXOOXOOXOOOXOXOXXOOXOOOOXOOOOOXOXXOOXOOOOXOXXXXOXOXOOXXOOXXOOXOOOOOOXXOOOO
XOOXOXOOXOOOXXXOOXOXOOOOXXOOXXOOOXOOXOOXOOOOOOOXOOXOXOOOXOOOXXXXOOOOOOOOOOOOOXOOOOOXOXXOOOOXOXOOOXOOO
OOOOXOOOXOOXOXOOXOOOOOOOOXOXOXOOOXOXOOXXOXOOOXXOXOOOOOXOOOOXOOOOOOOXXOXOXOOOXOXOOOOXXXXOXOXOXXXOOOOXO
XOOOOOXOXOOOOOOXXOOOXXXXOOXOXOOOOOOOXOOXOXOOXOOOOOOXOOOOXOXOOOOXOOOOOOXOOOOOXXOOXOXOXXOOOOXOXOOOOOOOX
OXOOOOOXOOOOOOOOOOXOOOOOOXOOOXXXOOOOXOXXOXOXXOOXOOOOOOXOOXXXOOOXXOOOOOOOOOOOOOOOXOOOOOXOXOOXOOXOXOOOO
OOOOOOOOOOOOXOOXOOXOOXOOOOXXOOOOOXXXOOOOOOOXOXXXOOOOOXOOOOOOOOOOXXOOXXOXOOOOOOXOXXOOOOOOOOOOOXOXOOOXO
OXXOOOOOXOOXXOOOOOOOOOOOOXOXOOXOXXOOOOOOXOOOXXOOOOOOOOOOXXOOXXXOOOOOOXXOOOOOOOOOOOOOOOOXOOOOOXXXXOXXX
OXOXXOOOOXOOOXOOXOXOOXOXOXOOXXXOXOOOOOOOOOXOXXOXOOOXXOOOXOOXXOOOXOXXXOXOOXOOXOOOOXOXXXOOXXOOOOXXOOXOO
OXXOOXOXOXOOOOOOOOXOXXOXOOOOOOOOOXOOXOOXOOXOOXOXOOXOOOOXOOOOXOOXOXOOOOOOOXOOOXOOXXOXOOOXOOOXOOOXOOOOX
XOOOOXOOOOOOOOOOXOOXOOXOXOXXOXOXOOOOOOXXOOXOOOXOXOOXOXXOOXOOOOXXOOOOXXXXOOOXXXOOOXOOOXXOOXOOXOOXOOXOO
OOXOXXOXOOXOOOXXXOXOXOOOOXOOOXXOXOOOOXOXXXOXXXXXOOOOXXXOOOOOOOXOXOOOOOOOXXOOXXXOXOOOOOXOOOXOXOOOXXXXO
XXXXOOOOOOXOOXOXOOOXOOOOXOOOOOXOOXOXXXXOOOOOXXXOOOOXOXXOOOOOOOXOOXXOXOOOOXXOXOOXOOOXOOXOOXOXOOOOOOOOO
OOOXOOOOOXXXXOOOXXXOOXOOOXXXXOXOXOOXOOOXOOXOXOOOOXOOOOOOOOOXOXOOOOOOOXXOOXOOXOOOOXOOXOOOXXOOOOOOOOXOO
OOOXXOXOOOXOOOOOXOXXOOXOOXOXOOOOOXOOXXOOXOOOOOXOOXOOOOOOOOXXOOXOOOOOXOOXOOOOOOXOOOOOOOOOOOXOXXOOOXOOX
XOOOXOOOOXXOXOXOXOXOOXXOOOOOXOXOXXXXOOOOOOOOXOXOOOOOOOOXOOOOOOOOOOOOXXXOOOOOOOXOOXOOOXXOOXOOXXOOXOOOX
OXOOOOXOOOXXXOOOXOOOOOOOOOOOOOOOOOOXOOXOXOOOOXOOOOOOOOXOOOOOOOOOOOOOOOOOXOOOOOOOOOOXXXOOXOXXXOOOOOOOO
OOOXOOOXOOOOOOOOOXOOOOXOOXOOXXOXOOOOXOXOXXOXOOOOOOXOXOOOOOXXXOOOOOOXOOOOOOOXOOOXOOOOOOOOOXOXOOOOXOXOO
OOXOOXXOXXXOXOOOOXOOXOOOOOXOOOXXOOOOOOOOOOXOOOXOXXOOXOOOXOOOOOOOOOOOOOOOOOOOOXOOOOOXOXXOOOOOXOOOOOOOX
OXXOXOOXXOOOOXOOOOOOOXOXOOOXOXOXXOOOOXOOOOOOXXOOOOOOOOXXXOXOOOOXXXOXOOOOOOOOOOOOOOOOOXOXOXOOXOXOXOXOX
OOXOXXXXXXOOOOOXOOOOXOOXOXXOXXOOOOXXXOXXXOXOOOXOXXOOOXOXXOOXOOOOOOOXXXXOOXXOOOOXXOOOOOXXXOOXOOOOOOOOX
OOOXOOOOOOOOOOXXOXOOXOOXOOXOOOXOXXXXOXXOXXXXXOXOOXXOOOXOOOXXOXOOOXXOOOXOOOOXOXOOOOXOOXOOOXXOOOOOXOOOO
XOOOXXXXOXXXOXXOXOOXOOOOXOXOOOXXOXOOOXOXXOOOOOXOOOOXOXXOOOOXOOOOOOXXOXOOXOXOXXXOOOXXOXXOXOOOOOXOOXOOO
OOXOOOOOOOOXOXOOOOXOOXXOOXOOOXOOOOOOXOXXXXXOOXXXOOXXOXOOOOOOOOOOOOXOOOXOOOXOOXOOOOOOOOOOOOOXXOXOOOOXX
OOOOOOOOXXOOOXOOOXOOXOOOOOXOXOXOOXOXOXOOOOOOXOOOXOOOOOOOXOXOXOOOOXXOOOOOOOOXXOOOXOXOOOOOOXOOOOOOOOXOX
OOOOXOOOOXXOOXOOXOOOOOOOOXXXOOOOOOOOOOXXOOOOOOOXXOXOOOOOOOOXOXOOOOOOXOOOOOXXOOOXOOOXOOXXXOOXOOOOOXOOO
OXOOOOXXXXOOOOOOXXOOOOOOOOOXOOOOOXOOOOOOOOOOXXXOOXOOOXOOOOOOOOOOXOOXOOOOXOXOOOOOOOOXOOXOOOXOXXOOOOOXO
OOOOOXOOOOOOOOOXOXOOXOOOXOOOOXOXOOOXOXOOOXOOOOXXOOOXOOOXOOXXOOXXOOOOXOXOXOOOOOOOOXOOOOXOXOXOOOXOOXXOO
OOOOOXXXOXOOOXOOXOOXXOOXOOOXOOXOXXOXOXXOOOOOXOOXXXOOOXOXOXOXOOXOOOOOXOOXXXOOOOOOXOOXXOOXXXOOOOXOOOOOX
OOOXOOOOXOOXOXXOOOXXOXOOOXOOOOOOOXOOOXOOOOOOOXOOOOOOOOOOXXOXOXXOOOOOOOOXOOXOXOOOXOXXXOOXOOXOOOOOOOXOO
XXOOXOOOOXOOOOOOOXXOOOOOXXOOOOOXXOOOOOXXOOOOXXXOOOOOXOOOXOOXOOOOXOOXXXOXXOOXOOOOOOXOOOOXOOOOOXOXOXOXO
XOOXOOOOOOOOOOXOXXXXXOOXOOXXOOOOOOOOOOOOXOOOOXOXOXOXXXOOOOOXOOOXOXOOOXOXOXXOOOXOXOXOOOOOOOOOOXXOOOXOX
OOXOXOOOXOOOOOOOOOXOXOXOOOOOOOOOXXOXXOOOOOOOOXOXXOXOOOOXOXOOOOOOOXOXOOOOXOOOOXXXOOXOOOXXOOOXOOOXOOOOO
OXOOXOXOOXXOXOOOOXXOOOOOOXOXOOXOOOXOOOXOXXOXOOOOOOXXOOOOOOOXOXOOXOOXXXOOOXOOXXOXOOOOOOXXOXOOOXXOOOOOO
XXOOOOXOOXOOOOOXOOOXXXOOXOOOOXXOOXOXOXOXXOOOOOOXOOOOOOOOOOOOOOOXXOXOOOOOXOOOOOOOOXOXOOOXXOOXOOOOXXXOO
OOOXOOXXXOOOOOOXOOXXOOOOOXXOOXOOOOOOOOOXOOXXOOOOXOXOOOXXOOXOOOXOOXOXOOOOOXOOOOOOOOXOOOOOOOXOXXOOXOXOO
XXOOOOOOOOOOOOXOOXOOXXOXOOOXOOOXXOOOOXXOOOXXXOOOOXOOOOXXXOOOXOOOOXOOXOOOXXOXXXXOOXXXOXXOXOXOOOOOOOOOO
OXOOOOOOOOOOOOOOOOOXXOXOOOOOOOOOOOOOXOXOXXOXOOOOOXXXOXOXOOXXOOOOOXOXOOOOOOOXXOXOXOOOOXOXOXOOXXOOOXXOO
XOXOOOXOXXXOXOXOOXXOXOXOXXXOXOXXXOXOXOXOOOOXXXXOXOOOOOOXOXOOOOOOOOOOXOXOXOXXOOOOOXOXXOOXOOOOOXXXOOOOX
OOOXOXXOXXOOOXXXOXOOXOOXOOOOOOOXXXOOXOOXOOXOOXOOOOOXOOOOOOOXOXOXOOOXOXXOXOOOXXOOOXXOOOOOXOOXOOXOOOOOO
OOXOOXOOOOOXOOOOXOOOOOOOOOOOOOOOOOOXOOOXOOXOXOOOXXOXOXOXXOOOOXXXOXOOOOOOXOOOOXXOOOOOOOOOOOOOOOOOXOOOO
XOOOXXOOXXOOOOOOXOOXOOOXOOOOOOOOXXOXXOOOOOOOOOOXXOXXXOXXOXOOXOOXXOOXXXXXOXXOXOXXXXOOOOOXOOOXOXOOOXOOX
XOOOOXOOOXOOXOOXXXOOOOOXOXOOXOOOOXOOOXOXOXOXOOOOOXOOOXOOOOOOOOOOOOOXXOXXOXOOOOXOOOOOOOOOOXOOOOXOOXOOO
