OOOOOOOOOOOOOOXXOOOOOOOXXOOXOOOXXOXXOOXXXOXXOOXOOXOOOOOOOOOXOOOOOXOOOOOXXOXOXOOXOXOOXXOXOOOOOOXOXOOOX
OOOOOXOOOOOOOXOOOXXOOXOXOXXOOOXOXXXXOXXOXOOXXOOXXXOOOXOOOOXXXOOOOOOXXOOOXXOOXOOOXOOOOOXXXXOOOOOOOOXXO
XOOOOXOXOOOOOOOOOXXOOOOOOOOOOXOXOOOOOXOOOXOXOOOOXOOOOOOOOOOXXXOOOOXXOXXXXXOXOOOOXOOOOXOOXOOOOXOOOXOOX
OOOOXOOXOOXXOOOOOXOOXOOXOXOXXOXXOOOOXOOOOOOOXOXOOOXXXOXXOOOXXOOXOOOXXOXOXOOOOOOXXOOXOOOOOOOOOXOXOOXOO
XOOOXOOXXOOXXOOXOOOXOOXOOOOXOOOOXOOOOOOOXOXOOOOOOOXOXOXOOOOOXOOOXOOOOOOXOOXOOOXXOOXXOXXOOOOOOOOOOOOXO
OOXOXOOOXOOXOOOOXXOXOOOXOOOOOOXOOOOOOOOOXOXOXXOOXOOOXOOOOOOOOOOXOXOOOOXXOOOOXOXOOXXXXXOOOOOOXOOOOXXOO
XXOXOXXOOOOOXXOOXXOOOOXOOOOOOOOOOOXOOOXOOOOOOOOOOOOOOOXOXOOOXXXOXOOXOOXXXOXOOOOXOXOOOOXXXXOOOOXOXOOXX
OXOXOOOXXOOOXOOOOOXOXOXXOXOOOOOOXOOXOXXXOOOOOXOOXOOOXOOOXXOOXXOOOOOXOOXXOOXOOOOXOXOOOOOXOOOOXOOOOOOXX
OOXOOXOOOXOXOOOOOOXOOOOXOXOOOOOOOXOOOOOXXOOXXOOOOOOXOOOOOOXOOOOOOXOOOOOOXXOXOOOOOXXOXOOOXOOXOXOOOOXOO
OOXOXXOOOOXXOOOOOOOOOOXOXOOXXOOOOOOXOOOXOXXXOOOOOOOOXXXOXOXXOXXOOOOXXOOOOOOOOOOXOOXXOXOOOXOOOOXXXOOOO
OOOXOOOOOOOOOOXOXOOOOXOOOOOXOOOOOOOXOOXOOOOXXOOOOOOOOXOOXOOXOOOXOXXOXOXOOOXOOOXOXOOXOOXOOOXXOOOOOXOXO
OXOOXOOOOOOOXOOOOOOOXOXOOOOOOOXXOXOXOOOOOXOXXOOXXOOXXXXOOXXXXXXOOOOOOOOOOOXOOOOOXOOXOOXXOOOOOOOXOXOOO
OOOOXOXOOXOXOOOOXOOOXXOXXOOOOXXOOOOOXOOOOXXOOOOOXXOOXOXXXOOXXOXOOXOOOOOOXOOOXOXOOOOOOOOOOOXXOOOXXOOOO
XOOOOXXOOOOOXOXOOOOOOXXOOOOOXXOOOOXOOXOXOOOOXOXXOOOOOXOXOXOOXXOXOOOOOOXOXXOOOOXOOOOOXXOXOOOXXOXXOXXOO
XOXOOOOXXXOOXOOXOXOXOOOXOOXOXOXOXOOOOXXXOXOOXOXOOOXXOXXOOOOOOOOXOOXOOOOOOOXOOOOXOOXXXXOXOOOOXXOOXXOOO
OOXOOOOOXOOOOXXOXOOOOXOOOXOOOXXOOOOXOOOXOXOOXOOOOOOOOOOXOOOOXOXOXOXOXOOXXOOOOXOOXXOOOXXXXOXOOOXOOOOOO
OOOOOOOXXXOOXXOXOXXOOOXOOXOOXOOOOOOOOXOXOXOOOXOOXOOXOXOXOXXOXOOXOOXXXOOOOOOOOOXOXXOOOOOOXXOOOOOOOOOOX
OOOXOOOXOXOOOOOOOOOOXOOXXOXOXXOOOXXOOXXOOOXOOOXOOOOXXXXOOXXXXOOXOXOOXOOOXXXXXOXXOOXOOOXXOOXXXXXOOOXOO
OOOOOOXOOOXOOOOXXOOOOOOXXXOOOXXOOOOOOOOXOXXXOXXXOXXOOXXOOXOOXOXOOXOXOOOOOOXOXOXOOXOOOOXOOOOXOXOOXXXXO
OOOXXOXOXOOOOOOOXOXOOOXOOOOXOXOOOXOOOXXOOOOOXOXOOOOOXOXXOOOOOOXOOOOOOOOOXXOOOOXXOXOOOOOXOOOXOOOOXOOOX
OXOOOOXXXXOOOXXOXOXXXOXOOXOOOXXXOOXOOOOXOOOOOOOOOOOXXOOOOOOOOOOXXXXOOXOXOXOOOXXOXOXXXXOOOXOOOOOXXXOOX
OOOOOOOOOXOOOXOOOXOOOOOOXOOOOXOXOXXOOOOXXXOOOXXXOXOOOOOOOOOOXOOOOOOXOXOOXOOOOXOOOOOXOXXOXOOXOXOOOOOOX
OOOXOOOOOOOXOOOXOOOOOOOXOOOOOXXOOOOOOOOXOXOOOOOXXOOOOOOXOOOXXOOOXOXXOOOXOOOOOOOXOOXOOOOXOOOOXOOOXXOOO
XOOXOOOOOOXOXOXOOOOOOOOXOOOOOOXOXOOOOOOOXXXOXOXOOOOOOOOOOXXXOOOOOXOOXOOOXXXOXOOOXOXXOOOXOXOOOOOXXXXOX
XOOXXOXOOOOOOOXXOOOOOOOOXXXOOOXOOOXOOXOOXOXXXOOOOXOOOOXXOXOOOXOOOOOOOOXXOOOOOOOXXOOOOOOOOXOOOOOXXOXOO
XXXOOXOXOOOXOOOXOXOXOOOXXOOOOOOOOOOXOOXXXOXXOOOOXOOOXXXOOXXXOOXOXOOOOOOXOOOXOXOXOOOOOOXOOXXOXOXXOXOOO
OOXXOOXOOOOOOOXOOOOOOOOOOXXOOOOOXOOXOXOOOXOOXOXOOOOOOXXXOXOOOOXOXOOXOXOXOOOOOOOXOXOOOOOOOXXOOOXOOXOOO
XOOOOXXXOOOOOXOXOOXOOOOXOOOOOOOOOXOOXOOXXOXXOOOOXOXXOOOOXOXOOOOOXOOOXXOXOXOXOOXXOOXOOOOOXOOOOXXOOOOOX
OOOXOXOOXXXOOOOXOOOOOOOXOXOXOXOOOXOXXXOOOOOOOOXXOOXOOXOOOXOOOOXXOXOOOXXOXOOOOXOXOOOOOXXOOOXXOXOOXOXOO
OXOXOOOOOOOOXXOOOXXXXOXXXOXXXOOOOOXXOOOXOOOOXXOOOXOXOOOOOXOOOXOOXXXOOOOOOOOOXOOXXOOOOXOXOOOXOOOOXOXOO
OXOOOXOOOOOXOOOXOXXOOXOXOOOXOOXXOOXXOOOXOOOOOOOOXOXXOXOOOOOXXXXXXOOOOOXOXOOXOOOXOOXOOOOOOXOOOOOXOOOOX
XOOOOOOOOOXOXXOOOOOOXOXOXOOOOXXOOOOXOOOXOXXOOXXOOXXOOXOOOOOOXOOOXOOOOXOOOOOOOXOXOOOOOXXOXOOXOXOXOOXXX
XXXOOOXOXOOOXOXOOOOOOOXOXOOXXOXOOOOXOOOXOOOXOOOOOOOOOXOXOOOXOOXXOOOOOOOOOOOOOOXXOXOOXOXOOXXOXOOOXOOOO
OOOOOOOXOOOOXOOXXOOOOXXXOXOOXXOOOOOXOOOXXOOOOXOOOXOOXOOOOOOOOOXXOXXOXXOOOOOOOOXOOXOOOOOOOOXOOOXXOOXOO
XOOOXOOOOOXXXXOOOXOXXXOOXOXOOOOOXOOXOOOOOXOOOXXXOXOXXOOOOXOOOOOOOOXOOXOXOOXOOOOXXXOOOOOOOXXOXXOXOOOOO
XXOOXOXOXXOXXOOOOOXOXOOOXXXOXXOOOXOXXOOOOXOOOOOXOOOOOXXOXOXOOOOXXOOOOOOOOXOOXOOXOXOOXOOOOOOOXXXXXOXOO
OOOOOXXOOOOXXOOOXOOOXOXOOXXOOXXOXXXOOXXOOXOOXOXOXOOOXOXOOXOXOXXOXOOOOXXOOOOXOOXOOOOOOOXOOOOXXOOXXXOXO
XOXOXOXOXXOXOXOOOXOXOXOOXOOOOXOOXXOOXOXXXXOXOOOOOOOOOOOOXOOXOOOOOOOXOOXXOXOOOOOOOOXOOOOOXOOOXOXOOXXXO
XXOOOXOOOOXXOOXOOXOOXOXOOOOOOXOOOXOOOOOOOOXOOOOOXOOXXOOOOOOOXXOXOOXOXXOXOOOOXOOOOOXOOXOOOOOOOOXOXOOOO
OOXOXOXOOXOOOOOOOOXXXOOOOXOOOOXOOOOXOOOOOXXOXOOXXOXXOXOOOOXOXXXOOOXXOXOXOXOXOXOXOXOXOOXOXXOOOXOOOOOOO
OOXOXOOXXOOOXXOXXOOOOOOXOOXOOXOOOXOXOOOOXOOXOXOOOOOOXOOOXXOOOOXOOXOOOOOOOOOXOOXOXXOXOXOXOXOOOOOOXOXOX
OOXXOOOXOXOOOOOOOOOXXOOXOXOXOOXXOOOOXOOOOXXOOOOXXOOXOOOOOXOXXOXOOOOXOOOOXOOOXOOXOOXOOOOOOOXXOOXOOOOOO
OXXOOOOOOOXOXOOOOOOOOXOOXXOXOXOOOOOOXXOOXOOOOXOXOOOOXOXOXOOOOOOOXOOXOOOOOOXOOOXOOOOXOXOXOXXXXXXXOXOOO
XOOOOXOXOOOOOOOOOXOOOXOOXXOOOOOOXOOOXOXXOOOXOOOOOOOOOOXOXOXOOOXXOOOXOOXOXOOOOOOOOXOXOOOOOOOXOOOOOOOOO
OOOOOOOOXOXOOOOXOXOOOOXOOOOOXOOXXXOXXOOOOOOOOXOOOOOOXXOOOOXXXXXXOOXOOXOOXOXOXOOOOOXOOXOOOXOOOOXOOXOOX
OOOOXOOOXOOOOXOXOOOOOOXOXXXOOOOOOXOXXOOXOXOXOOOXOOOXOOOOXOOOOXOXXXOOOXOXOOOOOXOXOOXOXOOXXOOXOOOOOOXOO
OOXOOOXOOXXXOXOXOOOOOOOOXOXOOOOXOOOOOOOOOOXOXOOOOOOOOOOOOOXOOOOOXXOOOOOOOXOOXOOOOOOOOOOXOOOOXOOOOOOOO
OOOOXXOXOOOOOOXOOXXOXXOXXOXOOOXOOOOOXOOOXOOOOXOXXOXXOXXOOOOOOXXOOOOXXOOOOOXOXXOOXXOOOOOXOOXOOOOXXOXXO
XOOXOOOOXOXOOXXXOOOXOOOOOXOOXOXOOOOXOOXXOOXOXXXXXOOOXXOOOOOXXOXOXOOXXOXOOOOOOXOXXOXOOXXXOXOXOOXOOOOOO
OOOXOXOOOOXXOOXOOOXOOOOXXXXXXXOOXOOOXOOXXXXXOXOOOOOOOXXOXOXOOXOOOOOOXXXOOOXOXOOOOOOOOOOOOOOOXOOXOOXOO
OXOOXXOOOOOXOOOXOOOOOOXOOOOOOOOXXXOXOOXXXOOOXOXXXXXXXXOOOXOXOOOOXXXXXOOXOOXOXOOXOOOOOXXOOXOOOOOXOOOXO
OXOOXOOXXOOOXXXOOOOOXOOOOOOOOOOOOOOOXXOXOOOOOXOOOOOOOOOOOXOXOOXOOOOXOOXOOOOOOXOOOOOOXOOOXOOOOOOXXOOOX
OXXOXOOXOOXOOXOOOXOXOOXOOOOOOOOOOOXOOXOXOOOOOOOOOOOXOOOOXOOOOOXXXOOXOOOXOOXOXOOXXOOOOXOXXOXOXOOOOOXXX
OXXOOOOXOOOXOXOOOOXOOOXOOOOOOOOOOOXOOXXOOOXXOOOOOOXOOOOXOOOOOOOOOXOXOOXOOOXOOXOXOXOOOXOOOXOOOOXXOOOXO
OOOXXOOOOXOOOOXOOOOOOOOOXOOOXOOOOXOOOOXOXOXOOOOOOOOOOOOXOOOOXOOOOOOOOOXOOOOOOOOOOXXOXOOOOXXXXOOOOOOXO
OOOOOXXOOOOXOOXOOOOXOXOOOOXOXXOXOOOOOOOOXOOOOOOXOOOOOOXOOXOOOOOOOXOOOOOXOOXOOXOOXXXXXXXXOOOOXOXOXOXXX
OXOOOOOOXOXOOXOXOOXOOXOOOOOOXOOXOOOOOXOOXXOOOOOXOOOOOXXOOOXOOOXXXOOOOOXOXOXOXOOOXOXXOOXOOOOOOOOOOOOOX
XOOXXOXXXXXOXXOXOXOOOXXOOOOOXOOOOOOOOOOXOXOOXOOOOXXOOOXOOOOOOOOOOOXOOOOOOXOOXOOOOOOOXOXXOOOOOOOOXOOOO
XOXXOOOXOXXOOOXOOOOOOOOOXOOXOXOOOOOOOOXXOOXOXOOOOOXOXOOXOXOOOOOOXOOOOOXOOOOXXOOOOXOOOOOOXOOOOXXXOOXOO
OOXOOOXXOXOOOOOXXXXOOOOXOXOOXXOOXOOXOXOOOOOOOOXXOXOOXOOXXOOOXOXOOOXOXOXXXOOOXOOOXOOXOOXOOOXXXXXOXOXXX
XXOXXOOOXOOOXXOXOXOOOOXOOOXOXOOOOOOOOOOOOOOOOOXOOXXXXOOOOOXOOOXOXXXOOOOXOOOOOOXOOXOXOOOOXOOOOXOOOOOXO
OXXOXOXOOOOOOOXXOOOOOXXXXXXXOOOOXXXOOOXXXOOOOOXOOXOOOXOOOOXOXOXOXOOOOXOOXOOOOOOOXOOXOOOOOOOOXOOOOOXXO
OOOOOOOOOXXOOOXOOOOOXOOOXOOXXXOOXOOOOXXOOXOXOOXOOOOXOXOOOXOXOOOXOOOXXOXXOXOOXOOOOXOXXOOOOOXOOXOOXOOXO
OXOXOOOOOOOXXOXOOOXOOOOOOOXOOOXXXOXOXOOXOOOOXOOOOOXOXOOOOXOOOOOOXOOXXXXOOOOOOXOOOOOOXXOXOXXOOOXOXXOOX
XOOXOOOOXOOXOOOXOXOOOOOOOXXXOOOOXXOOOOOXOOOXOXXXOOOOXOOOOOOOOXOXOOOXXOOXOOOOOXOXOOOXOXOOOOXOXOXOXOXOO
OOOXOOXOOOOOOOXXOXOOXXOOXOOOOXOOOXOOOOXOOOOOXOXOXXOXOOXOXOOOOXOXOOOOOXXOOOXXOOOOXOXOOOOXOOOOOOXOOOOOX
XXXOOOOXOOOXOOXOOOOOXOOOOOOOOOXXOOOXXXOOOXOXOOXXXXOOOOXOXOOOXOXXXOOXOOXOOOXOOOOXXXXOOOOXXOXOOOXXXXOOO
OOOXOOOOOOOXOXOOOOOOOOOOXOOXXOOOOOOXXOOOXOOOXOOOOOOOOOOOOOOOOOOOXOXXOXXOOXXOOOXOXOXOOXOOOOOXOOXOOXOOO
XOOOOOXOOXXOOXOXOXOOOOXXOXXXXOOOXXXOOXXOXOOXOXXXOOOOXOOOOOXXOOXXOOOOOOXOXXXOXXOXXOXOXOOOOXOXXOXOOOXXO
XXOXOXOXOXXXOXOOOOOXXXOOOOXOOOXOOOOOXXOOOXXXOOOOXOOXOOXOOXOXOOOOXOOOXXOXOOOOOOOOOXOOOOXOOOOXOOOOOOOXX
OXXXOOOXOOXXXOOXXOOOOOOOOXOXXOOXOOOOOOOOOOOXXXXOOXOOOXXXOOOOOOXOXOOOXOOOOOOOOOOOOOOXOOOXOOOOOXOOXXOOX
XOOOOOOOOXOOXXXXOOXOOOXXOOOOOXOOOXOOOOOOOXOOOOXOOXOOOOOXOOOXOOXOOOOXOXOXOOOOXOXXXOXOOOOXOOXOOXXXOOXOX
OOOOXOOXXXOXOXOOOOOOXOOOOOOOOXXOOOXOXXXXXXOXOXOOOXOOOOOOOOOOXOOOOOOOXOOOOXOOOOXXOOOOXOOOOOOOOOOOOOXOO
OOXOXOOOOXOOOXOXOOOOOOOOOXXXOOXXOXOOOXOXOOOOOOOOOOOOXOOOXXXXOOOOOXOOXXOXOOXOOOXOXOXOXOOXOXXXOXOXOOOOO
XXXOOOOOOOOOOOXXOOOOOOOXOOOOOOXOOXOOOOOXOXOOOOOOOXOXOXOOXOOXOOOOOXOXXOXOXXOXOOOOOXOOOOOOXXOOOOXOXOOOX
OOOOXXXOXXOOOOOOXOOOXOOXOOOXOOOOOOOOOOOOOOXOOXOOOOXOXOOOOXOOOOOXXOOOXOXOOOXOOOOOOOOOXOOOOOOOOOOOXOOOO
OOOOXOOOXXOOOOOOOXOOOOOOOOXOOXOOXXOXOXXOOOXOOOOOOXXXXXXOOOOXXXOOOXOOOOOXOOXOOOXOOOXOOOOOOXOXXOOXOOOOO
XXOOOXOXXXOOXOXOOXXXOOOOOOOXXXXOXOOOOXOOXOOXOOOOOOOOXXXOOOOOOOXXOOOOXOOXXOOOOOOOOXOOOOOXOXOOOOOXOOOXO
XOXOOOOOOOXOOOOXOOXOOOOOOOXOOOOXOOOXOOXOOXOXXXXXXOOOXOOOOOOOOOOOOOOOOXOOOOXXXOXOOXOXOOOOOXOXOOXOOOXOX
OXOXOXOXOOOOXOOOOOOOOXOOXXOOOOOXOOXOXOOOOOXOOOOOOXOOOXXXOOOOOOOXXXOXOOOXOOOOXOOOOOOXXOOXOOOOXXOXOOOOO
XOXOOOOOOXOOOOOXOOOOOOXOOOXOOXXOOOOXXXOXOOOOOOXXOXOOOOOOOXXOOOOOOOXOOOOXOOXXXXXOOOOOOOXXOOXXOOOOOOOOO
OOOXOOOOOOXOXXXOOXOOOOXOOOOOOXXOOOOOXOOOOOXOOOXOXOXOOOOOXOOOOXXXOXOOOXOOOXOOXOXOXXOXOOOXOOOXXXOOOOOOX
XXOXOOXXOOXOXOOOOOOOOOXOXOOXOOOOOOOOOOOOOXXOOXOOOXOOXOOXOOOXXXOOXOOOXXOOOXOOOOOOXOOOOOOXXOOOXOOOOOOXO
OXXOOXOOOXOXXOOOOOOOOOOXOXXXOOXOXXOOOOOOOOXOXOXOOOOXXOOXOOXOXXOXOXOOOOOOXXOOOOOXOOOXOOOXXOOOXOOOOOXOO
OOOOOOXOOOOXOXOOOOOOOOOOOOOOXOXOOXOXOOOOOOOXOOOOOXOXOOOOOOOXOOXOOXOOOXXOOXOOOOXXOOXOOOOXXOOXOXOOXOOXO
OOXOXXOOXOOXXXOXXXOXXXXOOOXXOXOOXOXOOOXOOOXXOOXOXXOOXOXOOOOOOOOXXOOOOXXOOOOXXOOXXOOXOXOOOOXXOXXOOOOOX
OOOXOOOXOOOXOOXOOXXOXXXOOOOOXOOXOOOXOXOXXXOOOXXOXOOOXOOOXXOOXOOOOOXXXOOXOOOXXOOOXOOOOOOXOOOOOOXXOOOOX
OOOOOOOOOOOXXOOOOXXXOOOOXOOXOOXOOOOOOXOXOXOOOOOOOOOOXOXOOXOOOXXOOOOXOXXXOXOOXOOOOOXOXOOOOOOOOXOOOOXXO
OOXXOXOOOOXXOXOOOOOXXXOXOXOXOXXOOOOXOXOXOOXOOOOXXOXXXOOXOOXXOXXOOOOOOOOOOOOOXOOOXOOXOXOOXXXOOOOOOOXXO
OOOOXOXOOOOOOOOOXOXOXXOXXOOXOOOOOOXOXXOOOOXXOOXOXOOOOOOOOXOOOOOOOXOOOOOOOXOXXOOOOOOXXOOXOOXXOXOOOOOXO
OOOOOOXOOOXOOOOOOOOXXXOOXOOOOXOXOOXOOOXOOOOOOOOOOXXXOOOOXXXXOOOXXXOOOOXOXXXOOOOOOOXOOOOOXOXOOOOOOOXXO
XOXOOXOOOOOXOOOXOOOOXOOOOOOOXOXOOOOOOOXOOOXOXXXOXOOXOOOOXXXOOOOXXOXOOOOOXOXOOOXXOXOXOOOXOOOOXOOOOOOOO
OOXOXOOOOOOXXOOOXOOOOXXOOOXXOOOXOOOOOOOOXOOXOOOXOXOXOOOOOOOOOXXOXXOOXOOOXXOOOXOXXOXOOOOOOXOOOOOOOOOOO
OOOOXOOOOOOXXXXOXOOXXXXOOXOXOOOOXXOXOOOOXXOOXOXOXOOOXXOOXXOOOOOOXOOOOOOOOOOOOXOOXXOOOOOXOXXOXOOOOXOOO
XXOOOOXXOXOXOOOXXOOOOXOOOXXXOOOXOOXOXOXOOXOXXOOOOXXOXXOOXXOOOOOXOOXOOXOOOXOOOOXOOXOOOOOOOXOOOOXOOOOOO
OOOOOOOOXXOXXXOOOXOOXOOOOOOXOXOXOOOOXOOOOOOXXOOOOOOOOOOOOOOOOXXOOOOXOOOXXOOXOOXOXOOXXOXOXOOXXOOOXXOXX
XOXXOOOOXOOOOXOOOOXXOOXXOOXOOOOOOOOOXXXOOOOXXOXOOOOOXOOOOXOOOOOOOXOXOOOXXOXOOOXOOXXOOOXOXOXOOXOXOOOOO
OXOXOXOXOOOOOXXOOXXOOOOOXOXXXOXOXOOOOOOXOXOXOOXXOOOOXXOXXOOXOOOOOOOOXXXOXOOOOOXOXOOXXOOOOXOOOOXOOOOXX
OXXOXOOXOXXXXOOOXXOXXOOOOOXOOOXXOOOXXOXOOXXOOOOOOXOOOOOOOOOOOOOXOOOOOOOOXXXOOOOOXXOXXXOOOOXOXXOXXXOXX
OXOOOOXOXXOOOXOXOOXOOOOOXOOXOOOXOXOOOXOOOOXXOXXOOXXOOOOOOXOOOXOOOOXOOOOOOXOXXXOXXXOOOXXOOXOOXOOOOOOXO
OOXOOOXOXOXOXOXOOOOOXOOOOOXOOOOXXOOOOXXOOOOOOXOOXOXOOOOXXOXOOXOOOOOOOXXOOXOXXOOOOOOXOOXOOXOXOXOXOOOOO
