OOOOOXOOXOXXOOXOXOXOOOOXXOXOOOXOOOOOXOXOOXXOOOOOOOOXXOXOXOOOXOXOOOOOOXOXXXXOXXXOOOOXXOXXOXOXOOXXXOOOO
XOXXOOOXOOOXOOOOOOOXOOOOOOXXOXOXOOXXOXOXXOOXOXXOOOXOOOOOOXOOOXOOOOOXOXOOOXOOOOOXXOOXOOOOOOOOXOOOOOXOO
OOXOOXOXOXOOOOOOOOOOOOOOOOOXOOOOXOOOOOOOXOOXOOXXXOOOOOXXOOOOXOOOOOOOOOOXOOOOXXOOOOOOOOXOXOOOXOOXOOOOO
OOOOOOXOOOOXOOOXOXXOXOOOOOOOXOXXXOOXXOXXOOXOOOOOOOOOOOOOOOXOOXOXXOOOOXOOOOOOOOXOXOXXXXOOOOXXOOXOXXXXO
OXOOOXXXOOOOOOOXOOXOOXXOOOXOXOOOOOOOOOXOXOXOOXXOXOXOXOOOOOOOOXXOOOOXXOOOOOOOXOOOOOOOOOXOOXOXOOOOOXOXX
OOOOOXOXOOOOXXXXOOXOOXOXOOOOOXOOOOOOOXOXOOXOXOOOXOOOXOOOOOOXOOOOOOXXOOOOOOOOXOXXXOOOOOOXOOOXXXOOOOOOO
OXOOXOOOOOXOOXXXXXOOOXOOOOXOOOXOOXOOXOOXOOXOXXOXXOOOOOOOXOXOOOOOOOOXXOOOXOOOOXOOOOXOOXXOOOXOXOOOOXXOO
XXOOOOXXOOOXOOXOOOXXXOXOOOXXOOOOOXOOOOOOXXXXOXXOOOOOXXOOXOOOOOOOOXOOOOXOOXXXXOXXOOOOOOXOOXOXOOXXOOOXX
OOOOOOXOOOXOXOOOOOOXOXXOOXOXOOOXOXOOOXXOOOOOXXOOXXOXOXOXOOOOOOXOXOOOOOXOOOOXOXXOOOOXOOXOOOOOOOOOOXOOO
OOOOOOOOOXXOXXXOOOXOXOOOXOOXOOOOXXOXOOOOOOOOOOXOOXOOXOOOOXOOXOOXOOOOXOXOXOXOOOOOXOXOOOOOXOOOOOOOOOOOX
OXOXXXOOOOOOOXOXOOOOOOXXOOOXXXOOXXOXXXOOOOOOOOOOOOXOOOXXXOOOOOOOXOOOXOOXOXXOXOOOOOOOOOXXOOXOOOXXOOOOX
XOOOOOOOOOXOOOOXXOOXOOOOOXOXOOXXOXOXXXOOOOOOOOOXOXXOOOOOXOOOOOOOXXXOXOOOXOOOOXOOOOOOOOOOXOOOOXOXOXXOO
OXOXOXXXXXOOOOOXOXXOOOOOOOOXXOOOXXOXOXXOOOOOOXOOOXOOOOXOOOOOXOOOOXOXOOOOOOOOOOOOOOOOXXOOOXOOOOOXOXXOO
OXXOXOXOOOXOOXOOOXXOXOXOXXXOXOXOOOXOOOOOXXXOOOOOXXOOOOOOOOOOOXOOOOOOOXXOXOOOOOOXOOOOOOXXOOXOXOOXXXXOO
OXOOOOXXOOXXXOOOOOOOOOXXOOOOOOOOOXOOXOXOOOXOOXOXOOOXXXOOOOOOOXOXOOOOOOXXXOXOOXXOXOXOOXOOXOOOXOXOOOXOO
OOXOOXOOOOOOOOOXOOOOXOOOOOOOXOOOXOOXOOXOOOOOOOOXXOXOXOXOOOXOXXOOOXOXOOOOOXOOOOOOOXXXOOOOXOOXOXOOOOOOX
OOOOXOOXXXOOOOOOOOOXXXXXOOOOOOOOOOXOOOOOOOOOOOXOOOXOOOXXXOOOOOOOXOOOOOXOOOOOOOOOOOOOOXXOOXOOXXXOOOXXO
OOXXOOOOOXOXXOOOOOOOXOXXXOXOXOXOOOOOOOOOOXOOOOOOXOOOOOXXOXOXOOXXOXOOOOXXOOXOXXXOXXOXOOOOOXOOOOOOOOOOO
OXOOOOOXOXXOOXXOOOOOXOOOXOOXXXOOOOXXOXOOXOXXOOOOXXOOXOOOOOOXXXOOXXOOXOXXXOOOOOOOOOOOOXOXXOOOOXXOOOOOO
OOOOXXOOXXOXXOOOOOOOOOOXOOOOXOOOXOOOOOOOOXOOOOXOOXOOXXOOOOOOXOOOXXXOXOXXOOOXOXOXXOOOOOOOXOOXOOXXOOXOO
XOOXXOOXXXOOXOOOOXOXOOOXXXOOXOOOOOOXOOXXOOOOOOOXOXOXOOXXOOXOOOOOXOXXOOXXOOOOOOOOOXOXOXOXOOXXOOOOOOOOO
XOXOOXOOXOXOXOOXOOXOOXOOOOOXOOOOXXXXOOOOOXXOOOOOXXXOOOOOOOOOOOOOOOOOOOOXOXOXOOOOOOOOXOXOOXOXXOXOXOOXO
OOOOXOXOOOOXXXOOOOOOOOOOOXOXOOOXOXOOXOXOOOXOOOXXOXOOOOXOOOOXXXOXXXXOOOOOOXOOXOOXOOXOOOOOOOOOXXOXXXOOX
OOOXOOOOXOXOOOXOOOOOOXOOOOOOOOOOOOXOOXOXXXXXXOXXXOXXOOOOOOXOOOOOOOOXOOOOOXOOXOOOOOXXXXOOXXXXOOOOXOOOO
XXOXOOOOXXOOXOOOXXOOOOOXOXOXOOOOOXOXOOOOOOXXXXXOXOOOOOOOOOXOXOOOOOOOOXOOOOOOOXOOXOOOXOOXOOXOXOOOOXOOX
OXOOXOOOOOXOXOOXXOOOXXXOXXOXOOOOOOOOXXOOOOOXOOOOXOOOOOOOOXOOOOXOOOXOOOXOOOOOOOOOXOOXXOOOOOXOOOXOOOOXO
OOXOXOOOOOOOOOXOOOXOXXOXXXXOOOOOXOXOOOOOOOOOOOXXOXOXOXXOOOOOOOOOOXOXOOOOXOOOOOOOOOXOXOXXOOOOOXOOXOXOX
OOOOXOXOOOOOOOXOOOOOOOOOOXOOOOOOXOOOOXXOOXXOOXOOOOOOOOOOXXOOOOXOXOOXXOOOXXOOOXOOOOXOOOXOXOXXOOXOXOOOX
XOOOOXOOOXXOOOOXOXOXOOOOOXOOOXXOXOXOOOOXOXXXOOXXXOOOOOOXXOOOOOXOXOOOXXXXOOOXXOXXOXXOOOXOOOXOOOOOOXXXO
OOXOOXXOOOXOXOOOOXOOOOOOXOOXOXOOOXOOXOOOOXOXXOXXOOOOOOXOOOOOOOXXXOXOOOXXOOOOOXOXOXOXXOOOXOOOOXXXOOXOX
XOXXXXOOOXOXOOXOOXOXXOXOXXOOXOOOOOOOOOOOXXOOOXOOXOXOOOOOOOXOOXOOOXOOOOOOOOXOOXXOOOOOOOOOOOOOOXOOOOOOO
XOXXXOOOOXOOXOOOOOOOOOOOXXXXXOXXOOOXOOOOOOOOOXOOOXOXXXOXOOOXOXOOOOOOOOOOOOOOXOXOXOOOOOOXOOOOXOXOOXOOX
XXOXXOOOXXXXXOOOOOXOXXOOOOOOXXOOXXOOOOOOOXOOOOOOOXOOOXOOXOOOXOOOXOOOOOOXOOXOXOOOOOOOOOOOOOXOOOOOOOOOO
OXOXOOOOXOXOOOOOOXOOOXOOOXOOXXXOOOOXOXOOOOOXOXOOOOXOXXOOXXOXOOOOOXXOOOXXOOOXOXOXXOOXOOOOOOOOOOXOOOOOX
OOOOOOXXOXOOOOXXOXOOOOOOOXOOOOOOXOOOOXXOOOXXXOXOOXOOOOOXOOOOOOOOOOOXXOOOXOOXOOOXOXOOXOXXXOOOOOOXXOOOO
XOOOOOOXXOOOOOOOOXOOOOOOOOOOOOOXOOOOOXXOOXOOOOOOXOXOOXOOOOOOOXOOXXXOOOXOXOOOOOOXOXOXOOXXOXOOOOOOOOOXO
OOXXOOOOOOXXOOOOXOOOOXXXXOOOOOOXXOOOXXOOXOOOOXOOXXOOXOXOOOXOXOXOOOOOOOOOOOXOOOOOOOXOOXXOXXOOXOOOOXOOX
OXOOOOXOOOXXXOXOXXOOOOOXOOXXOXXOOOOOOOXXOOOOOXOOXOOOXOOOOOXOOXOXXOOXXXOXOXOXXOXOOXOOOOXOOOXOXOOOXOOOO
OOOXOOOOOXOOXXOOOXOOOOOOOOOXOXXOOOOOOOXOOOOOXXXOOXOXXOOOOXXXOOOOOOXOXXOXOOXXXOOXXXOOXOOXOOXOOOOOXOOOO
OXOOOOXXXXOOOOOOOOOXOOOXOXOXXOXXOOOOOOOOOOOOOOXOOOOOXXOOXXOOOXOXXXXOOXOOOOOOOOXOOOXOXXOOOXXXXOXXOOXOO
OOOOOOOOOXOOOXOOOOXXOOXOOOXOXXOXOOOOOXOXXXOOOOXOOOXOOOOOOOXOXXOOOXXOOXOXOOOXXOXXOXOOXOOOOOOOOOOOOOOOO
OXOXOOOOXOXOOOOXXOOOOOOOOXXOOOXOOOOOOOOOOOOOOXOOOOOOOXOXOXXOOOOXOOOXOXXXOOXOOOOOOOOXXXOOXXOOXOOOOXOOX
OOOXOOOOOXXOOXOOOOOXOOXOOXXXOXOOOXOOOOXXXXXOOXOXXOOOXOXOOXXXOOOOOXOXOOOOOOXXOOXOOXXXXOOXXOXOXXOOOOOOO
OOOOXOXXOOXXOOXXXOXOOOOOXOOXOXOOOXOOXOOOOOOOOOOOXOOXOOXOXXOOOOXOOOXOXOOOOOXXXXOOXOOOOXXOOOOOOOOOOOXXO
XOXOOOOOXOOXOOOOOOOOXOXOOXOOOOOXOOOXOOOOXOXXXXOXOXOOXXOOXOOXOOXOOOXOOOOXOXXOOXOOOXXXOOOOXXOOOOXOOOOXO
XOXXXXXXXOXOOOOXOOOOOXXOOOOXOXOOOOOXOXXXOOOXOOXOOOOOXOXOOOOXOOOOXOXOOXOOOXXOOOXOOXOOXOOXOOOOOXOOXOXOO
OOXOOOOOOXOOOXOXXOOXXXXOOXOOXOXXOOOOOOXXOXXOOOOXXXXXXOXOOXOXOXXOOXOXXOXOOXOOOOXOOOOXOXXXOOXXOXXOXOOXO
XXXOOXOOXOXOXOOOOOOOOOXOOOXXOOXXOOOOOXOXOOOXXXOXOXOOXOXOOXOOOOOOOOOOOOOOOOXOOXOXOOOXOOOOOOOOOOOXXOXOO
OXXOOXXOOXXXOXOOOOXOXXOXXOOOXXOOXOOOXXOOOXOOOXOOXXXOXXOOOXXOXOXOXOXOOXOOXXXOOXOOOOXXXOXOXOOXOXOOOOOOX
OOXOOOXOOOXOOOOXOXOOOOOOOOOOXOOOOXOXOOXOOOOXOOOXXOXXOOOOOXOXOXOXOOOOOOXOOOOOXOOXOXOOOOXOXOXXOOOOOOOOX
XOOOXXOOOOOOOOOOOOOOOOOXXOXOOOXOXOOXOXOXXXOOXOOXXXXOXOXOOOXOOXOOOOOOOXOOXOXXOXOXOOXXXOOOOOOXOOOOXOXOO
OOXOOOOXOOOOXOOOOXOOOOOOXOOOOXOXXOXOXOOXOOOOXOOOXOXOOXXOXOXOXOOOOXXOOXOOXOXXOOOOXXOOXOXXOOOOXOOOOXOXO
OOOXXOOOXOOOOOXOOOXOOOOOXOOOXXOOOOXOOOOOOOOOOOOOOOXOOOOOOXOXOOOOXOXOXOOXXOOXXOOOOOXOXOOOXOOOOXOOXXOOX
OOOOXOOXXOXOOXOOOOOOOOXXOOOXXXXXXOXXOOOOOOOOOXOXOXOOXOXOXOOOXOXOOOXOOOOOOOOXOXOXOXOOXOXOOOXOOOOXOOOOO
OOOXOXXOOOOOOOXOOOOOOOOXOXOOOOXOXOOOOOXOOOXXOXOOOOOOXOOOOOOXOOOOOOOXOXOOOOXOXXXXXXOOOXOOOOOXOOOXOOXOX
OOXXXOOXOOOOOOOXOOXOXOXOOOXXOOXXOOOOXXOXXXOOXXXXOOOXOOOOOOXXOOXOXXOXOOXXOOOOOXOOOOXXOOOOOXOOOOXOXXOOO
OXOXOOXOXXXOXXOOOXOXOOOOOOXOOOOOOOOOOOOOOXOOOXOXOOOXOOOXXOXOOXOOOXOXOOOOOOXOXOOOOOOOOOXXOOOXXXXOOXOXO
OXXOOXOXOOOOXXXOXOOOXOOOXOXXOOOOOOXXXOOOOOOOOOXOOOOXOXOXOXOXOOOOXXOOOXOOOOOOOOXXXOOOOXOOXXXOXOOXOOXXO
OOXXOOXXOXOXXOXOXXOXXOOOOOOOOOXOOXOOOOOXOOOXOXXOOXOOOXOOXXXOOOXOOXXXOOOOOOXOOOOOOOOOOOXOXXOOOOXOOOOOO
XOOXXXXXXXOOXOOXOXOXOOXOOOXOXOXOOOOOOXOOOXOXOOOOOOOXOOXOOOOXOXXOXXXOOXOOOOOOOOOXXOXOOOOOXOOOOOXOOOOOO
XOOOOOOOOXXOOOOXOOOOOXOOXXOXXXOOOOOXOOOOOOXOOXOOOOOOXXXOOXOOOXOOXOOOXOOOXOOOOXOOOOXOXOOXOXXOOXOXXXOOX
XOOOOOOXOOOXXOXOOOXOOOOOOOOXOOOOOOXOOOXXXXOXOXXXXOOOOOXOXOOOOOXOOOOOXOOOOXOOOOOOXOXOOOXOOOOXOXOOOOOOO
OOOOOOOOOXOOXXOOOOOOXOOXXXOOOXOOOOOOOOOOOOOOOXOOXOOOOOOOOOOOOXXOOOOOOOOXXOOOOXOXOXOXOXOOOXXXOOOXOOOOO
OOOXOOOOOOOOOOOOXXXOOXOOXOOOXOOOXXOOOXOOXXOOOXXOOOXXXXXOXXXOXXXOOOOOOOOOXOOOOXOXOOOOXOOXOOOXOOXOXOXOO
OOOOOOOOOOOOOOXXXOOOXOOOXOOOXOOOXXOOXOOXXXOOXOOOXOOOOXXOOOOOXOOXXOOOXOOOOXOXOOOOOXXXXOOOOOXOOOOOOXXXO
OOOOXOOOOOOOOXOOOOOOXOOOXOOXXOXOXOOOOOXXXOXOOOXXOOOXOOOOOOOOOOOOXOXOXOOXXOOOOOOOXOOOOXXOOXOXXXOOOOXOO
OOXOXOOOOXOOXXXOOXOOOOXOOOOOOOOXOXOXOOOOXOOOOOXOOXXOXXOOOOOOOOOOXOXXXOXOOOXOOXOXOXXOOXOXXOXXOXXOXOOOO
OOOXOOXOOOXOOOOXOXXXOOOOOOOXXOXOXXOOXOOOXXOOOXOXXOXOXOXOOOOOOOOOOOOOOXOXXOOOXOOOXOXXOOOOOOOOOXXOOOOOO
XXOOOXXOOOOOOXOOOOOOOOOOXXOOOOOOOOOOXXXXOOOOXOXOXXXOXOOOXXXOXOOOOOXOOXOXOXOOOOOOOOOOOXOOOOOOOOXOXXOOO
XXOOOOOXOOXOXXOOOOXXOOOOOXOXXOOOXOXOOOOOOOXOOXOOXOOXOOOXOOOOOXOOXOOXOOOOXXOXOOXXOXXOOOOXOOXOOOOXOOOXO
OOOOOOOOXOOOOOXOOOOOOXOOXXOOOOXXOXXXOOXOOXXXOOOOOOXOOOOOXOOXOOXXXOOOOOOOOOXXOOOOOOXOOOOOOOOXOXOOOOOOO
OOXOOXXOXOOXOOOOXXXOXOXXOOXXOOXOOOXXOOXOOOOOXOOOOOOXOOXOOOOOOOOOXOOOXOOXOOXXXOXXOOOOOOOXOXOOOOOOOOOXX
XXOOOOOOOOOXXXOOOOXOOOXOXXOOXOOOOXOOXOOXOOXOOOOOXOOOXXXXXOXXOOOOXXOOOXXOOOOOOOOOOOOOOOXXOXXOOOOXXOOOX
OOXXOXOOXOOOXXOOXOXOOOOOOOOOOOXXXXOOOOOXOXOOXXOOOOOXOOXXXOXXOOOOOOOOOOOOOOXOOOOOOOOOXOXOOOOOOOOOXOXOX
OOOOOXXOOXXOXXXOOXOXXXOOOOOOXOOXXXOOOXOOXOOOOOOXOXOOXXOXOXOOOXOOXOOXXOXOXOOOOOOOXXOXOXOOOOOOOOXOXOOXX
OOOOOOOXOOXXXOOXOOXOOOOOOOXXOOXOXXXOOOOXOOOXXOXOXXXOXOXOOOOOXXOXOXOOOXOOXOXXXXOOXOXOOOOXOOOOOXOXOOOOO
XOXOOXOOOOOOOOOXOOXOOOXOOOOOOOXOOOXOOXOOOXOOXOOXXXOXOOOOXXXXOOOXOOOOOOOXOOOOOOXOOXXOOOXXOXOOXOOOOOOXO
OOXOOOOOXXOOOXOOOOXOXOOXOOOOOXOOOXOOXOXOOOXOOOXOOXOOXOXOOXXOOOOXOOOXXXOXOOOXOOXOOOXOOOOOOOOOXOOOOXOXO
OXOOOXOXOOOOOOXOOOOOOOXOXOXOOOXOOXOXOOXXOOOXXXOXOOOOXXOOXOOOXXXOOOXOOOXOOOXOOXOOXOOOXOXOOOOXOOOOOXXXO
OOOOXOOXXOXOOOOOOOXOOXOXOXXOXOXXXOOXOOOXOOOXXXOOOOOXOXOXOOXOXOOXOOOOOXOXOXOOXXOXOOXOOOOOOOOOOOOOXXXXO
XOXOXOOOXXOOOOOOOOOXOOOOXOXXOOOOOOOOOOXOOOXOOXOOOOOXXOOOXOXOOOOXOOOXOOXOOOXOOOOOOOOXOXXXOXXOOOOXXXOOO
OOXXXXOOOXOXOOXOOXOOXOOOOOOOOOOOOOOOOOOOOOOOXXOOOOOOOOXOOOOXXXOOOOXXOXXXOOOOOXXXXOXXOOXOOOOOOOOOOXXOX
OXXOXOXOOOOOXOOOXOOOXXOXXOOOOOOXXXOXOOOOXXOOOXOOOOXOOOOXOXOOOXOOOOXOXOXXOOOXOOXOOOOXOOOOOXOOOOXOOOOOO
OOXXOOOOOXOOOOOOOXOXOXXOOOXOOXOOOOOOOXOOXXOOOOOOOOXXOOOOOOOOOOOXOXOOXXOOOOOOXOOXXOOOOXXOXOXOOOOXXXXXX
OOOOOOXOOXOXXOOXOOOXOOOOXXOOOOOXOOXOOOXOOOXXXXOXOOOXOOOXXOOOOXOXOXOOXOOOOOOOOOOOOOOXXOOOOXOOOXOOOXOOO
OXXOOOXOOOOXOOOOOXOOOOOOOOXOOXOOXXXOOXOXXOOOOXOXOOOXXXOOOXOOOOXXOOOOXOXXOXOOXOXOOOXOOXOXOXXOOOXXOXOOO
OXOXOOOXOOOOOXOXOOOXOOOOXOOOOOXXXOXOOOXOOXOOOOOOOOXXXOOOOOOOOXOOOXOXOXXOOXOXXOOOOOXXOOOXXOOOOXOOXOOXX
OXOOXOOOXOOOXXOXOOOXXXOXOOOOOOXOOXOXOXXOOOOOOOOOOXOOXOOOOOOOOOXOXOOOXOOOXOOOOOOOOOXOOOOOOXXXOOXXOOOXO
XXOOXOXXOXOOOOOOOOOOOOOXOOOXOXOOXXXXOOXXOOXOXXXXOXOOOOOOOXXXXOOOOOXOXXOOOOOXXOOXOOXOOOXOOOOXXXOOOXXOO
OXXOOOOXOOOXOOXOOOOOOXXOOOOOOOXXOOOXOOOOXOOXOXOXOOOOOXOOOOOXOXXXOOOOOXOOOOOOOXOOOOXOOOOOXOXOOOXOXXOOX
XXOOOOOOOXXOOOOXXOXOXOOOXOXXOOOOOXOXOOXXOXOXOOOOOOOXOOXOXOOOOOOOOOXOOOOXOOOOOOOXXOOOOOOOXXOOOOOOOOOXO
OOXOOOOOOXOOOOOOOXXXOXOOOXOXXOOXOOOXOXOOOXOXXOOOOOOOOXOXXOOOXXXXXOXOOOOOXOOOOOOOOXXOOOOXOXXOOXOOXXOOX
OOXXOOOOOOOXOXOOOOOXXOOXOOXXXXXOOXXOOOXXXOOXOXOOOOOOXOOOOOOOOOXOOXOXOOOOOOXOXOOOXOXOOOOXOOOOOOOXXOOOO
OOOOOXOOXOOOXXOXXOOXXXXXXOOXXOOOOOOOOXXOOOOXOXOOOOOOOOOOOOOOOXXXOXOOOOOXOOOOOOXOXOOXXOOOOOOOOOOOXOXOO
OOOOOOXOOXOOOOOXOOXXOXOOOXXOOOOOXOXXOXOOOOXOXOOOOXOOOOXXOXOXOOOXXXOOXOOXOXXXXOOOXOOOXXOOOXXOOOOOOOXOX
OXOOOXOOOOOOOOOXOOOOOOXOXOOOOOOOOXOOOXOOXOOOXOOOXXXOOOOOXOXOOOXXOOOXOXOOXOOOOOOOOXOOOXOOXOOOXOOOOOXOO
OOOOOXXXXXOOOXOOOOOXOOOOOXXOOXOXXXOOXOOOOOOOOOOXOXOOOOOXOOOOXXOXOXOOOOOOOXOOXOOOOOXOXOOOOXOOXOOOOOOOO
XOOOOOXOOOOOOOOOOOOOXOXOOOXXOXOOOOOXXOXOOOXOOOOOXOXOXOOOOOOOOOXOOOXXXOXOOOXXOOOOOOOOXXOXOOXXXOOXOOXOO
OXOOOOOOOXXOOOOXXOOXXXOOOOXXOOXOOOOOXOOXXOOXXOOOXOOOXOXXOXXOOXXOOOXOOXOOXXXOXOOOOXOOXXOXOOOOXOOOOXOXO
OOOOOXOXXOOOXXOOOOOXOXXOOOOXOOOXOOXXOXOOOOOOXXOOXXXOOXOOOOOXXOOOOOOXOXOOOOOOXOXOOOXOOOOXOOOOOOOXOXXXX
XOOXOOXOOOOOOOOXOOXOXOOOOXOOXOOOXXOOOXOXOXOXXOOOOOXXOXOOXOOOOOXOOOOOXOXOOXXOOXOXXOXXXOOXXOOOOOOOOOXXX
