XOOOOOXOOOXOOOOOOOOOOOOOXOOXOOOOXOOOXOXXOOXOOOOOXOXOOOXOOOXOOOOOOXOOXOXOOOXXXOOXOOOOOOOOOXOOOXOOOOOOO
XXOOOOOOOOXOOXXOOOXOOOOOOXXOXXXOOXXOOOXOOOOOOOXOOXOXXXOXOOOOXOOOOOXOOOOXXOOXXXXOOOOOOOOOOOOOXOXOOXOOO
XOXOXXXOXOXOOOOOOXOXXXOXOOOXOOOOOXOOOOXXOOOXOXOOOOOOXOOOXOOOOOOOOXOOOOOOOOOOXXOOXXOXOOXOXOOOOXOXOOXOO
OOOOXOXOOOOOOOOXOOXXOOXOOOOXOXOOXOXXOXOOOOOOOOOXOOXOXOXOOOOXOOOXXXOOXOOOOOOXXOXXOOXOOXOOOOXOOXXOOOXXX
XOOXOXXXOOOXOOOXXOOXOOOOXOOOOOXOOOOXOOOOOXOXXXOOOOXXOOOOXOXOOOOOOOOOOOOOXOOOOOOOXOXOOXOOOOOXOXXOXOOOO
XOXOOOOOOXXXXOXOOXOOOOOXOXXOOOXXOXOXOOXXOOOOOOOOOOOOOXOOOOOXXXOXOXXOOOOOOOXOOXOOXOXOOXXOXXXOXOXXOOOOX
OOOOOOOOOOXXOOXOXOOOOOOOOXOOOOXOXOOOOOXXOOOOXXXOXXXOOXOOXXXOOOOOXOOOOXXOOOOOOXOOOXOXXXOOXXOOOOXXXXOXX
XOOXOOOXOXOXOOOXOXOOXOOOOOXOOOXOOOOOOOXOOOOOXOOXOXOOOOOOXOOOOXOXXOXOOOOXOOOOOXXOOOXOXOXOXOXXXOOOXOOOO
OXOOOOXXOOOOOXXOOOOXOOOXOOOOOOOOOOOOXXOOXOOOXOOOOOOXOOXOXXXXOOOOOOOXXOXOXXOOXOOOOOOXOOXOXXOOXOOOOOOXO
OOXOXOOXXOXOOOXOOOOOOOOOOOOXXXXOXXOOXOOOOXXOOOOXOOXXOOXOOOOOOOOXXOOOXXXOOOOOOXOXXOOXOOXOOOOOOXOOXOOOO
OXOOXXOXOOOOXOOXOOOOOOOXOOOOOXOOOXXXXXXOOOOXXOXOXOOXOOOOOOOOOOOXOXOOOXOOXOOXOOOOOOOOOXXOOOOOOXOOXOOOO
OOOOOXOXOOXOOXXOOOOOOOOOOOOXOXOOXOOOOOOXOOXOOOOOOOOOOOOXOOOOOXOOOOXXOXOOOOOOXOOOOOOOOOXOXOXXOOOOXXOOO
OOOOXOOXOOXOOOXOOOOOOXOOOXXXOXOOOOOOOXOOOOXOXXOOOOOXXXOXOOOXXOXXOOXOOOXOOOXOOOOOXOOOOXOOXXXOOOOXOXOOX
OOOOOOOOOOXOOOXOOXOXOOOOXOOOXOOXOOOOXOOOOXXOOOOXXOOOOOOXOOOOXOOOXOOOXOXXXOXOOOOXXXXOOOXOOOOXOOXOOXOOX
OOXOOXOXOXOOOOXXXOXOOOXOOOOXOXOXOOOXOOOOXOOOOOXXOOOOXOOOOOOOXXOXOOXOOOOOXOOOOOOOOXOOOOOOXXOOOOXOOXOXO
OOOOOOOOOOOXOOXXOOOOOOOOXOXXOXOXOOOOOOOOXOOOOOOOXOXOOOOXOXOOOXOOXXOXOOOXOOOOOOOXOXXOXXXOOOOXOXOOOXOOX
XOXXXOOXOOOOXOOOOOXXOOOOOXOOXOOOXOOOOOOXXXOOOXXXOXOOOXXOOOXOOOOOOOXOOXXOOOOOOXOOOXOXOOXOXOOOOOOOOXXOO
XOOXOOOOOOXXOOOXOXOOOXOXOOOOOOXOOOOOOXOOOOXOXOOOOOOOOXXOXXOOOOOXOOOOXXOOOXOOXOOOXOOOOOXOOOOOOXOOXOOOO
OOOXXXOOOOOXOOOOXOOXXOOOOOXOOOOOXOOOOOOXOOOXOOOOOOOOOOOOOXOOOOOOXXOOOXXOOXXXXXOXOXOOXOXOXXXXOOOOOOOOO
XOXOXOOXOXOXOOOOXOXOOXXXOOOOOOOOXOOOOOXOXOOOXXOOXXOOOXXOXXOXOOOOOXOOOOOOOXXOOOOXOOXOOOXXOXOXOOXXOOOOO
OXOOOOOOOOXOOOOOXOOXOOOOOXOOOOOXOOOOOOXOOXOOOOOOXOXOXOOOOOOOOOXOOXOOOOXOOOOOOXOOOOOOOOOXXOOOOOOOOOXOX
OXOOOXXOOOXOXOXOOOOXOOXXOOOOOXXOOXOXOOOXXOOOOOOOOXXOOOXXOOOOOOOXXOOOXXOXXOOOOOOOOOOOXOOOOOXXOXOXOXOOO
OXXXOOXXOXOOXOXXXOOOXXOOXXOOOXXOOOOOOXOXOOOOOXXOOXOOXOXOOOOOOOOXOXXOOOOOOXOXXOXOOOXOOXXXOXOOOXXOOOXOO
OOXOOOXOOOOXOOOOOXOXOXOXOOXXOOOOXXXOXOOOXXOOOOOOOOOOXOOOXOOXOOOXOOXOOOOOOOXOOOOOOOXOOOXOOXOOOOOXOXOOX
OOOOOOOOOOXXOOOOOOOXXOOOOOXOOOOXOXOOOOXOOOOOOOOOXXOOOOOXXXXOOOOOOOOXOXXXXOXOOOXXOXOOOOOXOOXXXOOOOXXOO
OOXOOOOOOOXXOOOOOXOOXOOOOOOOOOOOOXOOOOOOOOXOOOOOOOOXOOOXXOOOOOXOOOOXOOOOXOXOOOOOOOOOOOOOOOXOOOOOOOXOO
XOOXOOOOOOOOOXOOXXOOOOOOXOOOXOXXXXOOXXOOXOOOXOOXOOOOOXOOOOXOXOOOOOXOXXXOOOOOOXOOOXOOOOOOOOOOOOXOOOOXO
OXXOXXOOOOXOOXXOOOOOOOXOXOXXOOOOOOOOXOOXXXOXOOXXOXOOOOOOXXOOXOOXOXXXOOOOOOOOOXXXOOOOOOOOOOOXXOXXOOOXO
OOOOOOOOOOOOOOOOOXOOOXXOOOOOOXXOXOXOOXOOOOOXXOXXOOXOXOXXOOXXOOOOOOXOOOOOOXOOXOOOOOOXOOOOXOOXOOOXOXOXO
OXOOXOOOOXOOOXOXXOOXOOOOOXXOOXOOOOOOOOOOOOXXXXOXOXXOOOOOXOOOOOOOXXOXOOOOXOOXXOOOXXXOXOOOOOOOOOOOOXOOO
OOXOOOXOOOOOOXOOXXOOXOOOXOOOOOOOOXOOXXXOXOOOXXXOOOOOOOOOOXXOOOOXXXXOOOOOOOOOOXOOOOOOOOOXOOXOOOXOXOOXO
OOXXXXOOOOXOOOOOXXXXOOOOOOOOOOOOXXOOOXXOXXOOXOOOOOOXXOOOOOOXOXXOXOOXXXXXOOOOOOOOOXOOXXXXOXOOOOOOXOXOO
OOOOOXOXOXOXOOXXOOOOOOOOOOOOOOOOOOOOOOOXOOXOXOOOXOXXOOOOXOXXXOOOOXOOOOOOXXXXOOOOOOXOOOXXOOOOOOOOOOXOO
XXOOOOXXOOOOOOOOXOXXOOOXXXOOOOXOOOOOOOXXOXXXXOXOXOOOXOXOOOOOXOOOOOOXXOOOOOOOXOXOOOOOOXOOOOOOOOXOOXOOO
OOOXXOXOXOOOXXXOOOOOOXOXOXOOOOOXXOOOXXOXOXOOOXOXXOXXXXOOOOXOOOXOOOOOOOXXXOOXOOOOOOOOXOOOOXOXOOOOOOOXO
OOOXOOXXXOXOOXOOOXOXXXOOXOOOXOXOXXOOOXOOXXOXOOXOXXXOXOXXOXOOXOOOOOXOXXOOOOXOXOOXXOXOXXOOOOOOOOOXOOOOX
OXXXOOOOOOOOOXXXOOOOOOXXOOOOXOOOOOOOXXOOOOXOOOXXOOOOXOOOXOOOOXXOOOOXXXOOOXOXOXOOOOOOXOOXOXOOOXOOXXOOO
XOXOXOOOXOXXXOOOOXOXXOOXOOXOXOOXXXOOOOOOXOXOOXOOXXOOXXOOOOOOOOXOXOXOOOOOXOOOXOOOXOXXOOXOXOOOOOOXOXXOX
XOOOXXXOOOOXOOXOOOOOOXOOOXOXXOOOOOOXOXXXXOXOXOOOOOOOOOOOXOXOXOOOOXOOOXOOOOXOOOOOOXOOOOOXXOXOXOXXOOOOX
OOOOOOOXOOOXOOXOXOOOXXOXOOOOXOOOOOOXXOOOXOOOOXOOOOOOOOOXXOOXOOOXOOOXOOOOOOXOOOOXOXOOXOOXOOXOOXXOOXOXO
OXOOXOOOOOOOXXOOXXOOOOOXOOOXOXOOXXXOOOOXOOXXOOOOOOOOXXOOOXOXOOOOOOOOOOOOOOXOOOXOOOOOOOOOOOOXXOXOOOOXX
XOOXOXOOOXOOXOOXXOOOOXXOXOOOOOOXOXOOXOOOXXXXOXOOOXOOOXXOOOOOOOOOOOOOXOOXOOXOOOOOOOOXOOXOOXOXOOOOOXOOX
XOOOXOXOXOOOXOXOXOOXOXOOOOXXOXOOOOOXOXXOOOOXXXOXOOXOXOOOOXXOOOOOXXOOOOOXOOXOOOOOXOOOOXOOOOOXXOOOXOOXO
OOOOOOXXOOOOXOOOOOXXXOOOXXXOXOOXOXOOOOOXOOXOXOOOOXOXXOXOXXOOXOOXOOXOOOOXOOOXOOOOXOOOOOOOOXOXOXOXOXOXO
OXOOXXOOOOOOOOOOXOOOOOOXXOXXOOOOOOOOXOOOOOOXXOOOOOOOXOOOOOOOXOOOOOOOOOOXXOXXOOXXOOOXOOOOXOOOOOXOOOXOO
OOOXOOXXOOOXOXOOXXOOOOXOOXOOOOOXOXOOOOOXXXOOXOOOXOXOOXOXOOOOOOOOOOOOOOXOXOOOOXOXXOOOOOOOXOXOXOOOOOOOO
XXOOOXXOXOXXXOOOOOOOOOXOOOOOOOXOOXOOOXXOOOXOOOXOOOXOOXXOXXOOOXXOXOOXOOOOOOXXOOXOOOOXXXOOOOXXOOOOXOOOO
OOOXXOXXOOOOOOOOOOOXOOXOXOXOOOXOOXOXOXOOOOOOOOOOOOXXOXOOOXOOOOOXXXXOOOXOXOXOXXOOOXOXOOOOOOOOOOXXOXOOO
OOOOOOOOOOXOXOOOXOOOOOOXOOOOXOOOXOXXXOXOOXOOOOXOXOOXXOOOOOOOOXOXOOOOXOXXXXOXOOOOOXOXOOXXOOXXOOOOOXOOX
OOOOOOOOXOOOXOXOOOOOOOOOXOOOOOOOOXOOOXOOXOOXOOOOOXOXOXOOXOOOOOXOOXOOXXOOXXOOXOOOXXOXOOOOXOXOOOOOOOXOX
XXOOOXOXOXOOOOOXOOOXOOOOOOOXXOXOXXOOOOXOOXOOXOOOOXOXOXOOOOOXOOXXOOOXXOOXOOXXXOXOOOOOOOOXOOOOOOXXOOOOO
OXXOOOOXOOOOOOXOOOOOOOOOXXOOOXXXOXOOOXXOOOOOXOOOOOOOOOOXXXXOOOXOXXOOXOOOXOOOOOOXOXOOOXOOXOXOOXOXOOXOX
OOOXOOOOOOOXOOOOXXOOXOOOOOOOXOOOOOXOOOXOOOOOOOOOXOXXOXOOOOXOOOOOXOXOOXOXOOOOOOOXOXXOXOOOXOOOOOXXOOOXO
OOOOOXXOOXOOOXOXXXXXOXOOOOOOOOOOOXOOXXXOOOOXXXXOOXXOOOXXOOOOXOOOXOOXOOOOOXXOXOOOOOOOOXXOXOOXXXXOOXOOX
OOOOOXOOOOXOOOOOXXOXOOOOXOOOOXXOOXOOOXOOOOOXOOOOOXOOXOOOOXOOXXXOXOOOOOOOOOXOXOOOXOOXXOXXXOOXOOXOOOOOX
OOOXXOXOOXXOOOXOOOXOOXXOOOOOOOOOXOOOOOOOOXOOOOOOOOOOOOOXXXOOXOXOOOOXOOOXOOOXOXOOOOOOOOOOOXOOOOOXXOOOO
XOXXOOXOOOXOOOOXOOOOOOXXOXOXOXXOXOOXOOOOXOOXXXOXXOOXOOOOOOOXOXOXXOOOOXOXXXXOOOOXXOXOXOXOOOOXXOOOOXOOO
XOXOXOOOOOXOXOOXOOXOOOOOOOOXXOXOOOOXXOOXOXXXOOXOOXOXOOOXOOOXOOOOXXXOOOXXOOXXOOXXOOOOXXOOOOXOOOOOOOOOO
XOOOOXXOXXOXOXOXOOOOOXOOXOXXOOOOXOOXXOOXXOXOOOOOOOXXXOXOXOXOOXOOOXXOXOOXOXOOOOOOOXOOXOOOOOOXOOXXOXXOO
OOOOOOOOXOXOOOOOOOOOOXXOOOOXOOOOXOOOOOOXXXOOXOOOOOOOOOOXOOOXOOOOOXXOOOOOXOOXOOXOOXOOOXOXOOOXXOOOOOOOO
OOXOXOXOOOOOOOOOOOOOOOOOOOXOXOXOXOOOOOXOXOOOXXXXXOOXOOOXXOXXXOXOOOOXXOOOOOXXOOOOOXOOOOOXXOOOXOXXOOOOX
OXOOXOOOXOXOXOOOOXOXOXOOXOXOOOXXXOOOOOXOOOOOOOOOOOOXOOXXOOOOOOOXXOOOXOOXOOOOOOOXOOOXOXOXOOOOOOOOOXOOO
XXOOOOOOOOOOXOOOOOXXOXXOXOOXOOOOOOXOXXOOOXOOOXXXOOOOOOOOOXXOOOXXOXXOOXOOXXOOOOOOOOOXOXOOOXOOOOXXOOOOO
OXOOXOOOOXOXOOXXOOOOXOXOOOOOOOOXOOOOOOXOOOOOXXOOOOXOXXOOOOXXOOOOOOOXOOOOXOOOXOOOOOOOOOXOOOOOOOXOOXOOO
XXOXOOOXOOXOOOOXXOOXOOXXOOOXOXXOOOOOOOOOOOOXOOOOXXOOXOXOOXOOOXXXXXXOOOXXOXXOOOXOOOOXOXOOOOOOOOXXOOOXO
XOXOOOXOOXOOOXOOOXOOOXXOOOOOOOOOXOOOXOOOXOOOXXXXXOXOXOOXOOOXXOOOOOXOOOOOOOOOXXXOXXXXOOXOOOXOXOOOXOOOX
OOOXOOOOOOXOXXOOOXOOXXOOXOOXOOOOOOOOOOOOOXOOOOOOOOOOOOOOOOOOOOXOOXOOOOOOOOOXOOXOOXOOOXOOOXOOXXOOOXOOO
OOXOOXOOOOOOOOOXOOXOXXOOXXOOOXOOOOOOOOOOXOOOOOOXOOOOOXXOXOXXXOOOOOXOOOOOOOOOOOXXOOOOOXOOOXXOOXOXXOXOO
OOOOXOXOXOXOOOOOOOOXXOOOOOOOXOOOXOOOOOXXOOOOOOXXOXXOXOXXOOXXOOOOOOOXOOOOOOOOXXXOOOOOOOOXOOOOXOXOOOOOO
OXOOXOOOXOOOOXOXOOOOOOXOXXXOOOOOOOOXXOXOXOXOOOOOOXOOXOOOOOOOOXOXOOOOXOOOXXOXOOOOXXOOOOOXXOOXOOOOOOXOO
OXOOXOOOOOXXXOXOXXOXXXOXXOOOXOOOOOOXOXXOOXOOXOOOOOOOOOXOOOOOOOXXXOOOOOXOOXXOOXOOXXOOOXOOOOXOOXOOOOXOO
OOOOOOXXOXOXOXXOOXOOOXXOXXXXXXOXOOOOOOOOOOOOXOOOOOOOXXOOXOXOXOOOXXXOOOOOOOOXXOOOXOOOOOOOOOXXOOXOOXOOO
OXOXOXOOXOOXOOXOOOOXOOOOOOOOXXXOXOOOOXOOOXOOOXXOXXXOXOOOOOOXXOOOXOOOOXOOOOOXOOXOOOOOOOOOXOXXOXXOXOOOO
XOXOOXOXXOOXOXOXXOOOOOXOOXOXOOOOOXOOOXXOOOXOOOOXOOOXOOOOXOOXOOOOXOXOXXOOXOOOOXOXOOOXXXOOXOOOOOXOOOXOO
OOOXOXOXOOXOOOOOOXXOOOOOOOXOOOOXOXOOXOOXXOXOOOOOOOOOXOXOXXOXOXOXOOOOOOOOOXXOOXOXOXOOOOXXOOOOOOOOOOOOX
OOOOOOOOXXXOXOOOOOXOXXOOXOOOOOXXOOOOOOOXOOOXXXOOXOOOXOOXOXOOOOXOXOOXXXOOOOOXOOOOOXOOXOXOOOXOOXXOOOOOO
XXOOOOXXOOOOOXXOOXOXXXOOOOOOOOOXXOXXOOXOOOXOXOOOOXXOOXOOXOOOOOOOXOXOOXOOOOOOOOOOOXOOXXOOOOXOOXOOOXOXO
OOOOOOOOOOXXOOXOXXOOOOOOOXXOOOOOOOOOOOXOXOXOXOXOXOOOOXOXXXOOOXOOOOXOXOOXOXOXOXOXOOOOXXXOOOOOXOOXXOOXX
XOOOOOOOOOXOOOXOOXOOXOOXOXOOOOOOOOOOOXOOOOXOOOOOXOXOOXOOOOXXOOXXOOOOOXXXXXOXXOOXXOOOXOXOOOOOXOXXXOXOO
OOXXOOOOXXXOXOXOOXOOOOOOOOXXOOOOOOXOOOOOOXOXOOOXOOXXXXOOOXOOOXOOOXOXOOOOOOOOXOOOOOOXOXOOXOOOOOOXOOOXO
XOXXXXOXXXOXOXOOOOOOOOOXOXOXOXOOOOOXOOOOOOOXXOOOOOXOOOXOOOOOOOOOOXOXOOXXOXXOOOXXXOOOOXOXXOOOOOOOOOXOX
OXOXOXXOOOOOOXOXXOOXOXOOOOXOXOOXXOOOOXOXOOOOOOOOOXXOXOOXOOOOOOOOXOOXXOXOOOOOXXOXOOOXOOXXOXOOOOXOOOOXO
OXOOOOOXXOOOOXOOXOXOOOOOOXOXOOXOXXOOXOXXXOOOXOOOOOXOOOOOOOOXOOXXXXOOXXXXOOOOOOOOXXOOXOOOOXOOOOOOXOXXX
XOXOOOXOXOXOOOOOXOXXXOOOXXOOXOOOXOOOXXOXXXOXOOOOXOXOXXOOOOXOXXXOOXXXOOOOOXXXOOXXOOOOXOOXXOOOOOOXXOOOX
OOOXOOOOOOOOXOOOOOOXXOXXXOOOOOXOXOOOOXXOOOXXOOOOOOOOXXXXOOOXXOOOOOOOOOOOXXOXOOOXOXOOOOOOOOOOOXOOOOOXO
OOXOOOOXOOOOOOOOOOOOOXOOOOOOXXOOOOOOOOXOOOOXOOXOOXOXOOXOOOOOXOOXOOXXXOOOOOOXOOOXOOOXXOXOXOOOXOOOOXXOO
OOOOOXOOOOOOOOXOOOOOXOXOOXOOOOXOXXOOXOXOOOOOOOXOOOOXOXOOOOXOXOOOOOOXOOOXOOXOOXOOOXOOOOOOOOXOOOXOOOOXX
XOXOOOXOOOXOXOOOXOOOOOXOOOXOOOOOXOOOXOXXXOOXOOOXOXOXOOOOOOXXOXXOOOOOOOOOOOOOOOOOOXXOOOOXOOXOXOOOOOXOO
XOOOOOOOOOOOXOXOXOOOOOOXOOXOOXOOXXOOXOXOXOXOXOOOXXXOOOOOOXOOXOXOOOOXXXOOOXXOOOOXOXOOOOOOOOOOOOOXOOOOO
XOOOOXOOOOOOOXXOOOOOOOOOOOOXXOOOOXOOOOOOOOOXOXOOOOOOOOOXOXOOXOOOOOXOOXOOXXXOXOXXOOOOOOOOOOOXOOOXOOXOO
OOOOOOOOOOOOOOXOOXOOOXXXXXOOOOXOOOXOOOOOOXOOOOOXXOOOXOOXOOOXOOOOOXOXOOXOOXXOOXOOXOXOXOOXOOOOOOOOXOOOO
OOOOXOXOOOXOOOOXXXOOOXXXOXXXOXXOOXOOXOOXOXXOOXXOOOOOXOOOOOOOOOXXOOXOXOXOXXOOOOXXOOOXXOOOOOOXOXOXXOOOX
XOXXOOOOXXXOOOOXOOOXOXXXOOXXXXXXXOXOOXXXOOOOXOOOXOXOOXOOOOOOXXXXXOXOOOXOOOOOOXOOXOXOXOOOOXOXXXOOOXOOX
OOOOXOOOXXOOXOOOOOOXOOXOOOOOOOXOXOOOOOOOOOXOOOXOOXOXXOOOOXOOOOOXOOOXOOOOOOXOXOOXOXOXOOXOOOOXOXXOXOOXO
OXOXXOOOOOXOOXXXOOXOXXOOOOOOOOOXXOOOOXOXOOOOOXOOOOOOXOXXOOOXOOOOOOXOXOOOXOOOOXXOOXOOOOOOOOOOOXXOXXOXO
OOOXOOOOOXOXXOXOOOXOOOXXOOOOOXOXOOOXXOOOOOXXOOOOXOXOOOOOXOOOOXOXOOOOOXOXXOXXOOXXXOOXXOXOXOXOXXXXOOXOO
OOXOXOXXOOXOXOOOOOOOOXXXXOXOOXOXOXOOOXOXOXOXOOOOXOXXOXOOOXOXOOOOXXXOOOOXXOOXXXOOOXXOOXOXOOXOOOOXOXXXO
OOOXXXOOOOOXOOOXOOOXOXOOOOOXOOXOOXOXOXOXOOOOOXXOOOOXOOXOOOOXOOXOOOOOXOOXOOOOXOOOOXXOOOOOXOOOOOOOOOOOX
OXOOOXXXOOOXOXXXOOXOOXXOOOOOOOOXOOXXOOXOOOXOOOOOOOOXOOXXOOOOOOOOXOOOOXOOOOXOOXOOOOOOOXOXOOOOOXXOOOXOO
XOOOOOOOOXXOOXOOOOOOOXXOOOOOOOOOOOOOOXOXOOXOOOXOOOOXOOOXXOOOXXXOXOOOXXOOOXXOXOOOOOOOOOOOOOXXOXXXOXXXO
OOOOOOOXXOXOOXOOOOXOXOXOXOOOOOXOOOOXXOXOOXOOOXXXOOOOOXXOOOOOOXOOXOXOOOOOOXXOOOOOOOXOXOOOOXXOOOOOOOXOO
