OOXXXOXOOOOOOXOXOXXOOOOOOXOXOOOOOXOOXXOXXXOOOXOOOOOXOOOOOOOXOOOOOOOOOXOOOOXOOXOOOOOXOOXXOOXOXOOOXOOOO
XXOOOOOOOOOXOOXOOOOOXOXOOOOXOXOXOXXXOOOOXOOOXOXXOOXOOXXOOOOOOOXOXXOOOOOOOXOXOOOOOOOOXOXOXXXOOXOOOXXXO
XXOXOOOOXOXOOOOXOOOXOOOXOXXOOOXOOOXXXOOOXOOOOXXOOOOOOOOOOOXOXOXXOOOXOOOOOXOOXOXXOOXXOOOOOXOOOXXOOOXXO
OOXOOXOXOOOOOXOXXOXOOOOOXXOOOOOOOOOOOOOXOOXOOOOOOOOXOXXOXOXOOOXOOOXOOOXXXOXXOXOXOXOXXOOOXOOOOOOOOOOOX
OOOXOOXXOXOXOXOOOXOXOOOXXOOOXOXOOXOOOOOOOOOXOXXOXOOOXOXOXXOXOOOOOOXOXXOOOOOXOOXOOXXOXOOOXXOOOOOOXOXOO
OOOOOOOOOXXXOOXOOXOXOOOOXOXOXOXOOXOOOOOOXXOXXOOOOXOXOXOOOOOOOXOOOOOOOOOOXXOOOOOOOOXOOXOXOOXOOOOOOXOXO
XOOOOOOXXOXOOOOOOOOXXOOOOOOOXXOOOOOXOXOXOOOXOOOOOXOXXXOOXXOOXOOOOOOOOXOOXOOOXOOOOOOOOOOXOOOOOXOOOOXOO
OOOXOOOXOXXOOOOOOOOOXOOOOOOXOXXOOOOOOXOOXXOOOOOOXOOXOOOXOOOXXOOOXOOOOOOOXOOXOOXOOOOOXXOOOXOXOXOXXOXOO
XXOOOOOXOOOOXOXOOXOOOOOOOOOOXOXOOOOXOOXOOOXOXOOOXOOOOOOOOOOOOOOOOXOOOOOOOOXOXOXOXXOOOOXOOXOOOXXXOXOOO
XXOXOOOOOOOOOXXOXOOXOXOOOOXOOOOOOXXXOOOOOOOOXOOXOOXXOOXXXXOOOOOXOOOOOOOOOOOOOOOOOOOOOOOOOOXOOOOOOOXOX
XOOOOXOOOOOOOOOOXXOOOXOXOXOOXOXXOXXXOOOOXOXOOXOOOOOOOXOOOOXOOOOOXOXXOOOXOOXOXXOXOOOXXOOOOOOOOXXOXOOXX
OOOOOOOOOOXOXOOXOOOOOOOOXOOOOOOXOOOOOXOOOXOOOOXOXOOOOOOXOXOOOOXOOXOOOXXXOXOOOOOOXOOXXXOXOOOXOOOXXOOOO
OXXXOOOOOOOXXOXXOOOOOXOOOOOXXXOOOOXXOOOXXXOOXXOOXOOOOXOXOXOOOOXOOOOOOXXXOOOOXOXOOXOOOOXOOOOXXXOXXOOOO
OOOOOOXXXXXXOOXXXOOXXXXOOOOOXXOOXOOOXOOOXOOOOOOOOXOXOOXOOXOOOXOOOOOOOOOXOXOOOOOXXOOXOOXXXOOOXOOXOXOXX
OOOOOXOXXXOXOOXOOOOOOOXOOOOOOXXOOOOOXXOOOOOXOXXXXOOXXOXOOOOOOOOOOXOOOOXOOOOOOOOOOOOOOOOOOXOOOOXOXOOXX
OOOOOXOOOXOXOOOOOOOXOOXOXOOOOXXXXOOOOXOOOXOOOOOOOXOXOXXOOXXOOOXOOXXOXOOOOOOOXOOOOOOXOOOOOXOXOOXXOOXOO
XOOOOOOOXOOOXOOOOOOOOOXXXOOOOOOXXOOOOXOOOXOXXOXOOOOOOXOXOOXOOXOOOOOOOOOXOOOXOOOXOOXOOOOXOXXOXXXOOXOOX
XXXOOXXOXOXXOOOOOOXOOOOOXOXOOOOOXOXOXOOOOXOOXOOXOOOOXXOOOOOOXOOXOOOOXOOOXOOXXOOXXOOOXOOOOOOXOOXOXXXOX
OXOOOXOXOOOOXOXOOOXOXXOOOOOXXOOXOOOOOOXOOOOOOOXOOXOXXXXXXOOOOOXOXXOXOOOXOOOOXOXOOOOOOOXOOOXOOOOOOOOOX
OOOOXOXOXOXOOOOOOOOOOOXXOOOOXXOXXOXOOOXXXOOXXOOOOOXOOOXXOOXOOXOOOXOXOOOOOXOOOXOOXOXOOOOOXOOOOOXOXOOXX
XXOOOOOOOOXXOXOXOOOOOOOOXOXOOOXOOOOOXOXXOOXXXOOXXOXXOOOOXXOOOOOOXOXOOXOOOOOOOXXOOOOXOOOXOOXXOOOOOOOOO
XOXOOXOOOOOXOOOXXOXXXXOXOOOXXXXOXXXXOXXOOXOXXOOOOXOOOOOOXXXXOXOXOOXXOOXOOOOOOXOOOXOOOOXXXXOOXOOOOOOXX
XOXOXOOXOXOXXXOOOOOOOXXOOXOOXXXXOOXOOOOOOOOXOOXXOOXOXOXOOOXXXOXOOOOXOXOOXOOOXOOOOXXOOOOOOOOOOXOOOOOXO
XOOOOOOOOOXOOXOXXOXOXOOOXXOOOOOOOOXOOXOOXOOXOOOOOOXOOOOOXXOXOOXXOOXXXOOOOOOXXOXXOOOOOXOOXXOOOOOOOOOXO
OXOOOOXXOOOXOXOOOOXXXOOXOOOOXOOXOOOOOXOXXOOOOXOOOOOOOOOXXOXOXXOXXXOXXOOOOOOOOOOXOOOXOOXXOXOXOOOOOXXOO
OOXOOOOOXOXOXXOXXXOXXOXXOOXOOOOOXOOOXOOOOXXXOXOOOOOXOXOXOOOXOOOOOXOXOOOOOOXOOOOOOOOOOOXOOOXOXXOXOOOOX
OOXOOOXXXXXXOOOOOXOXOOOOOOOOXXOOXXOOOOOXOOOOXXXOOXXOOOOOOOOOXXOOOOOXOXOXOXOOOOOOXXXXOXOOOOOOXOOOOXOOO
OXOXXXOXXOOOOXXOOOOXOOXOOOOOOOOOOOOOOOOOOOOXXXOOOOXOOOXOXXOXXOOOOOOXOOOOOOOOOOXOOOOOXXOXXOOOXOXOOOOOO
XOOOOXXOOOXOOOOOOOOOXOOXOXXOOXXOOXOOOOOOOOXOXOOXXXXXOOXOOOXOXOOXOOXOOOOOOXOXXOOOXOXXOOOOOOOOXOXOOXOOO
OXOOOOOXXOOOOOOOOOXOXOXOOXXOOOXXOOOOOOOXXXOOXOOOOOXOOOXXOOOOXXOXOXOOOOOOOXOOOOOOOXOXOOOOXOOOOOOXXOOOO
XXOOOOOOOOXXOOOOOOOXOOXOOOOOOOOOOOXOOOOXOOOOOXOOOOOOXOOOOXOOXOOXOOOOOOOXOOOOXOOXXOOOXXXXOOOXXXOXOXOXO
OOOOXOOXOOOOOOOOOOOXXOOXOOOXOOXXXOOOXOXXOOOOOXOXOXOXXXOOOXXXOXXOXOXOOOXOXXOXXOXOXXOOXOOOXOXXOXXOOOXOX
OOXXXOOOOXXOOOOXOXOOOOOOXOXOOXOOOOOOXOOXXOOOXOOOOXXOOOOXOXOOOOOOOOOXOOOOOXOOOOOOOXOOOOOOOOXXXOOOOOOOO
OXOOXXOXXOOXOXOXOOXXOXOOOXOOOOXOXXXOOOOOOOXOOOXXOOOOOXOOOOOOOXOXOOXOOOOXOOOXXOXOOXOOOOOOOOOOXXOOOOOXX
XOOXXXOOOXOOOXOOOOOXOOOOXOOXXOOOOOOOOOOOXOOOOOXOOOOOOXXOOOXXOOOOXXOOOXOOOOOOOOOXXXXXXOOOOOXXOOOOOXOXX
OOOOOOOOOOXOOOOOOOOXOOXOXOOOOOOXOOOOOXXOXOOXOOXOXOXOOOXOOXOOOOOXOXXOXOXOOOOOOOOOOOXOXOOOXOXOOOOXXOXXO
OXXOXXOOOOOXOOXXOOOOXOOOOOOOXOOOOOOOOOOXXXXOOOOOXXOXXOOXOOOXOOXOXXOOXOOOXOOOXOOOOXXXOOXOOOXOXOOXXOOOO
OOOOOOOOOOXXXOOXXXOOOOOXXOOOOOOOOOOOXOOXOOXXOOXOOOXXOXOOOOXXXXOXXXOOOOOOOOOOOXOOOOOXOOXOOXOOOXOOOXXXO
OXXOXOXXOOOOOOXOOOXOOOOXOOOOOOXXOOXOOOOOOXOOOXOXOOOOOXOOOOXOXXXXOOXOXOOOOOXOOXOOOOOOOOOOOOOXOXOXXXXXO
OOOOOXOXOOOOOXOOXOOOOXXOOXOOOOOOOXOXXOOOXXXXOOOXOXXXOOXOXOXOXOOOXOOOOOOOOOOOOXXOOOXXOOXXXXOOOOOOOOOXO
XXXXOOOOOXXOOOOOOOOXOOXOOXOOOOOOXOOOOOOOOXOOOOXOOOOOOXOXOOOOOOXOOOOXOOOOOOOXOOOXOOOXOOOXXOOOXXOXOXXOO
OOOXOOOXOOOOOXOOOOOOXXOOXOOXXXOXOXXOOOXOOOXXXOOOOOOXOOXOXOOOOXXXOXXOOOXOOOOOOOOOOOXXOOXOOOXOXOOOOOOOX
OOXOXXOXXXOXXOOXOOOXXOOOOXXOOOOOOXOXXOOOOXOOOOXOOXOXOXOOOOOOOOOOOOOOXXOOOOOXOOOOOOOOOXOOOXOXOOOOOOOOO
XOOOXOXOXOOOOOOXXOOOOOOXOXXXOXOOOXOOOOXXXXXOOOOXOXOOOOOOOOXOOOXXOOOOOXOXOOXOOOOOOOOXXOOOOXOOXOXXXXXOO
OOOXOXOOOOOOOOOOOOOOXOXOOOOXOOOOOOOOXOXXOXXXOOOOOOOOOOXOOOXOXOOOOOOOXXOOOXXOXOOOOOOOXXXOOOXOOOOOXOOXO
XOOOOXXOOOOOXOOXOOXOXOXOOOXOOOOOOOXOXXOOOOOXXOXOOOOOOOOXOOOXOOOOXOXXOXOOOOOXOOOOOOOXXOXOOXOOXXXXOOOOO
XOOOOXOOXXOXXXOOOXOXOXOXOXOOOXOOXOXOXOOOOOOOOOOOOOOOOOOOOOXXXOXOXXOOOOXXXXOXOOOOOXOXOOOOOOOOOOOOOXOOO
OOOOOOOOOXXOXOXXXOOOXOXOOOXXOXOOOOOOOOOOOOXOXOOXOOOXOXOOOOXXXOXOOOOXXOOOOXOOXXXOOOXXOOOXOOXXOOXOXOXOO
OOXOXOOOXOOOOOOOOOXXXOOOOOOXXOOOXOOOOXOOOOOOXXXXXXOOOXXOOXXOXXXOOOXOXOXXOOOOOOXXOOOXXOOXXXOOOOXXOOOXO
OOOOOOXXOOOXOOOOOXXOOOOOXOXXXOOOOOOOXXOXOXOXXXXOOXOOOOOXXXOOOOOXXOOXOOXOXOOOOOOOOXOXOXOXOXXXXXOOOOOOO
OXOOOOXXXXOXOOXOOOXOXXOOOOOOXOOOXXXOOOXXOOXOOOXXXOOOOOOXOXOXOOOOOOOOOOOXXOOOXXXOOOOOXOOOOOXOOXXOOXOXO
XOOXOOXXOOOOOOOXOOOXOOOOXXOXOXXXXXXOOOOOXOXXOOOOXOXXOXOOXXOOOOOXOXOXOOOOXXXXXOOXOOOOOOOXOOXXXXOOXOOOX
XOOOOOOOOOXXOOOOOOXXOXOOOXXXOOOXOOXXOOOOOXXOOXOXOOOOXOOOOOXXXXOXOOOXOOOXXOXOOOOOOOOOOOOOOXOOOOXXOOOXO
OXOOXOXXOOOOXXOOOOOOOOXXOOOOOXXXXXXXOOXOOOOOOOXOOXXOOOOXXXOOXOOOOOXOXXOOOOXXXOOOOXOOXOOOOXOXOXOOOOOOO
XOOOXXXOXOXOOOOOOOXOOXXOOXOOXXOXXOXOXOXXOOOOOXXXOOOOOXOXOOXOXOXOOOOOOXOOOOXOOOXXXOOOOOXOXXOOOOOXXOXOO
OOOXXOXOOOXOOOOOOXXOOOXOXOXXXOXOOOXXOOOOOXXXXXXXOXOXXOXXOOOXOOOOOXOOOOOOOXOXOOOOOOOOXXOOXOOXOOXXOOOOO
OXOOOXOOOOOXOOOXOOOXXOOOOXOXOOXXXXOXXOOOOOOOOOXOOXOXOXOOOOXOXOXXOOOXXXXOOOOOOOOXOOOXXXXXOOOOOOOOOXOOO
XOOOXOOXOXOOXOOOXXOOOOOXOOOOOXXOOOOXOOOOOXOOOOOOOXOXXOXXOOOOXXOOOOXOOOOXXXOXOOOOXOOXXOXOOOOOOOXOOOOOX
XOOOXOOXOXOOXOOXOXXOOXOXOOOOXOOXOXOOOXXOOXOXXOOXXXOOXXOOOOOOOXXOOOOOOOOOOXOOOOOOOOXXXOOOXXXOXOOOOOOOO
XXOOXOOOXOOOOOOOOOOOXXXOXOOOXOXXXOOOXOOXOXOOXOXXOXOOOXOXOOOXOOOOOOOOOXOOOOXOXOXXOOXXXXOXXXOOOOOXXOOXO
XOOOXXOOOXXOXOOXXOOOOOOXOOOXOOOOOOOOOXXOOOOOOOOOOOOOOOOXXXOXOOOXOOXOOOOXXXXXXXOXOXXXXXXOOXXOOOXOOXXOO
OXOXOOOXOOOXOOOXOOOXOXOXXOXXOOOOOOOXOOOOXXOOXOXOOXOXOXOOOXXXOOOXOXOXOOXOOOOXXOOOOOOOOOOOXXOOOOOOOXOXO
OOOXOOOOOOXOOOOOXOOOXOXOXOOXXOXOXOOOOOXXOXOOOOOOOOOOXXOOOOOXOOOOOOXXXOXXOXXOOXXOOOOOXOXXOOOXXOOXXXXOO
XOOXOXOOOXXOXOOXXOXXOOOXOOOOOOXOOXOOOOOOXOOOOXOOOOOXOXOOOOOOOOOOOOOOXXXOOXOXXOOOOOOOXOOOOXXOXOOOOOOOO
XOOXXOXOOOXOXOXXOOXOOXOOOXXOXXOXOXXXOOOOOXOOXXOXOXXXXOXOOOOOOOXOOXXXXOOOXOOOOOOOXOOOOOOOOOOOOOOOOOOOX
OXXOOOOXOOOOXXOOXOOOOXOXXXXOOXOOXOXOOOOOOXOXOOXOOOXOXOOOXXOXOXOOOOOOXXOOOOOOOXOOXOOOOOOOXXXXOOXOOOOOX
OOOOOOOOOXOOOXXOOOXOOXOOXXOOOOOXOOOOOOXOXOXOOOOOOXOOOXOOOOOOXOOOOOXOXOOOOXOOOXOXOOXXOXOXOOXOOXOOOOXOX
OXXOOOOXOOOOOOOOOXOXXOXOOOXXXXOXOOOXOXXOOXOOXOOXXXOOOOOOXXOOOXOOXXOOOOOXOOOOXOXXOOOOOOXOOOOOOOXOOOOXO
OOOOXOXOXOXOOXOOXOXOOOOXOOXOOOOOOXXOOXOOOXOXOOOOOXXXOXOOOXOOOXOOOOOOXOOXXXOOXXXXOOXOXOXOOOOXXOOOOOOOX
XOOXOOOOXXOOOOXOXOOXOOXOXOXOOOOOXOOOOXOOOXOXOXOOOOOXOOOOOOOOXOXOOXXXOOOOXOOXOOOXOOXOOXXOOOXOOXXOXXXOO
OXOOOOOXXOOXOOXXOOOOOOOXOOOXOOOOOOXOOXOOOOOOOOXOOOOOOXOXOXXOOOOXOXOXOOXOXOOXXOOOXOOOOOOOOXXOOOOOOOXOO
OXXOXOXXOOOOOOOOXXOOXOXOOOOOOOOOOXOOXOXOOXOOOXOOOXOOXXOOXOOOXOOOOOOXOOXOOOOOOOXXXOXOOOOOXOOOXXOOOOOXO
OXOOOOXOOXOOOOOOOOOOOXOOXOOOOOXXOOXOOOXXXXOXOXOOOXXOXOXOOOOXOXOOXOOOXOXOXOXOXXOOOOXOOOOOOOOOXOXOOXXOX
OXOOOXXOOOXOOXOXOOOOOXOOXXXXOOXXOOOOOXOXXXXXOOOXXOXOXOXXOOOOOXOOOOOOOOOXXOOXOOOOXOXOOOXOXOXOOOOOXOOOO
OXOOXXOXOOXOOXOXXOOXOXXXOOXXOOXOOOOOOOXOXOXXXOOOOOOXOOOXXOOXOXXXOXOXXOOOOXXXXOOXOOXOOOXOOOXOXOOOXOOOO
OOOOXXOOOOOOOXOOXOOOXOOXXOOXOXOOOOXOXOOOXOOOOOXXOOOOXXOOOOOOOOXOOXOOOOOXXOOXOOXOOOOOOOOOOXOOOOXOOOOOO
OOXOXOOOOXOOOXOOOOXOOXOOOOOOXXOOXOOOOOOOOOOOOXXOXOOXOOXOOOOOOOXXOOOOOOOOXOXOXOOOOXOOXOOOOXOOOXOOOOXXX
OXOOOOOOOXXOOOOXXOXXXOOOOOOOOOOXXXXOXOXXXOXXOOXOOXOOOOXXOXOOXXOOOOOOOOOOOOOOOOXOXOOXOOOOOOOXOOOOXOOOO
XOOOXOOOOOXOOOOXOOXOOOOOXXOOOOOOOOOXOXXOOXOXOOOOOXOOXXXXOXXOOOOOOOOOOOXXOOOOXOOXXOXOXOOOOOOXXOOXOXOXO
OOXXXOXXXOXOOOOOOOOXXOOOXXOXXOOOOOXXOOOOOOOXXOOOXXOOXOXXOOOOOXOOOOXOOXOOXOOOOXOXOXXXXXXOXOOOXOXOOXOOO
OOOXOXOXOOOOOOOOOOOOXOXOXOOOOXOXOOOOOOOOOXOOOOOXOXOOXOXXXOOXOOXOXXOOOOOXOXOOOOOOXOOOOOOXOOXOXOOOXOOOO
OXXOXXOOXOOXOOOOOXOOOOOXOOOOOOOOOOOOXOOOOOOOOOOXOOOXOOOXOOOOXOOOXXOOOOOOXOOOOOOOXXOOXOXXOXXOOOOOOXOXO
XOOOOXOOOXOXXOOOOOOOOXOOOXXOOXXOOOXOXOOOXXOOXOXOOXOOXOOXOXOOOOXXOXOOOOOOXXOXXXOOOOOXOOXXOXOOOOXOXXOOO
OOOOOXOOOOOXOXOOXOOOXXOOOOOOOXOOXOXOOXOOXXXOXOXOXOOOOXXOOOOOOXXOOOOXOXOOOOXOOOOOOOOOOOOXOOOOOOOXOOOXX
OOOXOXOOOOOOOOOOOOOOOOOOOOOXOOOOOXXOXXOOOOOXOOXOOXXOOXOOOOOXOOOOOOOOOXOOOOOOXXOOOXOOXOOOXOOXXXXOOOOXO
OOOOOXOXOOOOXOOXOXOOOXOOXOOOOOOOXOOOOXOOOXOOXOOOOXOOOOOOOOOOOXXOXXXXXXXXOOOOOOOOOXOOOOOOOOXOXOOOOXOXO
XXOOOXOOOOOOOXXOOOXOOXOOXOXOOOXOOOOOOXXXOOOOOXOXXOXOOOOOOOXXOOOXXOXXXOXXOOOXOOXOOXOXXXOOOOXOOOOOOXOOX
OOOOOOOOOOOOOOOOOOXXOOOOOOXXOXOOOXOXOXOOOOOXOXXOXOOOOOOXXOOXOOOOXOXXOOXOOXXOOXXOXXXOOXXOOOOXXOOOOXOOO
OXOOOOXOXOXOOXOOXXOOOOOOOOXOOOXOOOXOOOXOOXOOOOOOOOOOOOXOXXOXOOXOOXXOOOOOOOXOOOXXOOXOOXXXOOOOOXOOXOOOX
OXOXOOOOOOOXOXXOOOOXXOOOOOXOOOOXOOOOXXXXOOXXXOOXXXXXOOOOOOOXXOXXOOXOOOOXOOOOOXOOXXXOOOOXOXXXXOOXXOOOX
OOOOOXOOOOOXOOXOXOXOXXOXOXOXOOXOOOXOOXOOOOOOOXOOOOOOOOXXOXOOXXOXOOXOOXOOOXXOOXOXOOXOXXXXOXOOOXOXOOOOO
XOOOOXOXXOOOXXOOOXOOOXOXOOOXOOOOXXOOOOOOOXOOXXOXOOXOXXXXOOOOXXOOOOXOOOOOXOXOOOXXOXXOXOOXOOOXOOXOOXOOX
XXXOOOXXOXOOOOOXOOOXXOOXOXXXOOOOOXXXXXXOXOOOOXOXXXOOXOOOOOOXOXOOOOOOXOXOXOOOXOOOXOOOOOOOOOXXOOOOOOOXX
OOOOXOXXOOOOOOXXOOOXXXOOOOOXOXXXXOOOOOOOOXOXOXXXXXXOOOOXXOXOOXOOOOOOXOXOOOOOOOOOOOOOXOXXOOOXOOXXOOOOX
OOOOOOOXOOXOOOOOXXOOOOXXXXOOOXOOXXOOOOOOOOXOOOXOOXXOXOOOXXOOOOOXOOOXOOOOOOOOXOOOXXOOOXOOOOOOOXXOOOOOO
OOXOOXXOOXOOOXOOOOXOOXOXOXOOXOOOOOOXOXOOOOXOXOOOOXXOOXOOOOXXOOXOOXXOOOOOOOOOXOOOOOXXOXOXOXXOOOXOOOXOO
OXOOOOXOOXOXXXOOXOXXXOOOOOOXXOOXOOOOOXXXOOOOOXOXOOXOOOXOXOXOXXOOOOXXOOXOOOOXXOXXOOOOOXOOXOOOOXOXOOXOO
OOOOOOOOOXXOOXXOOOOXOOXOOOOOOOOOOOOOXXXOXOOOXXOOOOOXXXOOXOXOXOOOOXOOXXOOOOXXOXXXXOOOXOOXOOOOOXOOOOOOO
OOOOOXOOXXOXXOOXXOOOOXOXOOOXOXXXOXOOOXOXOOOOXOOXXXXOOOXOOOOOXXOOOXOOOXXOOOXXXXXOOOXOXOOOOOOOOOOOOXOOO
OOOOOOOOOXOOXOOOXXXXXOOXOOOOXOOOOXXXXOOOOOOXOXOOXOOOOOOOXOXXOOOOOOOOOXOOOOOOOOOOOOOXXOXOOOOXXOXOOXXOO
OOXXOXOOXOOXXOOOXOOOOOOXOOOOOOOOOOXOOOXOOOOOOOOOOOOOXOOOOOOOOOOOOOOOOXOOOXOXOOOXOOOOOXOOXOOXOXOOXXOOO
