OOOOOOOOXOOOXOXOOOOOOOXOXOOXOOOOOOOOOOXOOOOOOOOOXOOXXXOOOOOXOXOXOOXXOXOOOOXXOOOOOOOOOOOXXOXOOOOOOXOOO
OOOOOXOXOOOOXOOXOOOXOOOOOOOOOOOOOXOXXOXXOOOOOXOOXXXOOOOOOXOOOOOOOOOOOXOXOOOXOOXOOOOXOOOOXOOOXOOXOOOOX
OOOOOOOOOOOOOXOXOOOOOOXXXOXXOOOOOOOOOOOXOOOXXXOOXOOOOOOXOOXOOOOOOOOOOXOOOOOOXXOXXOXXXXOOOOXOXOOOOOOOX
OOOOOOOOOOOOOXOXOXXXOXOXXOOOOXXXOOOOXOXXXXOXOXOOXXOOOOOOXOOOOOXOOOOOXOOXOOOOOOOOXOXOOOOXOOOOXXXOXOXOO
OOOXXOOOOOXXXXOXXOOOOOOOXXOOOOOOOXOXOXOOOOOOOXOOXOOOOOOOOOOOOOXOOOOOOOXXXOOXXOOXXOOOXXOOOXOOOOOOXOXXO
OXOOOOOXOXOOXXOXOXOOOXXXXOOOOXXOOOOOOOOOXXOOXOOXOOOXXXOXXOXXOOOOOOXOOXXOOOXOOOOXOOOXOOOXOOOXOOXXXOOOO
OOOOOOOOOOOOOOXOXOXXOOXOOXOOOXXXOOXOOXOOOXOXXOXXOXOOXOXXOOOOOXOXXOOOOOXOOOXOXOOOOOXXOOOOXOOXOOXOOXOOO
OXXOXXOOOXOXOOXOOXOOOXOOOOOXOOOOOXOOXOOXOOOOOOOOXOOXOOOOXOXOOOOOOXXOOXOOXOOXOOOXOOOXXOOXXOXXOOOOOOOOO
XOXOOOOXOOOOOOXXXXOOOOOOOXOXOOOXOOXOOOOOXOOOXOOXOOOXOOXXOOOOOOOXXOXXOOXOOOOOXXXOOXOXOOOXOOOOOOOXOOOOO
XOOOOOXOOOOOOOOOXOOOXXXOOOOOXOOXOOOOOXOOXXXXXOOOOOOOOXOOOXOOOOOOOOOOOXOOOOXOXOOOOOOXOOOOOOOOXXOXXXOXX
OXOOOOXOXOXXOOOOXOOOOXXXOOOOXOOXOOOXOOOOOOOOOXOXXOOOOOXOOOOXOOOOXXOOOOOXOOOXOOOOOOXOXOXXXXOXOOOOOOOXO
OOXOOOOOXOXOOXOXOOOXOXXOXXOOOOXOXOOXOXOOOOOXOOOOOOXOXXXOOXOXOOOOXOXOOOXOOXOOOOOXOOOOOOOXXXXOOOOXOOXXX
XOOOXOOXOOXOOXOOOOOXOOOOXXXXOOOOXOOXOOOOOOOOXOOOOXOOOOXXOOXXOOOOOOXOXXOOOOXOOOOOXOOOXOOXXOOOOOOXXOOOO
XOOOOOXOOOOOOOOOOOOOOXOOXOXOXOOOOOOOOOXOOOOXXOOOOOOOXXXOOXOOOOOXXOOXOOXOOOOOOOXOOOOOXOOOXOXOOOOOOOOOO
OOXOOOXOOOOOXOOXXOOXOOOOXOXXOOOOOOXXOXOOOXXOXXXOOXOOXXXOOXOOXOOOOOOOOXOOXOXXOOOOXOOOOXOXOOXOXOXXOXOOO
XOOOOOOOXXOOXOOOOOOXOXOOXOOOOOOOOXXOOOOOOOXXOOOOOOXXOOXOOOOOOOOOOXOOOXOOXXXXOXOXXXOXOOOXXOXOOXOXOOOOO
XOXOOXOOOXXOXOXOOOOOXOXOOOOOXOOOOXOOOOOOOOOOOXOOOOOOOXOOOOOXOOOXXOXXOXOXOOOOXXOOOXOXOOOOOOOXOOOXOXOOX
XXXXOOXXOXOXOOXOXXOOOXOXOOOXXXOXXXOXXOXOOOOOOOOOOOOOOOOOOOXXOOOXXXOOXOOXXOOOOXOXOXXOOOOOOXOOOOOOOOOOO
OOXXOXXXOXOOOXOOXOXOOOOOOOOOXOOOOOXXOOOOOXOXOOXXXOOOOOOOOXOOOOOOOXOOXXXXOOXOOOOOOXOXOXOOXOOOOOOOOOOOO
XOOOOXOOXOOOXOOOOOOOOXOOXXOXXOOOOOOOOOOOOOXOOOXOOOOOOOOOXOOOOOOOOOXXOOOOOOOOOXXOOXOOOXXOOOOOXOOXOOOOO
XOOOOOXOOXOOXOXXOOOOOXOOOOOXXOXOXOOOOOOXOOOOOOOOOXOOOOXOOOOXOXOXOOOOOOOXOOOOOOOOOXOOXXXXOOOXOXOXOOOOO
OOXXOOOOXOOOOOXOXXOXOOXXOOOXXOXOOOOXXOOOOOOOXOOOOOOOOXOXOOOOOXOOOOOOOOXOOXOOOXOOOOOOOOOXOXOOXXXOOOXOO
OOOOOXXXOOOOXOOOOOOXOXOXXOOXXOXXXXOXXOOXXOOOOXXXOXOOOOOOXOOXOOOXOOOOXOXOOOOOOOOXXOOOOOOOXOOOXOXXOXXOX
OXOXOOOXXOOOOOOOOXOXOXOXXXOOXXOOOOOOOOXOOXOOOOXOOOOOOXXXOOOXOOOXOXXXOOOOXXOOXOOXOOOXXOOXOXOOOXXOOOOOO
XOXXOOOOOOOOOXOOXXOXXOOOOXOOXOXOOOOOOXOXOOOOXOXOOOXXOOOOXOOOXOOOXOOOXOOXOOXOOOOXOOOXXOOXXOOOOXOXXOXXO
OXOOXOOOOOOOXXOOXOOOOOOOOXXOXXOOOOOOOOOOXOOOOOOOOOOOOOXOXXXXXXOOXOOOOOXOXOOXOOOOOOOXOOXOOOOXXOOXOOXOX
XXOOOOOOOOXOXOOOOOOOOOOOXOOOOOXOXOOOOXXOOXXOOXXOOOXXOOOXOOOOOXXOXOOOOOXOOOOXXOOXOXOOXXOOOXOOOOXOOXOOO
XOOOXOXOXOOOXOOOOXXOOOOXXXOXOXOXXOXXOOXOOOOOOOXOOOXOOOXOOXOOOOOXXOXOOOOXOOXOOXXXOOXOOOXXXOOXOOOOOXXOX
XOXOOOXXOOOOXOOOOXXXXOOOOOOOXOOXXXOOOOXOXOOOOXOOOXOOOOXXOOXOOOOXXXXXXXOOOXOOXXOOXXOOOOOOXXOOXXXXOOOXO
OOOOXOOXXXOOOXOXOOXXOOOOOXOXOXOOOOOOXXOOOOXOXXOOOOOOOOOOXOOOOOOOOOOOOOOOXOXOXOXOOOOOOOOOOXXOOOXOOOXOX
XOOOOOOXOOXOXXOOXOXXXOOOOXOOOOOOXOOOOOXOOOOXOXOOOOOOOOOOOXOOOOOOXOOOOOOOXXOXOXOOXOOOXOOOOXOOOXOOOOXOO
OXOXXOOOOOXOOOOOOOOXOOOOOOOOOOXOOOOOOOOOOOOXOXOOOXOOOOOOXOOXOOOXOXOOOXOXOXOXXOOOOOOXXXOOXXXOOOOOOXOOO
OXOOXXOOOXXOOOXOOOOOOOXXOOOOOOOOOOOOOXOXXOOOXOXOXOOXXOXOXOXOXOOXOXOOOOXXOOOOOXOOXXOXXXOXOXXOXOOOXOOXO
XXXOXXOXXOOOOOXXXXOOOXOXXXOXOOOXXOOXXXXOOOOOXOXOOOOOOOOOOOOOOXXXXOOOOXOOOOOOOOOXOXXXOOXXOOOXOOOOOOOOX
XXOOOXOOXOXXXOOXOOXOOOOXXOOOOXOOOOXXOOXXXXOOXXXOXXOOOOOOOOOXOOOOOOXOXOOOOOOXOOOOXOOOXOOXOOOOOXXXOOOXO
OXOOXOOOOOOOOOXOOOOXXOXOOXXOOOOXXOOOXOOOXOOOOOXOOOOOOOOOOOOOOOOXOXOOOOXOOOOXOOOOXOXOOXXOOOOXOOOXXOOOX
OXOOOOOOXOOXOOOOOOOOOOXOOOXOXOXOOOXOOOOOOOOOOOXOOXOOOOOOXXOXXXXOOXOXOOOOOOOOOOOXXOXXOOOXOOOOXOOOOOOOO
OOXXXOOXOOXOOOXOOXOXOOOOOOXOOOOXXOOOOXXOXOXOXOXXXOOOOOXOOXOOXXOXOXXOOOOOOOXOXOXXOOOOXOOXXXOOOOOOOOXXX
XOOXXOOXOOOXOOOOOXXXXOOOOOOXXOOOXXOOOOOXOOOXOOOOXOOXOOOOOOOOOOXOOXOXOOOOXOOOOOOOOOOOOOOOOXOXXXXXOXOOO
OOXXXOOOOOOOXXOXOOXOOOOXOOOOXOOXXOOOOOOOXOXXXXXXOOOOOXOOOOOOOOXOOXOOXOXXXOOXOXOOXXOOOOOOOXXOXOOXXXOXX
OOOOOOOOOOOOOOOOOOOOXXXOOXOXXOOOOOXOXOXOOOOXXXOOOXOOOXXOOXXOOOOOOXXXOXOOOOXOXXOOXXOOXOXOXOXXOOOXOOXOX
OXXOXOOOXOOOOOXOXXXOOOOOOOOOOXOOOOXXOOOOOOOOOOOOXOXOXOXOOOXOOOOOOXXOOOOOOXOXOOOOOOOXOOXOXOOOOOOOXXOOO
OOXXOXOOOXOOOOXOXOOXOOOOOOOXOOOOOXXOOOOOXOXOXXOOOOXOOOXOXOOOOOOXOOXOOXOXOOOOXOOOOOOOXOXXXXOXXXXOOOOOX
OOOOOOXOOXXOOOOXOXXOXXOOOXOOOXXXOOXXXXOXXOXXOOOOOXOOXXOOOOOOOXOXOOOOOOOOXOOOOXOXOXXXOXXOOOOXOXOOOOOOX
XOOOOOOOOXXOOOOOXOXOOOXOOXOOOXOOXXXOXXOOOXXOOOOXOOOOOOOOOXXOOXOOOOOXOOOOOOXOOOOOOXXOOOXOXOOXOOOOOXOXX
OOOOXOXOOOOXXOXOXOOOOOXXOOOXOOOOOOOXOOOOOXXOOOOOXOOOXOOXOXXOXOXOXOXOOXOOOXXXOOOOXXOXOOOXOOOXXXOXOOXOO
OOOOOXOOXOOOOOOOOXXOXOOXXOOOOOOXOOOOXOXOXOOOOXXXOOXOOOOOXOXOXOXOOOXOOOOXXXXOOOOOOXXOOOXOOOOOXXXOOOOOO
OOOOOOOOOOOOXOOOOXXOXOXXOXXOOXOOOOOXOXOXOXXXXXOOOOOOOXOOOOXOXOOXXOXOXOXOXXXOOOXOXOXOOOOOXOOOOXXOOOXOX
XOOXOOOXOOOOOOOXOOOOXXOOOXXOOOOOXOXXOOOXOXOOXOOOXOOOOOOOOOXOOOOXOOOOXOOOOOOOOOOOOOOXOOOOOOXOOOOOOOOOX
XOOOXOOOOOOOXOOOOOXXOOOOOXOOXOOXOXOOOOOOOOOOXOOOXXOXOOXOOXOXOXOXOOOOXXXOOXXXOXXOOOOOOOXOOOOOOXOOXXOOO
OOOXXXOXOXOOOOOOOXOXOXOOXOOOXOOXOOXOXOOOOOOXXOXOOOOXXOOOXOOOXOOOOOOOXOOOXXOXOOXOOOXOOXOOOOOXOXOOXOOOO
XXOOOOOXOOOXXOOOOOXOOOOOOXOOOOOOXOXXXOOXXXXXOXOOXOOOOOOOXOOOXOXOXOOOXXOOOOOXOOOOXOXOOXXOOOOOXOOOOOOXX
XOXOXXXXXOOOXOXXOOOOOXOXOOOOOOOXOOOXXOOOOOXOXOOXOOOOOXOOOOOOXXOOXOXOOOXXOOXXOOOXOXXOOOXOOOXXXXOOXOXOO
OOXOOXXOXXOOOOOXOXXXXOOOXXOOOXXOOOXOOOOOOXOXXOXOXXOOOXXOOXOOXOOOXXOOXOXXOOOOOOXXOOOOOXOXOOOOOOOOOOOOO
OOOOXXXOOXOXOOOXOOOOOOOXOOOXOXXXOOOOOXXOOOOXXOXOXOOOOOOXXXOOOOXOXOXOXXOOXXOOOOXOOOXOOXXOOOOXOXOOOOOOO
XOOOXXOOOXOOOOOOOOOOOOOOXOOOOOOOXOXXOOOXOOOOXOOOOXOXXXOOOOOOOOOOOOXXOOXOOOOOOOOOOOOOOXOXOXOOOOOOXOOOX
OXXOOOOXOOOOOOOOOXOOOOOXOOOOOOXOOXOOOOXOXOOOXOOOOOOXOOXOOXOXXOXXXOOOOOXXOOOOOOXOOOOXOOOOOOOOXOOOOOXOO
OXOOXXOXOXOOXXOXXXOOOOOXOOOXOOOOXOOOOOOOOOXXOOXXOOOXXXOOXXOOOXOOOXOOOOOOOOOOOOOOXXXOOOOOOOXXXOXXOXOOX
OOOOXOOOXOOOOOOOOOXXXXOOOOOOOOOXOOXOOOOOOXOOOOOOOOOXOOOXOOOXXOOXXXOOOOOXOXOOXXXOOOOOOOXOXOXOOOOXOOOXO
OXOOOOXOOOOXXOXOXOXOOOOOOOOOOOOOOOXXOOOOOXOOOXOXOOXOOXOOOOOOOOOOOOOOOXOXXOXOOXOOXXOOXOXOOXXOOOOXXXOXO
OOOXOOXXOOOOOOXOXOOOXXOOOOOOXOOOOXOXXXOOOOXOXXXOXOOOXOOOOXXOOOXOXXOOXOOOOXOOXOOOXXOXXOOOXOOOOOOXOOOOO
OOXOOOOXOOOXXOOOOXOXOOOXOOOOOXXOXXOOOOOOOXOXXOOXOOOOOXOXOOOOOOOXXOOOOOXOOOOOXOXOOOOOXOOOOXOXOOOXXOXXO
OXOOXOOOOXOXOOXXOXOOOOOXOOOOOOXOOOOOXOOOOXOOOOOOXOOOOXOOOOOOOXXXXOOOXXOOOXOXOXOXXXOOOXOOXOOOOOOOOXOOX
OOOOOXXOOOXOXOOXOOOXXOOXXXOOOOOOOXOOXOXXOXOOOXOXXOOOOOOOOXXXOXOOOXOOOXOOXOOXXOOOOOOOOOOOXOOXXXOXXOXOO
OXOOOXXOOOOOOXOOOOOXOOOXOXOOXOOOOOXOOOOOOXOOOOOXOXOOXOXOOXOXOOOXOOXOOXOOOOOXXOOOOOXOXOOOOOOOXXOOOOOXO
OOOOOXOXXOOXOOXOOXOOXXOOOOXOXXOOOOOOOOOOOOXOXXOOOXOXOOOXOOOXXOOOOXOOXXOOXXXOOOOOXOXOOOXXXOOOOOOOOOOXO
XXOXXXOOOOOOOXOXXOXOOOOOOOOOOOXOOOOOXXOOOOOXOXOOOOOOOOOOOOOXOOOOXOXOOOOOOOOOXXOOOXOXOXXXOOOXOOOOXOXOX
OOXXOOOXOOXOOOXXOXOXXOOXOXOOOOOOOOXOOOOXOOXXXOOXOXXXOOXXXXXOOXOOOOXOXOXXOOXOOOOOXOOOXOOOOXOOOOOOOOOOX
OXXOOOOOOXOOOOOXXOXOOOXOXOOOOOOOXOXXXOOOOXXOXOOXXXOXOOXXOOOOOOXOOOOOXOOOOOXOOXOOXOOOOOOXOXXOOOOOOOXOX
XOOXXOOOXOXXOOOOOXXOOOOXOOXXOOOOOOOOXXOOOXOXOOOOOOOOOOOOOOXOOOOOOOOOXOXOXXOOOOOXXXOXOOOOOXOOXOXXOXOXO
XOXXOOOOXXOOOOXOOOOOXOOOXOXXOOOOOXOXXXXXXOOOOXOOXXOXOOOOOOOOOOOXOOOOOOXOOOOXOXXOOXXOOOOOXOOXOOOOOOOOO
OXOOOOOOXXOXOOOOOOOOOOOOOXOOOOOOOOOOOOOOXXOOOOXXOOXXXOOOOXXXOOOXXOXXOOOOOOXOOOOOOOOOOXXOOOOOOOOOXOOOX
OOOOOOOOOXOXXOXOXOXXOOOXXOOOOOXOOOXOOXOOOOOOXOOOXOXOOOOOOOXOOOOXOOXXOOOOXOOOXOOOXXOXOOOOOOOOOXOOOOXOO
XOOXXOOOOOOOOXOOOOOXXOXOOOXOXOOXXXXXOXOOXOOOOOOOOOOOOOOOOOOXXOOXOOOOXOOXOOOOOXOXOOOOXOOOOOXXXOOOXOOOO
XOOXOXXOOOOXXOOOOOXOOXOXOOOXOOXXXOOOXOXOXOOOOOOOOOXOOOOOOOOOOXOXOXXOXOOOOOOXOOOOOOXOOOOXXXXOXOOOOXOOO
OXOOOXOOXOXOXOOOOOOOXOOOOOOXOOXOOOOOOOOOOOXXOXOOOXOOOXOOOOOXOOOOOOXOOOOOOOOOOXOXOOOOOOOOXOOOOOXXOXOOX
OXOOXXOOXOOOOOXXOXXXOOOOOXOOXOOOOXOOXOOOOOOOOOXOXOOXOOXXXOXXOOOOOOOOOOXOXOOXXOOOXOXOOOOOXOXXOOXOXOOOO
OOOOOOOXXOOXOOOOOOOOOOOOOOOOXOXXOOXOXOXOOXOOXOXOOOXXXOOOOXOOOXXOXOOOXXOOOOOOOOXOOOOOXXOOXXOOOXOXOOXOX
OOOXOOOOXOOOXOXOXOOXOOOOOOOOOOOOOOOXOOXOOXOXOXOOOXOOOOXOOXOOOOOXOOXOOXOOXOXXXOXOOXOOXOOOOXXXOOXOOOXXO
OOXOOOOOOOXOOOXOXOXOXOOOXXOOXOXXOOOOOOOOXXXOOXOOOOXOOOOXXOXOOOXOXOXXOXXXOXXOXOXOOXXOOOXXOXXOOOXOXOOXO
OXOXXOXOOOOOOOXXXOOOOOOXXOOXOOXOOXXXOOOOXOOOOXOXOXOOOOXOOXOOOOOXOXOOXOOOOXXOOOOXOOOOOXXOOOOXXOXOOOOOO
OOOXOOOOXOXOOOOOOXXOOOOOXOXOXOXXOOOOOOOXXXOOXXOOOOOOOXOOOOOXOOOOOOOXXOOXOOOXOOOXXOOOOXOOOOOXOOXXOOXOO
XXOOOOXOOOOXOXOOOOOXXOOXOXOXOOXOXOOOOOOXOOXOOXXOOOOOOOOOOOOXOOXOOOOOOOXOOXOOOOOXXOOOOOXOXXOOOXOXOXOXX
OOOOXOOOOXOXOXOOXXOOOOXOOOXXOOOOOXXOXOXOXOOOOOXOOXOXXXXXXOXOOOOOOOXXOOXXOOOOXOOXXOOXOXOOXOOXOOOXOOOOO
XOOOOOXXOOXOOOXOXOOOXXXOOOXOOOXXOOOOOOXOOXOOOXOOOXOOOOOOOXOXOOXXXOXXOXOOOOOXOXOOOOOXOXXOOOOOOOOXOOOOO
OOXXXOXOXOXXOXOOXOOOOOOXXXOXXOOXOXOXOOXOXOOXOOOOOOOOOXOXOXOOOOOOOOOOOOOXOOOOOOOXXXOXOOOOXXOOXOOOOXXXO
OOOOXOOXXXOOXXOOOOOOOOOOOOOOOOOXOOOOXOOXOXOOOOOOXOOOOXOOOOXOOXOOXOOOOOOOOXOOXOOXOOOXOOOOOOOOXOOXOOOOO
XOOOOOOOXXOOXOOOOOOOOXOOXOXOOOOOXXOXOOXOOOOOOOOOOOOOXOXXOOOOOXXOOOXOXOOXOOOOXXXOOXOOOXXOOOXOOOXOXOOXO
OOOOOXXOXOOXXOXXOOXOOOXXOXOOXXOOOOOOOOOXOOXOOOOOXXXOOXXXOOOXXOOOOXOXOOOXOOOOOXOOOOOOXOOOOOOOXOOOXOXOO
XOOXXOOXXOOOOOXOXXOOOOOOOXOOOOOXOOXOOOOOOXOOOOOOOOOOXXOOOOOXOOOOOOOOOOXOXXXXOOOOOXOOOOOOXOOOOOOXOOOOO
OOOOOOOXOOOXOOOOXXOOOOXOXXXOXXXOXXOOOOOOOOOOOOOXOOOOOOOOXOOOOOOXOOXXXOOXOOXOXOOOXOOOOXOOXOOOXOXOOOOOO
XOXOOOOOOOXXOOOXOOXOOXOOOOXOOOOXOXOOOOXOOOOOOOXXOOXOOOOOOXOOOOOOOOOXOOOOOXXOOOOOXXXOOOOOOXOXOOXXXOOOO
XXOOOOXOOOOOXOOOOOXXOOOOOXXOOOOXOXOOOXOOOOXOOOOOOOXOOOXOOOOXOXOOOOXOOOOOOOXOXOOXOOOOOXOOXOOXOOOXXOOOO
XXOOOOOXOOXOOOOOXOOOOOXOOOOOXXXOOXXOOOOOXOOOXOOOOOOOOOOOOOOOOOOOOOXOOXOOOOXOXOOXOOXOOXXXXOOOOXOOOOOXX
OOOXXOXOOOOXOOXOXOOOOOXOXOOOOXXOOOOOOXXOOOOOOXXXOOXXOOOOXOXXOOOOXOOOOXOOOOXOOOOOOOXOOOOXOXOOOOOOXOOOO
XXOOOXXOOOOXXOOXOOOOXXOXXOOXOOXOOOXXOXOXOOXOXOOOOOOOXOXXXXOOXOOOXXOOOOXOOOOOOOXOOOOXOOXOOOXOOOOOXXOOX
OOXOXXXXXXOOOOOOOOXOXXXOOOOOXXXOXXXOOOXXOOOXOXXXOXXOOOOOOOOXOOOOOOOOOOOOOXOOOOOOOXOOOOOOOOXOOOXXOXOOO
XXOOOOOOXOOOOXOXXOXOOXOOOOOOXOXXOOOOOOOOOOXOOOOXOOOXXXOXXXOOOOOXOOXOXXOXOOOOXOOOXOOOOOOOOOXOOOOOOOOOO
XXOOXOOOXXOOXXOXOOXXOOOXXXXOOOOXXOOOXOOXOOOXOOXOOXOOOXOOOOOOOOXOXXXOOOOXOOOOXOXXOOOXXOOOXOOXOOOOOOXXO
XOXOOOOOOOXXXOOOXOOOOXOXXOXOXOOOOOOOOOXOXXOOOOOOOOXXOOOOOOXOOOOOOXOOOXOOOOOXOXOXOOXOOXOXOXXXOOOOOOXOO
OXOOOOOOXOOOOOOOOXXOXOOXOOOOXOXXXOOXOOXOOOXOOOOOXXOOOOOOXXOOOOXOXOOOOOOXOOOOOOXXXOOXOXXXXOOXOOOOOXOOO
