OXXOOOOOOOOOXOOOOXOOOOXOOOOOOOOOOXOOOOOOXOXXOOOXOOOOOOOXOOXOOXOOOOXOOOOOOOXXXOOOOOXOOOOOOOXOOOOOOOOOX
XOXOXXOOOXOXXXXOOOOOXOOOOXOOXXXOOXOOOXOOOOOOOOOOXOXOOOOXOOOXOXOOOXXOOXXOXXOXOXXOOOOXOOOOOOOOOXOOOXXXO
XOOOOOOOOXOXOXOOXOOOOOXOXOOOXOOXOXOOOOOOOOOOXOOOXOOXOXOOOOOOOOOXOOOOXXXOOOOOOOXOXOXOOOOXOXXOXXOOOOOOO
XOXXXOOOOOXXOOXOOOXOOOXXOOOOXOOXOOXXXOOXXXOXOOOOOOXXXOOOXOXOOXXXOXOOXOXOOOXOOOOOOOOOOOXOXOOOOOOOOOOOO
XXOOOXOOOXOOOXOOXOOXOXOOOXOOXOOOOOOXOOOOOOOXOOXOOOOOXOOXOOXOOOXXOXOOOOOOXOXXXOXXOOOOXOOOOOOOOXXOOOOXX
OXOOOOOXOXOXOOOXOOXXOXOOOOOOOOXOXOOOOOXXOOXXOOOOXXOOOXOOOXOOXOOOOXXXXOOOOOOXOOOOOOOOXOXXOOOOOOOOOXOXX
XOOXXOOOOOOOXOOOOXOOXOOXOOOOOOOOOOOXOXOOOOXOOXOXXXOOOOOXXXXXOXXXOOOOOOOOOOOOXOXXOOXOOOXOXOOOOOOOOOOXO
XXOOOXOOOOOXOOOOOOOOOOOXOOOXOOOOOOXOOXXOOOOXOOOOXXOOOOOOXOOOOOOOOXOXOOOOOXOOOXOOOOXOOOOOXXOXOOOOOOXOX
OOOOXOOOOOOOOOXOXXXXXOOOOOOOXOOXOOXOOOOOOOXOXOOOOOOXXOXXOXOOOOOOOXOOXOXXXOOOOOOOOXOOOXOXOOOOOOOOOOXXO
OOOOOOOOOOOOOOOOOOOXOOOOOXOOOOOOOXOXXOOOOOXOOXXOXOOXXOOOOXOOOOOXOOOOXOOOXOOOXOXXXOOOXOXOOOOOOOOOOOOOO
XXOOOXOOOOOOOXOOOOOOOOOXOOOOOOOOOOOOXOOOOOXOOOOOXXOXOXOOOXOOOOXOXOXOOOOOXOOXXOOOOXOOOOXOXOXOOOOOOOXOO
XOOXOOXOOOOOOXXOOXXOXOOOOXOXOOOOXOOOOXOOXXOOOOXOOOOOOOOXOOOOXXOOOOXOOOOOXOOOOXOOXOXXOXOOOOOOXXOOOXOOO
XXXOOOXOXOXOXOOOXXXOXOOXOXOOOOOXXOOXOOOXXOOOXOOOOOXOOOOXOOXOXOXOOOXXOOOOOOOOXXOXOOOOXXXOXOOOOXOOOOOXX
OOOOOOOOOOOOOOOOXOOXOOOXOXOOOXOOXOOXOOXOOXXOOXXXOXOOOOOOOOOOXOOOOXOOOOOXOXOXXXOOXOOOXOXXOOOOXOOOOOXOX
XXOOXOOOOOXOOOOOXOOXXXOOOOOOOOXOOOOOOOOOXOXOOOOXXOXOXOXOOOOOOOOOOOXOOXOOXOOOOOXOXOXOOOOOOOOOXXXXXOOOX
XOOOOOOOOOXOOOOXOOXOOOOOXOOOOXXXXXOXOXOOOOOOOXXOOXOXXOXXOOOOOOXOOOXXXXXOOOOOOOOOXXOOOOOOXOOOOXOOOOOOX
OOOOOXXXXXOXOOOXXXOOOOOOXOOOOOOXOOOOOOXOOXXOOOXOXOXOOOOOOXOOOOXOOOOOOOOXXOOXXOXOOOXOOOOOOXOOOOOOXXOOO
OOXOOOOOXXOOOXOOOOOOOOOOXOOXOOOXOOXOOOOXOOOOXOOOOOXOOOXOOXOXOOXOOOOXOOOOXXOOXXOOOOOOOOXXXOXOOXXOXOOXO
OOOOOXXOXXOOOOXXOXOOXOXOOOOOOOXOOOOXXXOXXOOOOOOXOXXOOOOOXOOOOXXOOOOXOOXOOOOOXOOOOOOOOOOOXXOXXOOXXOOOX
OOOOXXOOOOOOOOXOOXOOOOOOXOOOOOOOOOOOOOOOOOOXXXXOOXXOOOOOXOOOOOOXOXOOOXOXOXOXOOOXXOXOOXOOOOOOOOXOOXOXO
XOOXXOXXOOOOOOOOXXOOOOXXOOXOOOXXOOXOOXOOOOOOXOXOOOOOXOOXXOOXXXOXOOOOXOXXXOXOOOOXXOOOOOXOOOOOOXOOOXOOX
XOXOOOOOOOOXOOOOOOOOOOOOXXOOXOOOOOOOOOOXXOXXOOOOOOXXXXOOXOXOOXXOOXOOOOOOXXOXXXOOOXOXOXOXXOOOOOOXOOXXO
OOXOOOOOOOOOOOOOOOOOXOXOXXOXOOOXOOXOXOOOXXXOOOXOOXOOOOOXXOOOOOOOXOOOXXOXOXOOOXXXOXXOXOOOOOOOOOOOXOXOO
OOXOOOOOOXOXOXXXOOOOOXXOOXOXOOOOOOOXXOOOOXOXXOXXXXOOOXOOOXXOOOOXXOOOOXOXOOOOOOOXOXOXOOOOOOXOOOXXXOOXO
XOXOOOOOXOOOXXXOOOOOXOXOOOOXOOOOOXOOXOOOXXOOOOOXXOOOOOOOOXOOXXOXOOOXOOOOOOOXOOXXXOOXOOOXXOOOOOOOOOOOO
XOXOXOOXXXOOOOOXOXOOXOOOOOOXOXXOOXXOOOXOXOXXXXXOXOOXOOOOOXOOOOOXOOXOXOOOOOXOOXOOOOXOOOOOOXOOXXOOOOOXO
OOOOXXOOXOOXOOOOOXOXOXXOOXOXOOOOOOOOOOXOOOOXOOOXOOOOOXOXXXOOXXOOOXOOXXOXXOOOXOOOXXOOXOOOOOOOOOXXOOOXO
OOOOOXOOOOXXOOOXOXOXOOOOXXOXXOOOOOOOOXOOXOOOOXOOOOOXOXXOOXOOOXOOOOXXXXOOOOOOXOXOOOOOOXOOOOXOOOOXXOOOO
OXOOOXOXXOOOOOOXOOOXOOOXOXOOOOOOOOOOOOXXOOXOOOXXOOOOOOXOXXOOOXOXOXOOXOOOOXOXOOOOOXOOOOOOOOOOOXXXOOXOO
OXOOXXXOXXXOOOOXOXOOOXOOOOOOOOOOOOOOOOXXXOXOXOXXOXOOXOOXOOOOOOOXXOOOOOOOOOXXXXXOOOXOOOOXXOOOOOOOOOXXX
OOOOOOOOXOOOOOOOXOXXXOXXXOOOOOOOOXXOOOXOOXXOXXXOOXOOOOXXOXOXXOXOOOOXOOOOXOOOOOOXXXXOXOOXXOOOOOOOOOXOX
XOOXXOXXOXOOXXOXOOOOOOOOXOOOOXOXXOOOXXOXOOXOOXXXOXOXOOXXXOOOXXOOOXOXOOXOOOXOXXOOXXXXOOOOOOOOOXOOXOOOO
OOOXXOOOOOXXXXOOXOOXOXOOXOXOOXOXOOOXOOOOOOOOXOXOOOXOOOOOOOXOXOOOOOXOXOOXOOOOXXXXOOXOOOOOXOOOOXXOXXXOX
OXOOOOOOXXOXXOOOXXOOOXOXXXOOOXXOXOXOOOXOOOOOOOXXOOOOOOOOOOOXOXXOOXXXOOXXXXXXXOOOOOOOXOXOXXOOOOOOOOXOX
OOOXXOOOXOOXOOOOOOOOOOOOXOOOOXOOOOOXOOOXXOXOOXOOOXOOOOOOOXXXOOOXOOXOXOOOXOOOOOXOXXOOOOOOOOXOOOOOXOXOO
OOOOOOOXOOOOXOXOOXXXOOXOOXOOOOOXXXOOOOXOOOOXOOOXOOOOOOOOOXOOOOXOXXXOOOOOOOOXXOXOXXXOXOOXXXOOOOOXOXXXO
OXXOOOOOOOOOOXOOOOXOOXOOOOOXOOOXXXXXOXOXOXOOOOOOOOOOXOXOXXOXXOOXXOOXXOOOXOXOOXOOOOOOOOXXOXOOOOOOOXOOO
OXOOOXOXOOXOOOOOOXOXOOXOXOOOOXXXXXOXXOXOOOOXOXXOOOOOXOXXOOOOOOOOOOXOOOOOOOOOOOOOOOOOOOOOOOOOOXOXXOOOX
OXOOOOXOOOXOXXOXOOXOOOOOXXOOOOOXXOOOOOOOOXOOOOOOOOOOOOOOOXOOOOOOOOOOXXOOOXOOOOXOOXOXXOOOOOOOOOXOOOXOX
OOXOXOOOXOOXOOOXOXOOOOOOOOOXOOOOXXXOOOOOXOOOXOOOOXOXOOOOOOOOOOOOOOOXOOOOOOXXOOOXOOXXOXXOOOOOXOXXOOOXX
XXOOOOOOXXOOXOOXOOOOOOOOOOOOOXOXXOOXXOOOOOOXOXXXOXXOXOOXOOOOOOOOOXOOXOXOOOOOOXOOOXOOOXXOOXOOXOOOOOOOO
XOOOOOOXOOOOXOOXXOXOOOOXXOXOXXOOOOOOXOXOOOOXOOOXXXOOOOXOOOOXOOXXOOOXOXOXOOXOOOOOOOOXXXOOXOOOXXXXOOXXX
OOOXOXOOOXOOOOOOOOOOOOOXXOOOOXOOOOOXOXXOOXOOXXXOOOOOXOOXOOOOOOXXOOXOOOXOOOXOOXXOXOXOXXOOXOOXOXOOOOOXX
OXXXOOOOOOXOOXOOOXOOXXOOXXOOOOOOOOXXXOOOOXOXXOOXOOXOXXOOOOOOXOOXOOXXOXXOXOOOOXXOOXOOOXXOOOOOOOOOXOOXX
XXOXXOOOXXXOOOOOOOOOOOOOOXXXOOXOOOOOOXXOOXOOOOOXXOXOOXOOXXOOOOOXOOOOOXXOOOOOOOOOOOOOOOXOOXOOOXOXOOOOO
OXXOOOXXOOXOOOOXOOXOOOXOOOXOOOOOOOOOOOXXOOOXXXOOXOOOOOOOOXXOOXOOOOXOOOOXOOOOOOXXOXOXOXOOXXOOOOOXXOOXO
XXXOXOOOOXXOXOOOOOOOOOOXXOXOXOOOOOOOOXOOOOOOOOOOOOOOOOXOOOXOOXXOOXXOOOOOXXXOOOOOOXOOXOOOOXXOOOXOXOOXO
OXXOOXXOOOOOOOXXOOOXXXOOOOOOOOXOOXOOOXXOOOOOXOOOOOOOOOXOOXOOOXXOOOXXOOOXOOOOXOXOOOOOXOOXOOOXOOOOOXXXO
OXOXOOOOOXOOXXXOXXOOXXOOOXXOXOOOOOOOXXXXOOOOOOXOXOXOXOXOOOOOOOXOOOXOOOOXOOXXOOOXOOOXOOOOOXOOXXXOOXOOO
OOOXOOOOOOXOOXOOOOXOOOXOOOOOOXOXOXOXOXXOOOOXOOOOXXOOXOOOOOOOXXOXXOOOXOOOOOXOOOOOXXOXOOXXOXXOOOOXOOXOO
OXOOOXOOXOOOOOOXOOOXOOXOXOOOXOOOOOOOOOOXOOOOXOOOXOXOOXOOOXOXOOOOOXOXXOOOOOXOOOXXOOXXOOXXOOOXOXXOOXXOO
OOOXOXOOOOOOXXXXOOXOXOXOOOOOOXXOOOXOOXOXOXXOOOXOOOOXOXOOXXXOOOOOOOOXOOOOOOXOOOOOOOOOOOXOOOXXOOOXXOOOO
OOXOOOOOOOOXXOXXOXOOOOOOXOOOOOOOOOOXOOXOXOOOOXXXOOXOOOOXOOOOOOOXOOOOOXXOOXOOOXOOOXXXOXXOOOOXXXOOOOOXO
OOOOOOOOOOOOXOXOOOXOOOOOOOOOOOOOOOXOOOOXOOOXXXOOOOOXXOOOOXXOXXOOXXOOOXOOOOOOOOXXOXOOOOOOOOOXXOOOXOOOO
OOOOOOOOOOXXXOOOOOOOOOOOXOOXXOXOXXOOOOXXXXOXXOOOOOOOOXOXOOOXXOOOXOXOOXXXOOOOOOOXXOOOOOOOOOOOXOOOOOOXO
XOXOOXOOOOOOOOOOOOXOOOOOOOOXOOOOOOOXOXXOOOOOXOOXOOOXXXXXOOOOOOXOXOXOOXOOXXOXOOOOOOXOOOXOXOOOOOOOXXOOX
OOOOOOXXXXOOOXOOOXOXOOOOOOOOXXXXOOOXOXOOOOOOXOOOXOOOOXOOOOXOOOXOOOOOOOOOOOOOOXOOXXOOOXOOOOOOOOOOOXXOO
OXOXXXOXOOOXOOOOOOXOOXXOXOXXOOOOXOOOXOOOOOXOOOXOOOOOOXOOOOOOOXOXXOOOOXOOOOOOOXOOOOOXOXOOOOOXOOOXOOOOO
OOXXOOOXOOOOXXOOOXOOXXOOOOXXOOXXOOOXOOOOOOOOOOXOOOOXOOXOOOOOOOXXOXXOOXOOXOXOXOOOOOXOXOOXOXXOXOOOOOOOX
XXOXOXOOOXOOOOXXOOXOOOOOXOXOOOOXOOOXOOOOXXXXXXXOXOXXXOXXOXOOXOOXXOOOXOOOXXOXXOOXOOOOOOXOXXOOOOOOOOOOO
OOOOOOXXOOOOOOXXXOXOXOOXOOOXOOOXOOOXOXXOOOOOOOOOXXOXOOOOOOXOOOOXOXOOOXOOOOOXOOXOXOXOOXOXOOXOOOXOOOXOO
OOOOXOXOXOOXXOXXOOXXOOOXOXXOXXOOOOOXOOOOOOOXOOXOOOOOOXOOOOOXOOOOOOXXOXOOOXOOXXXOOXOXOOOOOOXXOXOOXXXXO
OOOXOOOOXOOOOOXOOOOOOOXXOXOOOOOXOOOOOOOOOOXOOOOXOOXOOOXOOOOXOOXOXOOXOOOOXOXXOOOXXOOXOOOOOOOOOOOXOXXOX
OXXXOXOOOOXOXOXOOOOOOXOOOXOOXOXOOXOOOOXOOOOXXOOOXXXOXOOOOOXOOOXXOOOXOXXOXOOOOXOOXXOOXOXOXXOOOOOOOXOOX
XOOOOXOOOOOOXOOOXXOOXOOOOOXOOOOOXXOOOOOXXOOOOOXXOXOXOOOOXOOOOOOOXOXOOOOOXOXOOXOOOOOOOOOOOXOXOOOOOOOOO
XOXOXOXOXXXXOXOXOXXOOOOOOOOXXOOOOXOOXOOXXOOXOOOXOOOXOOOOOXOOOOOOXXOOOOOXXOOOOOXXOXOOOXOXOOOOOOOOOOOOO
OOOOOOXXOXXOOOOXOXOXOOXOXOXXOOOOOXOXOXOOXXXOOOXOOOOXOOXOOOOOOXOXOXOXOOOOOXOOXOOOXXOOOOOXOOOOOXOOOOXXO
OXOOXXXOOXXOOXXOOOOXXOOOOXXOOOOOXOXXOOOOXXOOOOOOOXOOOXOXOOOOOOOOOOOOOOOXOOOXOOXXXOXXOOOOXOXOOXOOXXOXX
OOOOXOOOXOOXOOOOOXXXOOOOOXOXOOXOXXOOOOOOOOXOOXOOXXXOOOOXXOOOOOXOOOXOXOXOOOOOOOXOOOXXOXXOOOXOOXXXOOOOO
OOXOXXOOOXOOXOXXOOOXOOXOOOOXOOXOXOOOOOOOOOOXXOOOOOOOXXXOOOOXOOOXOOOOOOOOOXXOOXXOOOXOOXOOOOOOOOOOXXOOO
OXOOOOOOXXXXOOXOOOXOOXXOOOOOOOOXOOXOOOXXXOXOOOOOXXOOOXOXOXOOOXOOXOXOOOOOOXOOOXOOXOOXOOXOOOOOXXOOXXOOX
XXOXXOXXOXXOOOOOOXOXXOOXOXOOXOOOOOXOXOOOXOOOOXOOOOOOXOXOOXXOOXXOXOOXXOOOXOOOOOOXOOOOOOXOXXXXXOOOXXOOO
XOOOXOOOXOOOOOXXOOXOOXOOOXOOXOXXOOOXOOOOOXOOXOOOXOOXOXOOOXOOOXOXXOOOOOOOXOXOXXXOOOXXOOOXOOOOXXOOOOOXX
OOXOOOOOOOOOXXOOXXOOOOXOXOOOOXXOOOOOXOXOOOXOOXXOOXXOXOXOOOOOOXOXOOXXOOOOOOOOOOXOXOOOOOOOOOXOOOXOXOOXO
OOOOXOOOOOOOXOOOXOOXOOOOXXOXXXOOOOXXOXOOOOOOOOXXOXXOXOOXXOOXOXOOOOOXOXOOOOXOOOOXOXXXXXXOOOXOXOOOOOXOO
OXOOOOOOXOOXOXXOXOOOXOOOXOOXOXOOOXOOOOOOOOOXOOXXOXOOOOXOOXOOOOOXOOOOXOOOXOOOXOOOOOOXOOOOOOOXOOOOOXOOO
XOOOOXOOOOOOXOOOOOOOOOXOXXXXOXXOOOOOOXXOOOOOXOOOOOOOOOXOOXOXOOOXOOOOXOOXOOOOOOXOOOOOOOOXXOXOOOOOXOOOO
OOXOXXOOOOXXXXOOOOOXXOOOOOOOXOXXOOXXOXOOXOOOOOOOOOXOOOXOOXOXOOOXOXOXOOOOOOOOOOOXOXOOOXOOOOXXOXOXXXOOX
OOOOOOOOOOOXXXOXOOOOOOOOXOOOOOOOXOXOOOOXOOOOOOOXOXOXXOOXXOOOXXOOOXOXOOXOOXOOOXOOOXOOOOOOOOXOXOOOOXOOO
XOOOOOOOXXOOOOXXOXOOOXXOOOOOOXXOOOOOXXOXOXOOOOOOOXOOOOOXXOOOOXOOOXOOOXXOOOOOOOXOXOOOOOOOOOXOOOOOOXOOO
XXOOXXOOOXOOOOOXOOOOXXOOXOOOOOXOXOOXOOXOOXOOOOOXOOOOOXOOXOOOXOOOOOOOXXXOOOOOOOXOOOOOOXXOOOXXOOOOOOOOO
XOOOOOXOOOOXXOOXOXOXOOOXOOXOOXOOOXOXOXOOOXXOOXOOXOOOOOOOOOOOOOXOOXXOOOXOOXXOOOOOXOXXOXOXOOOOXXXXOOXOX
XOOOXOOOXOXOOOOXOOXOOXOXOXOOOXOXXOXOOOOOOOXXXOOOOOOXOOOXXOOOOOOOOXXXXXXOOOOOXOOXOOXOXXXXOXOOOOOXOOOOO
OOOXXOOOXOXOOXXOOOOOXXOXOOOOOOOOOXOXXOXOOOXOOXOOOOOXXOXOXOXXXXOOOXOOOOOOXOOOOXXXXOXXOXXOOOXOOOXOOOOOO
XOOOOOOXOOOOOOOXOOOOOOOOXXXXXOOOOXOOXOXOXXOOOOOXOOOXXOOOOXOXOXOXXXOOOOOOOXOOOOXOOOXOXXOXXOOXOOOOOOOOO
XXOXOOOOOOXOOOXOOOOOXOOXOXXXOOOOXXOOOOOXOXXOOOOOXOOOOOOOOOXXOOOOOOXOOOOXOXXOOOXOOXXOOOOXXOOXOOOXOOOOO
OOOOOOOOOOOOOXXXOOXXOOXOOXOXXOOOXOXOOOXOOOOOXOXOXOOOXOOOOOOOXOOOOOOOOXOXOOOXXOOOOXXOOOOOOOXXXOOOOXOXO
XOOOOOXXOXOOOXOXOOOOXXOXOOOOXOOXOXOXOXXXXOXOOOXOOOOXOOOOOXXOXOXOXOXXOOXXOXOXOOXOXXOOOXOOOXOOOOOOXOOOX
OXXOOXOXOOOOXOXOOXXOOOXOXOOOXOOOOOXOXOOXOOOOOXOOOOOOOOOOOOXOOOXOXOXOOOOOOOXOOXOOOOOXXOOOOOOXOOXXOXOOO
XOOOOOOXXOOOXXXOXOOXOOXOXOOXOXXOOXOXXOXOOOOOXOOOOXOOOXOXOOOOOXOOOOOXXOOOOOOOXOOXOOXOXOOOOXOOXXOOXOXOO
XOOOOOXXOOOXOOXXOOXXOXOOOOOXOOOOOOOOOOOOXOOOOOXOXOOOOOOOOOOOXOXOOXOOXXOOOOOXXOXOXOOOOXXOOXXOOOOOOOXXO
OXOOXOOOXXXOXXOXXOOXXOOXXOXOOOOOOOOXXOXOOXOXOOOOXOOOOXOOOOOOOOOOOOXXXXOOOOXOOOXOOXOXOOOOOXXOOOOOOOXXO
OOOOXXOOXOOXXOOOXOOXXOOOOOOOOOOOOXXOXOOOOOOOOOXOOXOOXOOOXOXXXOOXXOOXOOOOXXOOOOOOXOOXXOOOXOOOOOXOOXOXO
XOXOXOOOOOOXOOOOOXXOOOXOOOOOOOOOOOOOOOOXOOOOXXOOXOXOOOOXOOOXXOOXXOXOXOOOXOXOOOXOOOOOXOXXOXOOOOOXXOOOO
XOOOOOOOOXOOXXOOXXXXXOOXXOOOOXXXOXXOOOXXOOXOOOXOOXOXOOOOXOOOXXOXXOXOXXOOXOOOXOXXXOOXXXOXOOXOOOOOOOOXX
OOXOOOOOOOOXOOOOOXOOOOOOOOOXOOXOOXXXOOOOOOOOOOXOOOXXOOXOOOXXXXOXXXOOXOOOOOOXOXOOOOXXOOXXOOOOXOOXOOXXO
OOOXOOXOOOOXOXOXXXOXOOOOOOXOXOOOOOXOOOOXXXOXOOXXOOOOOXOOOOOOOOOOXOXOOOXOOXOOOXOOOXXOOOXOOOOOOOOOOXOXO
XOOOOOOOXXXXXOXXOXOOOOOOOXOOXOOXOXOXOXOOXXOOOOOOOXXOXOOOXOXOOOXOOOOOOXXOOOOOOOOXOOXOOOOOOOXOOOOXOXXOO
OXOOOOOXOOOOOOOXOXOOOOOOOOOOOXXXXOOXXOXOOOOOOOXXOXOOOOOXXXOOXXXXXOXXOOOOOOOOOOXOXOXXOOOOXOOXOXXOOOOOO
OOOOOOXOXOOXOOXOXOOOOOOXOOOOXOOOOOOOXXOOOOXOXXOOOXOOOOOOOOOOOOXOOOOOXXOXOOOOXOOXOXXXXOXXOXXXOOOOOOOXO
OOXXOXOXOOOOOXOXXOOOXOOXOXXOOOOOOOOOOOOOOOOOXOOOOXXXXOOOOXXOXOOOOOOOOOOOOOXOXOOOOXOOXOOOOOOOXXOOOOOOO
