OOOOXOXOOXOOOOXOOOXOOOXOXOOOOOOOXOOOOOOXXOXXOOOXOOOOOOOXOOOOOOOOXOOXOXOOOXOOXOOOOXOOOOOOOOOOOOOOOOOXX
OOXOOOOOOOOOXXOOOOOXOOOXOOXOOXOOOOOOOOXOOOXOOOOOOOOXXXXXXOXXXOOXOOOOOOOXOXOOOOOOOOOOOOOXXOOOOOOXOOOOX
OXOOOXOOOOOXXOXXXOOOOOOOOXOXOOXOOOOOOOXOOXOXOOOXOXOOOOOOOOXXXOOXOXOOXOXOXOOOOOOOXXXOXOOXOOOXOOXOXOOOX
XXOOOOXOXOOOOOOOXOOXOOXOXOOOOOOOOXOOOOOOOOOOOOOOOXOOOXOOOOXOXOOOXOXOOOOXOXOOXOXOOXXXOXXXOXOOOOOOXXXOO
OOOXXOOXXOOOXXOOXOOOOOXXOXOOOOOOXOOOOXXXOOOOOOXOXXOXOXOOXOOOOOXOXOXOOOOOOXXOOXOXOOOOOOOOOOOXOOXOXXXOO
OXOOXOOXXOXXOOOOXOXXOOOOXOOXOOOOOOOOOXXOOOOOXOOXOXXXOOOOXXOOOOOOOOOOOOOXOOOXXOXOOOOXXOOOOOOXXOOOXOOOO
XOOOOXOOOOOXOXOOXOXOOOXXXOOOOOXOOXXXOOXOOXOOOOOXOOOOXOOOXOOOOXXOOOXOXOOXOOXOOOOOXOOOXOOOOOXXXXXOOOXXX
OOOXOOOOXOOXOOOOXOXOXOOXOOOOXOOXOOOOOXXOXOOOXOOOXXOOOOXOOXOOOOXOOOOXXOOXOXXOOOOOOXXOXOOOOXXOOOXOXOOOO
OOOOOXOXOOOOOOXOXOXXXOXXXOOOOOOOOOOOOOOOXOOXOOOOXOOXOOOOOOOOXOOOXOOXOOOOXXOOXOOOOOXXOXOOOOOXXOOOOOOOO
OOOOOOXOXOXOXOOXXOOOOOXOOOOOXOXOOOOOXOOOOXOOOXXOOXOOXXOOXXOXOXXXOXOOXOOXXOXXOXOOOXXOOXOOOOOOOOOXOOOOO
XXXOXXXOOOXOOOOOOOXXXOOOXXOXOOXOOOOXOXOOOOOXOOOXXOOXOXXXOOOOOOOXOXOOXOXOOOOOOOXOOXOOXOXOOOXOOOOOXOXOX
XOOOXOXXXOXOOXOXOOOOOXXXOOOXXXXOXOOXOOOOOXOOOOOXXOXOXOOXOOOOOOOOOOOOOXXOOOOOXOXOOOXOOOOOOOOOOOOOOOOXO
OOOXOOOXOOOOOOXXOOXOOOOOOOOXXOOOOOOXOOXOXXOOOOOOOOXOOOOOOXOOXOXOXXOXOOXXOOOOXOXOOOOOXXOOOOXXOOOOOOOOX
XXXOXXXOOXOOOXOXOXOOOXOOOOOOOOOXOXOOOXXOOOOXOOXOXOOOXXOOXOOXXOXOOOOXOXOXXXOXOOOOXOOXXOOOXOXXOOOOOOOOX
OOXOXXOOOOOOOXOOOOOOOOOOOOXOOOXOXOXOXOOOXOOOOXOOOOOOOXXOOOOOXOXXXOOXOXOOXOOOOOOOOXOXOOXXXXXXOOOOOOOOO
OOOOOOXOOOXOXOOOXOOXXOOOOOOOXOXXOOOOOOOOOOOOXXOOOOOOOOOXXOOOOXOOOOOOXOXOOOXOOOXOOOXXXXOOOOOXOXOOOOOXX
OXOXOOOXXXOOOOOXOOOOXXXOOOOOOOOXOOOOOOOOOOOOXOOOOOXOOOOOOOOXOXOOOXOOOOOOOOOOOOOOOOOOXOOOXOOOOXXOOOOXO
OXXOXXXXOXXOOOOOXXOXOOOOOOOXOOOOOXOOXOOOXOOOOXOXXOXOXOOOOXOOOOOOXXOOOXXOOOOOOOOOXXOOOOOOOOOOXXXOOOXXO
OOOXOOOOOOXXOOOOOOOOOOXXOOOOOOOOOOOOOOOOXOXXXOOOOOOOOOXOOOXOXOOXXOOOXOXOOXOOXXXOOOOXOOOOOOXOOOOOOXXOO
OOOOOXOXOOOXXOXOOOOOOOXOXOOOOXOOOOOXOXOOXOXOXOXOXOOOOOOXOOXXOOOOXXOOOOXXOOOOXOOOOOXOOOOXXOOXXOOOOOOOO
OXOOOXXOOOOOOXXOXOOOXXOOOOXOOOXOOOXOOOOOOOXOOOXOOOXOOOXXXOOOXOOXOOOOOXOOXOOXOOXOOOOOOOOOXOOOOOOOOXOOO
OOOOXOOXOOOOOOOOXOXXXOOOOOOXOOOOOXXOXOOOOXXOOOXOOXOOOOXOOOXOXOOOOOOXXXOOXXOOOOOXOXXXXXOOOOOXOXOOOOOOX
OXOOOOOXXXXXXOXOOOOOOXOOXOOXOXOOOOOXOXOOOOXOOOOXOOXOOOOXXOOOXXOXOXOOOOXOOXOOOOOOXOXXOOOOOXOOOOXOOOOOO
OOOXOXOOOXOOOXOOXOOXOOXXXOXOOOXXXXOOOOOOOOOXOXXOXXXXOOOOXOOOOOOOOXXOOOXOOOOOOOXOOXXOXOXOOOOOXOXOOXXOO
XOOXXXOOXOOOXOOOOXOOOOOOOXOOXOOXXOOOOOXOOXOOOXOOOOXOOOXOOOOOOOOOOXOOOXOOOXXXXXOOOOOOXOOXOXXOOOOOOOOXO
XOOOOOOOXOOOOOOOXOXOOOOOOOXXOOXOOOXXOOXOOOOOOOOOXXOOOOOOOOOXXOOOOOOOOXOOXOXOXXOOOOOOOOOOOOOOOXOOOOOOX
XXOOOOOOXOOOXOOOXXOOXOOXXXOOOOOOXOOOOOXOXOOOOXOOOXXOOXOOXXXXOXOXXOXOOOOOOOOXOXOXOOOXOXOOXXOOOOOOOXXOO
XOOXOOOXOXOOOOOXOXOOOXOXOOOOOOOXOXOXOXXOOOXOOOXOXOOXOXXXOOOOOOOOXOOXXOOXOXOOOXOOXOOOOXXOOOXXOOOOOXOOO
OOOOOXOOOOXOOOXXOOXXOOOOXOXXOOOOXXOOOOOOXOXXOXOOXOOXOOXOOXOXOOOOOXXOOOOOXOOXXOXXOOOOOOOOXOOXXOOOXXOOO
OOOOOOXXXOOOOXOOXOOOOXOOXOOOXXOOXOXOXOOOOOXOXOOXOOXOOOOOOOXOOOXXOOOOXOOOOXXOXOOOOOOOOXXOOOXOOOXOOOXOO
OXXXOOOOOOOOOXOOOOOOOOXOOXXOOXOOOOXOOOOOXOOXOOXOOXXXXOXOOOOXOXOOXOOXOXXOXOXOOXOOXOOOOOOOXXOOOXOOOOXOO
OXOOOOOXXOOOXXOXOOOOOOOXOOOOOOOOOXOXOOXOOOOOOOOOOOOOXXXOOOOOOXXXOXXOOXXXOXXOOXOOOOOXOOOOOOOOOXOXOOOOO
OXOOXOOXOOOXOXOOOOXOOXOOOXXOXOOOXOOOXOOOOOXOOXXOOOOOOXOOOOOOOOOOXOOXOOXOOOOOOXOOOOXOXXOOXOXOOOOOOOOXO
XOXOXOOOXOXOOXXOOOOXOOOXOOXXXXXXXOXOOOOOXXXOOOOOOOOOOOOXXOOOOOOOOOXOOXOOOOOOOOOOOXOOXOOXXOXOOOOOXXXOX
XXOOXOXXOOOOOXOXOOOXXXOOOXOXXOXOXXOOXXXOOOOXXOOOOOOXOOOOOOOOOOOOXOOOXXXOOOOOOXOOXXOOOXOXXOOOXOOOOOOOO
XOOOOOXXOOXOOXOOOOOXOOOOXOXOOOOXOXOOOXXOOOXOXXXXOXOOOXOXXOOXXOXXOOOXOOOOOOOOXXXOOOXOOOXOOOOOOOOXOXOXX
OOXOOOOXOOOXOXOOXXXOOXOOOOXOOXOOOOXOOOOOOXXOOXOOOOOXOXOOOOOOOOOOOXXOOOOXOXOXOXOOOOOXOXOOOOXOXXOOXXXXO
OOOXOOXOXOOXXOOXOXXOOOOXXOOXOOXXOXOOXXOOOOXOOOOXXOOOXXOOOOXXXOOOOXXOOXXOOOOOOXXOOXXXXOXXOOOOXOOXOOOXO
XOXOOXXOOOOOOOOXOOOOOOOOOOOOXOOOOOOOOXOOOOOOXOXOOOOOXXOXXXXXXOXOOXXOOOOOXOXXOXXOOOOXOOXXXOXOOOOOXXOOO
XOOOXOOXXOXOXXOXXXOOOXOOOOXOOOOOOXOXOOOXOOXOOOOOXXXXXOOOOOXXXOXOOOOOOXOOOXOOXOXOXOXOOOOOXOOOOOOXOXOOX
XOOOOOOOOOXOOOXXOOOOOOOOOOXOXOOOOOOXOOXOOOXXOOXOOOXOOOXOXOXXOOOXXXOOXXXOOOXOOOXOOOOOOOOXXXOOOXXXOXOOX
OOXOOXXOXOOOOXOOOXOXXOOOXXOXOOOOOXOXOOOOOOXOOOOXOOOXOOOOOOXOOOOOOOOOOXXOXOOOOOXOOXOXOXOOOXOOOXOOOOOOX
OXXXOOXXOOOXXOXOOOOOOXXOOXOOOOOOXOXOOOXOXOXXOXOXXXOXOOXOXXOOOXOOOOXOOOOOOXOXOXOOOOOOXXOOOOOOXOXOOOXXO
XXOOXOOXXXOXOOOXOOOOOOOXOXXOOOXOOOOOOXOOOOXXOXOOOOXOOXOXOOOOOOOXOOOOOOOOOOOOOOOOXOXOOOOOOOOXXXOOOXXOO
OOOOOOOOOOXOOXOOOOOXOOOOOOOOOOOXXXOOOOOOOOOOOOXOOOOOOOOXOOXOOXXXXOOOOXOOXOOOOXXOOXOXXOOOXOXOOOXOXOXOO
XOXOOOXOOOXOOOOOXOOXOOOXOOXXOOOOXOOOXOOOOXOOOXOXOOXXOOOXOOOOXXOOXXXOOOXOXXXXXOXOOOOOOOOOOXOXOOOOOOOOX
OOXOOOOXOXOOOXOOOXOXOXOOOOXOOXOOOOXOXOOOXXXOXXXOOOOXOXOXOOXXOOXXXOOOOXOOXOOXOOXOOXXOOOOXOXXXOOOOOOOOO
OXXOOOXOOOOXOXOOXXOXOOOOOOOXOXOXXOXOOOOOOOOXOOOOOOOOOOOOXXXXXOOOOXXOXOOOOOOOOOOOOOOXOOOOXOOXOXOXOXOOO
OXOOOOXOOOXOOOOOOOOOOOXOOOXOOOXOOXOOOXOXOOOOXOXOOOOOXOOOOOOXOOOOXOOXXXOXXOXOOOOOOXOOXOOXOOOXXOXOXXOXO
OOXOOXOXXXOOOOOOOXOXOXOOXOXXOOXOOOOXXOOOXOOOOXOOOOOOOOOXOOOOOXXOXXOXXOXXXOOXOOOOXXOOOXOOOOOXOOOOXXXXO
OXOOOOOXOXXOXOOOOOXXOOXOXOXOOOOOOOXOOOXOXXOXXOOXXOXXOOXXXOOOOOOOOXOXOOXOOOOOOXOOOOXOOOOXOOXOOXOXOXOXO
OOOOOOOOOOXOOOOOOOOXOOXOOOXOXXOOOOXOOOOOOOOOOOOOOOOOOOXXOOOXOXXOOOOOOOOXOXXXOXOOOOXXOOOOOXOXOOOOOXOXO
XXOOOOXOOOOXOOOOOXOXOOOOOXOOOXXXOOOXXOOOOOXOXXOOOOOOOOXOOXOOOOXOOXXXXXXOOOOXOOOOOXOXOOOOOOOXOOOXOXOOO
OOOOOXOOOXXOOXOOOXXOXXOOXOXXOOOOOOXOOOXOOOXXOOOOXOOOOOOOOOXOOOOXOOXOXOOOOXOOXOOXOOOXXOOXXXOOOOOOOXOOX
OOOOOOOOOXXOOXOOOXXXXOOXOOOOOOXOOXOOOOXXOOOXOXOOOOOOOOOOXXXOOXXOOOOXOXOOXOXOOXOOOOOXXOOOOOOXOXOXOOOXO
XXXOOOOOOXOOOOOOXXOXOXXOXOOOXXOOOOOXOOOOOOXOXOXOOOOOOXOOXOOOOOOXOOOOOOXOXOOOOOOOOXOXOOOOOOOXOOOOOXXOX
XOXXOOOXXXXOOOXXOXXOOXXOOOOXOOXXXOOXOOOOOOXOXOOOXOOOOOOOOXXOOOXXOOXXOXOXOOOOOOXOOXOXXOOOXXOOOXOOXXOOO
OOOOXXOOXOOXOOOOOXOOOOOXOOOXXXOXOOOOXOOXXOOOXXOOXOOOOOOOOOOOOOOOOXOOOXXXOOOXOXXOOOOOXXOOOXOOOOXOOXXOX
XOOOOXOOOXOOXOOXOOOXOOXOOXXOXOOOOOOOOOOOXXXOOOXOXXOXXOXXOXOXOXOOOOXOOOOOOXOOXXXOOOXOOOOOOOOOOOOOXXOOO
XXOOOOOOOXOOOOOXOXOOXOXOOOXOXOOOOOOOXOOXOOXXXOXOOOOOOOOOOOOOXOOOOOOOXOOXXOOOOOOXOOOXOXOOOXOOOXOOOOOXO
OXOOOOOXOXOOOXOOOXOOOOOXOXOOOXXXXXOOXOOOOOOOOOOXXOOOXOOOXXOOOOOOOXOOXOOOXOOOOOOOXOXXXXOOOOOOXOXOOOOOX
OOXXOXOXOOOOOOOXOOOXXOOOOOOXXOOXXXOOOXXOOOXOOOOOOOOOXOOOOOOOOOXOXXOOOOXOOXOXOOOOOOOOOXOOOXOOXXOXOOOOX
OXXOOOOOOOOXOOOXXOXOXXOXOOXXOXOOOOOOOOOXOOOOOOOOOXXXXOOXOOOXOOOOOXOXOXOOXOOOXOXOOOOXOXOOXXOOXXXOOOOOX
XXOOOXOXOXOXXOXOOOOOXOOOXOOOOOXOOXOOOXOXOXOOOXOOOOXXOOOOOOXOOOOXOOOXOOOOXXOXOOXOOXOOOOOOOOOXXOXXOXOOO
OXOXXOXOOXOXOXOOOOXXOOOOOOOXOOXOXOOXXXOXOOXOOOOOOOOOOOOOOOOOOOXOOOXOXXOXXOXXXXXXOOOOOOOOOOOOOOXXXOXOX
XOOXXOOOOOXOOOOXXOXOXXOOOXOOOOOOOOOOXXOXXOOOOOOXOOXOOOOOOOOXOXXOXOOOOOOOXOOXOOXOOOOOOOXXXXOXOOOOOXOOO
XXOOXOOOOOXOOOOXOOOXOOOOXXXXOXOOXOOOOXXXOOOOXXOOOOXOOOOOOXXXXOXXXOOXOOXXXXOOOXXXOOOXOXOOOXOOOOXOOOOOX
OOOOOOOOOXOOOOOXXOOOOXOOXOOOXOXXOXOXXXXXXOOXXOXOOOOXOOXXOXXOOOOOOOXOOOXXOXXOOOOXOXOXOOOXOXXXXOOXOXOXO
XOOOOOOOOOOXXOOOOOXOOOXOOOXXXOOXOXOOXOXOXOOOXOOOXOXXOOOOXOXOOOXXOOOOXXOOXOXOXXOOOOOOOXOOOOOOOOOXOOXXO
OOXOXOXXXXXOOOXXOOXXOOOOOOOOOOXOOOOOOOOOOOOXOXXXOOOOOOOOOXXOXOOOOOOOOXOOXXXOOOOOOOOOOXOOOXOXOOXOXOOOO
XOOXOXXXOOOXOOXOOOOOOXOXOOOOOOOOXOXOXOXOOOXOOXOOOXXOOOOXXXXOOXOXOOOOOXOOOXXXXXOOOOOOOOOXXOOOOXOOXOXOO
OOOOXOOOXOOOXOOOOXOOXOOOXOOOOOXOOXOOOXOXOOXXOOXOOOXXOOXOXOOOXXOOOXXOXOOOOOOOOOOOOXXOOOOOOXOOOOXOXOOXO
XOXOOXOOOOOOXOXXOOOXOXOOOOOOOOOOOXXXOOXOXXOXOOXOOXOOOXOXOOOXOOOOOOOXXXOXOOOOOOOOOOOOOOOOXXXXXOOXOOXOO
OOXOOXOOOXOOOOOOOOOOOOOXXXXOOOOOOOOOOOXXXOXOXXOOXOOOOOOXOOOXOXOOXOOXOOXOOOOOOOOOOXOOOXOOOOOOOXOOXOOOO
XXOXOOOXXOXOXOOOXOOOXOXXOXOXOOOOOOOOOOOOOXXXOXOOOOOXOOOXXXXXOOOOXOOXOOXXOOOXOXOXOOOOOXXOOXOXXOOOXOOOX
OOOOOXOOOOOOXOXOXOXOOOOOOXXXOOXOOXXOOOOOOXOOOOXOOOXOOOXOXOOOOOOXXOOOXOOOOOXOOOOXXOOOOOOOOOOOOOXXOXOOO
OOXXXOOXXOXOXOOXOOXOOOOXOOOXOOOOOOOOOOOXXOOXOOOOOXOXOOOOXOOOXOOOOOOOOOOOOOOXOXXXXXOXXOOXXOOOXXOXOOXOO
OOXXOXXXOOXOOXOXOOOOXOXOOOXXOOXOOOXOOXOXXXOXXOOOOOOOXOOOOOXXOOOXOOOOOOOOOXOOOOOOOOXXOOOXOOXXOXXOXOXOO
XXXOOXOOOXOOXOOOXOXOOOOXXXXOOXXXOOOOOOOOOOOOOXXOOXOXXOXOOXXOOOXXXXOOOOOOXOOOOOXOOOXOOOOOOXOOOOOOOOXOO
XXOOOOOXOXOOOOXOOOOXOOOOOOXOOXXOOXOOOOXOOOOOOOXOOOOOOOXOOXOOOOOXXOOOOOOOXOOOOOOXOOXOXOXOOOOXOOOXOOOOO
OOXOOOXOXXOOOOOOOOXOOOXXOXOOOOOOOOOOOOOOOOXOXOOOXOOXXOXOXOOOOOOXOOOOOOOOXOOOOOOOOOOOXXXXXXOXOOOXXXOXX
OXXOOOOOOOOOXXOOOXXXOXOOXXOXXOXOOXOOXOXOOOOXOXOOXXOOOOOOOXXXXOOOXXXOXOOOXXXOXXXXXXXOOOOOXOXOOOOOOOOOX
OOOOOOOXOXXOOOXOOOXOXOXOOOOOXXXXOOXOOOOOOOXXOOOOOOOXXOOOOOOOOXXOOOOXOXOXXOXXOXOOOXOOXOOOOOOXOOXOXXOOO
XOOOXXOOXOOOXOOOOOOOOXXXOXOXXOOOOOOOOXOOXXXOOOOXXOOXXXOOOXXOXXOOOXOXOOXOOOXXOOOOOOOOOOOOOXXOOOOOOOXOO
OOXXOOOOXOOXOOOOOOOOOXOXXXOOXXXXOOOOOOXXXOOOXXOXXOXOOOOXOXOOXOOOOXOXXOOXXXOOOXOOOOXOOXOOOXOOOXOOOXXXO
OOXOOOOOOOOOOOXOXOXOOOOOOOOXXOXOOOXXXXXXXOOXOOXOOOXXOOOOXOOOOOOOOXOOOOXOOOXXOOXOOOXOXOOOOXOOOOOXXXOOX
XXOOOOOOOXOXXOXOOOXOOOOOOXOOOOOXOXXOOOOOXOXOOXXOOOOOOOOOXOXOXOOXOOOOOOOOOOXXOOOXXOOOOXOOXXXXXXXXXOXXO
XXOOOOOOXOOOOOOOOOOOXOOOOXXOOOXOOOOXOOOOOOXXOOOXOOXOOXOXXOXOOOXXOOXOOXOOXOOOOOOXXOOOOOOOOOOXOOOXXXOOO
OOOXOXOXOOOXOOOOOOOOXXOXOOOOOOOXXXXOOXOOOOOOXOOOOXOOOOOOOOOOXOOOOXOOXOOXOXXOOXXOOOXOOOOXOOXXXXOOOOOXO
OOOOXXOOOOOOOOOOOOOOOOXXOOOOOXOOXXOOOXOOOOXXOXOOOXXOOOOOOOOOXXXXXOOXOOOOXXOXOXXOOOOXXXXOOXXOXOOOXOOXX
XXXXOOXOXXOXXOOXOXOXOXOXOOOOOXOOOXXOOXOOOOXOOXOOOXXOOOXXXOXOOOXOXXOOXXOOOXOOOOOOOOOOOXOOOOOOOOXOOXOXO
OOXOXXOOXOOOOOOXOXOOOOXOOOOOOXXXOOOOXOXOOOOOOOOOOXOXOOXOXOOXXOXXOXXOXOOXOOOXXXOOOOOXXOXXXOOOOOOOOXXXO
OOXXOOXOOOOOXOXOOOOXOOXOXOOOXXOOOOOOOOOOOOXOXOOOXOOOOOXOOOXOOOOOOOOOXOOOXOOOXOXOOOOOXOOOOOOXXXXOOOXXO
XOOXOOXXXOOXXOXOXXOOOOXOOXOOOOOOOXOXOOXOOOOOOXOOOOOOOOOOOOOXOXXXOXOOOOOXOOXOXOOXOOOXOOOOOOXOOXOOXXOXO
OXOOOOOOOOXOXOOOOOOOOXXOOXOOOXOOXOOOXOXXOOOXOXXOOOXOOXOOOOOOOOOOOXXOOOXOOOOOOXOOOOOXOOOOXOOXXOOOOXXOO
XOOOXOOOOOOOOXOXXOXXOXOXOOOXOXXOXOOOXOOXOOOOOXOOOOXXOOOOXOOXOOOOXOXOOOOXOOXXXOXOOOXOXOXXOOOOOOXXOXOOO
XOXOOOXOXOOOOOOOOOOXOOXOOOOXOOOXOOOOXOOOOOOOXOOOOXXOOXOOOOXOXOOXOOXOXXXXXOOXXOXOXXOXXOXOOOOXOOXXXXXOO
OOXXOOXOXOXOOOXOOOOXXOOOOOOXXOOXOXOXOOOXOXOXOOOOOOOOXXXOOOOXOOOOOXOOOOXOOOOOXOXXXXOOOOOXOXOOOOXOOXXOX
XOOOOOXXOOXOOXXOXOOOOOOOOOOOOOOOXXXOOOXOOOOOOOOOOXOOXOOXOOOOXOOOOOXXXOXOXOOXOOOXOOOXXOOOOOXXXOOXXOOOO
XXOOOOOOOXOOXOOOOXOOOXXXOOOOXOOXOOOOOOOXOOXXOOOXXXOOOOOOOOOOOOXOXOOOOOOXOXOOOOOOOOOOOOXOOOOOXOXXXOXOO
OOOOOOOOOOOXOOXOXXOXOXOOXXOXOOOOXOXXXXOOXOOXOOXOOOOOOXOXOOXOOOOOOOXOXXXOXXOOOXXXXOOOOOXXOOOOOOOXOOOOO
