XXOOOOXOOXOXOOOOOOXXOXOOOOOXOOOXXOOOOXOOOOOXOXOXOOOOXOOXOOOOOOOXOXOOOOOOXOOOXXXOOXXOXXXOOOXOOOOOOXXOX
XOOXOOXOOOOXOXXOXXXOXOOOOXOOXXXOOOOOOOOXXXXXOOXOOOOOOXXOOOOXOOOOOOOXOXOXOXOOXXOOOOXOOOXOOXOXOXOXXXOOO
OXOOOOOOOXOXOOOXOOOOOOXOOXOOOOOXOOXOOOOOOOXXXXOOOOOOOOOOOOXOOOOOOOOOOOXOOOOOXOOOOOXXXOXOOOOXOOXOXOOOO
OXOOXOOOOOOOXOOOOOOOOOOOOOXXOOOOXOOOXOOOOOOOOXOOOOOOXXOOOOOOOOOXOOXOOXOXOXOXOOOOOXOXOOOOOOXOOOOXXOXOX
OOXOOXXXXOXOOOOXOOOOOOOOXOXOOXOOOXOOOOOOOOOXXOOOOXOOXOXOOXOOOXOXOXOXOOOXXOOOXXOOOOOOOXOXXOOOXXOOXOXOO
OOOOOOOOOXOOXOOOOXOOOOXOXOXXXXXOOOOOOOXOOOXOOOXOXXOOOOXOOOXOOOXOOXOOXOOOOOOOXOXOOXXOOXOOOOOOOOOOXOOOO
OOOOXOOXOOOXOOXOXOXOOXXOOOXXOOOXOOXOOXOXOOOOXOOOXXXOOXXOOOOOOXXOOXOXXOXOOXOXXOOOOXOOXXOOOXXXOXOOXOOOO
OOOXOOOXOXOOOXOOOOOOOOXOOOXOXOOOOOOOOOXXOXOOOOOOOOOOXOOOXOOXOOXOOOOXOXOOOOXXXOXXXOOOOXOOOOOXOOXOOOXXX
OOXOOOXOXXXOOOXOXOOOOOOOOOOXXOXOXOOOXXXOOOXOOOXOOOOOOXOOOOXXOXOOXOOXOOOOXOXOOOOOOOXXOOOOOXXOOOOOOOXXO
OOOOOOOOOOOOOXOOOOOXOOOOXOOXOXXOOOXXOOXOOOXOOOXOOXXOOXXOOOOXXOOXOOOOOOOOOOOOXOOXXXOXOOOOXXOXOXXOOOOOX
OXOXOXOOOOOOOXOOOXOXXXOOXOXOOOOOXOOOOXOOOOOOOXOOXOXOXOOXXOOOOOOOOOXXOOXXOXOOOXXOXOXOOXOXOXOOOXXOOOOOO
OXOOOXOOOOOOOOOXXXOOOOOXOOOOXOOOOOXOXOOOOOOXOOOXXOOXOXOOOOOOXOOOXXXOOXXOOXXXOOOXXOOOOOXOOOXOOOXOOXOXX
XOOOXXOOOOOXOOOOOXOXOOXOOXOOXOOOXOOXXXXXOOOXXXOOXOOXOOOOXXOOOXOXXOOOOXOOOOXOXOXXOXOOOXOOOXOXOXXOOOOXO
OOOOOOOOOXOXXOOOOXXOOXXXOOOOOOOXXXXOOXXOXOOOOOOXOOOXOOOOOOOOXOOXXOOOXXXXXOOXOXOOXOXOOOOOOOOOOOXXXXOXO
OOOOXXXOOOXOXXOOOOOOXOXXOXOOOOOXOXOOOOXOXOXOOOOOOOOXOXOOXOOXOXXOOOOXOXOOXOOOXOOXOOOOOOOOXOOXOOXXXOOXX
OOOOOOOXXOOOOOOOOOOOXOOOOOOOOXXOXOOXOOOOOXOXXXOOXOOOOOOOOOOOXOOOOOOOOOXOOOOOOOXXOXXXOXOOOOXXXXXOXOXOX
XOXOXXOOXOOOOOOOOOOXXOOXXOXXOXOOXXXOXXOOXOXOOXXXXOOOOOXOOXOOOOXXXOOOOOOOOOXXXOOOOOXXOOOOOOOXOOOOOXOOX
OXXOOOXXXXXOOXOOOXOOOOOOOOOXXOOXOXXXOOOXOOOOOOOOXOOOXOOOXXXOOOXXOXOOOOOOOOOOXOOOOXOXOOOOOXOXOXOOOOXOO
OXOOXXOXOOXOOXOOXOOXOOXOXOXXXXOOOOOXXOOOXOOOXXOOXOXOXOOOOOXXOOOOXOOOOXOOOXOXOOOOOXOOOOOOOXXOOOOXOOOOO
OXXOXOOOOXOXOOOOXOOOOOXOOXXOOXOXOXXOXOXOXOOOOOOOXOOXOOOXOXOOOOOOOOXOOOOOOOXXOOXXOXOXOOOOOOOOOOOOOOXOO
XOOOXXOOXXOOXOXOOOOOOOOOOXOXOOOOOOOOOOOOXOXXOOOOOOOXXOOXOOXOOXXXOOOXOOOXOOOXOXOOOOOOOOOOOXXOOXOXOXXOO
OXOOXOOOOOOOOOXXOOXOXOOOOOOOOOOXXXOOOOOOXOXXOOXOOXOOOXOOXXXXOOOOOOXXOOOXXOOXOOOOXXXOXOOOOOXOOXOOOXOXO
OOXOOOOOOOOXXXOOOOXXOXOOOXOOOOOOOXXOOOOXXOOOXOOOXXOOOXXOOOOOOOOOOOXOOOOXXXOOXXXXXXOOXOOXOOOXOOOOOOOOO
XOOOXOOOOOOOXOXOOXXOOOOXOOOOXOOOOOXOOOXOOOXXXOOOOOXXOOXOXOOOXXXOOOOOXXOXXXOXOOXOXXXXOOXOOOOXOOOOOXXOO
OXOOXOOOOOOOOOOXOOXXOOOOXOOOOXOOOXOXOOOXOOXOXXOOOOOOXXXOXOOXOXOOOOOOXOOOOOXOOOOXXOOOOOOOOXXOOOOOOOXXO
OOOXXXXOXOOOOOOOOOXOXOXOOXXOXOXOXOOOOXOXOXOOXOOOOOOOXOOXOOXXOOOOOXOOOXXOXOOOOOOXOOOOXOOXOXXOOXOOOOOOO
OXOOOOXOOOOOXXXOOXXOOOXXXOOOXXOOOOOOOXOXXOOOXOXOOOOOOOOOOOOXXOOXOXOXOOOOXOOXOOOOXOOOXXOOXXOOOXOXOOXOX
XOXOOOOOOOOOXXXOOOXOOXOOOOOOOXOOOXOOXOOXOOXOXOOOXOXOOXXXOOOXXOOXXOOOXOOOOXOOOOOOOXXOOXOXOOOOOOXOOOOOX
XOOXXOXOOOOOOOOOOXXXOXOOOOOOOOOOOOOOXOXXXOOOOOOOXOOOOOOOOOXXOOOOXOOXXOXOOXOOXOOOXOOOOOXOOOOOOOOXOXOOO
OOOOXOXXXOOOXOXOOOXOXOXOOXXXOOOOXOXOOOOOOOOOOXOOOOOXXOOOXOXXOOOOOOXOOOOXOOOOOOOOOOXOOOOOOOXOOOXOXOOXX
XOOOOXOOOOOOOOOOXXXOOOXXOXOXOOOOXOXOXOOXOOOOOOOOOXOXXXOOXOOXOOOOXOOOOOOOOOOOOOOOOOXXOXOXXOXOOOOOOXOOX
XOOXXOXOOOOOXXOXOOOOOXOOOOOXOOXXXXOOOXXXOXOXXXXOOOOOOXOOOOOOOXOOXOOXOOXOXOXOOOOOXOXOOOXOOXOOOOXOOOOXX
OOOXOXOXXOOOOOXOXOXXOOOOOXOXXXOOOOXOOOXXOOXOXXOOOOOOXOXOXOXOXXXXXXXOXOOXOOOOOOOOXXOXXOXXOOOOOOOOOOOXX
OOXXOOXXOOOXOOOXXOXXXOOOOOOOOXXXOOOXOOOOOXOXOOXXOOXOXOXXXXOOXXOOOOOOXOXXOOXOXXXXOOOOOOOOOOOXOXOOOOOOX
OOOXXOOOXOOXOOOOOXOOOOOOOOOXOOXOOOOXOOOXOOOXXXOOOOOOOOOXOOXOOOOOOOOOOOXXXOOOXOOOXOXOOXXXOXOOOOXOOXXXO
XOOXXOOOOXOOXXOXOXOOOOOOOXOXXXXOOOXXOOXOOOOOXOOOOOOOOOOOOOXOOOOOXOOOOXOOOOOOOXOOOOOOOOOOXOXXOOXOXOXOO
OOOOOXOOOOOXOOOOOOOOOOOXOOXOOOOXXOOOOXOOOXXOXOOOXOXOOOOOOOOOOXOXOOXXXOOOXOOOOXOXXOOOXXOOXXOOOOOOOOXOO
OOOOXXOXXOOOXXOXXXXOOOXOXXOOOOXOXXOXOOXOOXOOOOOOXOOXXXOOXXOOOXXOOXOOOXXXXOXOXXOOXOOOOOXOOOXOXXXOXOOOO
OXOXXOXXOOXOOOOOXXOOOOXXOOOOXOXOOOXOOXOXXOOOOXXXOXXXOXXOOXXXOXOOOOOOXOOOOXOOOOOOXXOOOOOOXOXOOXOOOOXOO
OXOOOOOOOOOOOXOOOOOOXXOOXOOOXXOOOOOOOOXOOOXOXOOOOOXXOOOOOOOXOOXOOOXOOOOOXOOOOOOOXXOXOXOOXOOOOOXOOXXOO
OOXOOXOXOOOOXOXXOOOXOOXOOOOOOXOOXOOOOOOOOOOXOOXOOOOOOOOOOOXOXOXXOOOXOOXOXXXOXOXOXOOOXOOXXOXOXXXOOOOOO
XXXXXOOXXOOOOXXOOOOXOXXXOOOOXXOXOXXOOXXOOOOOOXXOOOXOOOOXXOOOXOOOOOXOOXOOOOOOOOXOXOOXOXOXOXOOOXOOOOOXO
XXXOOOOOOOOOOXXOOOOOXOOOOXOOOXOOXXOOOOXOOOXOXOOOXOXXOOOXOOOXXOOXOXXOXOOOOOOOXOOOOOOXXOXOOOOXXXOXOOOOO
OXXXOOXOOOOOOXOOOOXXXOOOOXXOXOOXOXOXXOOXOOOOXOOXOOXOXOOXXOOXOXOXXOOOOOXOOOOOXOXXOOOOOOOXOOOOXOOXOXOOO
OOOOOOOOOXOOOXOXXOOOXOOOOOXOXOXOXOXOOXOOXOOOOOXXOOOOOXOOOXOOOXOOOXOOOXXXOOOOOOXOXXXOXXOOOOOOOOOXOOOOO
XOXXOXOXOOOOOOOXXOXOOOOOXOXOOXOOOOOOOOOOXOXOOOXOXOOOOXXOOOOXOXOXOXOXOOOOXOOXXXXOOXOOXOOOOOXOXOOOXXXOO
XXXOOXOOXXOOOOXOOOOOOXOXXXXOXOOXOOOXOOXOOOOXOXOOXXOXXOOOOOOXOOOOOOOOOOOXOXOOOOXOOOXOOXOOXXOXXOXOOOOXX
OOOOOOOOOOOOOOOXXOOOOOOOOOOOXOOXOXOXOOOXXOXOXOOOOOXOXOOXXOXOOXOOOOXXXOXOOOOOXOOOXXOOOOOOXXXXOXOXOXOOO
OOXXOOOOOXOOOXOXOXOOOOOOOOOXOOXOXOOXXXOXOOXOXOXXXOOXOXOOXXXOOOOOOOOOOOOXOXOOOXXXXOXXXXOOOXOXOXXOOOOXX
XOXOOXOXOXXXOOOOXXOOXOXOXOOXOOXOXOOOOXOOOXOOXOXOOOXOXOOOOXOXOOOOOXOOOOXOOXXXXOXOXOOOOOXOOXXOOXOOOOOOO
OOXOOOOOOOOXOXXOOOXOXOXOOOOOOOOOXOOOOOOOOXOOXOOXOOXOXXOOOOOXOOOOOOOXOXOOOXOOXOXOOOXOOOOOXOOOOOOOOXOOO
OOOOOOOOOOOXXOOOOOXOXOXOXOXXOOOOOOXOOOXOXOXOOOOOOXOOXXOXOOXOXOOOXOOOOXOOOOXOOOOXXXXXOOXXOXOOOOXOOOXOO
OXOXOXOXOOOOXOOOXXOXOXXOXOXOOOXOOOOXOOXOOOOXOOOOOOXOXOOOOOOXOXXOOOXOOOOOXOOOOOXXOOOOOOOXOXOOOOXOOOOXX
OOOOOOXOXOOOOOOOXOXXOXOOOOXOOXOOOOXOXOOOXXXOXOOXOXOOXOOOOXXXOXOOOOXXOOXOOOOOOOOXOOOOOXOOXOXOOXXOOOXOO
OOXOOOOXOXXOOOXXOOOOXOOXOOOXOXOXOXOXOOOOOXXOOOXOOOOOOOOOXOOOOOXXOOXOXOOXOOXOXOXXOOXOXOXOOXOOOOXOXOOXO
OOOXOOXXOOXOXXOXXXOOXOOOOOOXOOXOXOOOXOOOOOXXOOOXOOOOOOOOOXOXOOOOOOOXOOOOXOOOXOOOOOOOOOOOOOOOOXOOOOOOO
OOOXOOXXOXOXXOOOOOXOOOXXXOXOXXOXOOXOOOOOXOOOOOOXXOXXXXOOXXOOOOOXOOXOOOOXOOXOXOOXOOOOXOXOOXOOXXOOOOXXO
XOOOOXXOOXXOOOOOOXOOOOXOOOXOXOOOXOOOOOOOOXXOOOXOOOOOOOOXOXOOXOOOXXOXOXXOXOXOXOXXOXOOXOXXOOOXXXXXXOOXO
OOOXXOOOXOXOOOOOXXOOXOOXOOXOOXXOOOXOOXOOOXOOXXOOXXOXXOOOOOOOOOOOOOXXOOOOOOOOXXOXXOOOOOOXOXOOOOXXXXXOO
OXOXOOXXOXOOOOXOOXXOXXOOOOOXOOOOXOXOOOOOOOOXXXXOXOOOXOXOXOOXOOOOOOXOOOXOOOOOOXOOXOXOOOOOOXXOOOOOXXXOO
OXXOOOOXXOXXOOOOOOOOOXOOOOXOOOXOOOXOOOXXOOOOOOOOOXOOOXXXXOOXOOOOXOOOOOOXXOXXOXXOOOOXOOOOOXOXXOOOOOOOO
OOOXOOOXOOOOXXOOOOOXOXOOOOOXXOOXOOOOXOOOXOOOOOOXXXOOXXOOXXXOXOOOXOOOOOOOXOOOXOOOXOOXOOOOOXOXOXXOOOXXX
OXOOXOOOXOOOOOOXOOXXOOOOOXOOXOXOXOOOOXOOXOOOOOXOOOOXXXXOOXOOXOXOOOOXOXOOOXOOOOOOOOOOXXOOOXOOXOXXOOOOO
OOXXOOOOXOOXOOXOOOOOXXXOOXOOOOOOOXOOOOOXOXOXXXXXOXOXOXOXOOOOOOOXOOOXOOOOOOOOXOOOOOOXXOXOXOOOXOOOOOXOX
OOOXOXOOOOXOOXXOOOOOOOOOOOOXXOOXOXOXOXOOOOOXXOXOXOOOOXOOOOOOOOOXOOOXOOOOOOXXOOOOXOOOOOOOOOOXOXOOXXOOX
OOXOXOOXOOOOOOXOXXXOXOOOXOXOXOOOOXOOOOOOOOXXOOOOXOOXOOXOOOOOOXXXOOXOOOXOOXOOOOXXOXOOOOOXXOOOXOOOOOOXO
XOOOXOXOOOXOOOXXOOXOOXXOOXOOOOOXOOOOXOOOOXOXOXOXOOOOXOOXXXOXOOXXOOOXOOXXXXOXXOOXOOOOOOXXOOOOOOOOOXOOX
OOXXXOOOXOOXOOOOOOOOXOOOOOOXOXXOOXXOOOOXOOXXOOOOOOOXXXOXXOOOOOOOXOXOOOXOOOXXXOOOOOOXOOOOOOOOOXXOXOOOX
OOOOOOXXXOOOOXOOOXOOOOXOOXOOOOOOOXOOOOOOOOXOOOOOOXOOOOOXOOOOOXOOOXOOOXOOOOOOOOOOOOOXXOOXXOOOXXOXXOXXX
OOOOXOOOXOOOOOOXOOOXXOXXXXOXOOXXOOXOXOOXOOXOOOOOOOOOOXXXOOXXOOOOOXOOXOOOOXOOOOXOOXOXXOOOOOXXOOOXOOOXO
XXOOOOOOOOXOOOOOOOOXOXOXOXOOXOOOOOOOXOOOOOOXOOOXXOOOOXOOXXXOOOOXOOOOOOOOXOXOXOOXXXOOOXXOOOOOOOOOOOOOX
OXOOOOOOOOXOOXOXOXOOOOOOOOOOOOXXXOOXOOXOOOXOOOOXOOOOOXXOXOOOXOOOXOOXOOOXXOXOOOOOOOOXOOXXXOXOOOOOXOOOO
XOOOOXXOOOOXOXOXXOOOOOOOOOOOXOOXOOXXXOOXXOXOXXXXOXOXOOXOOXOOOOOOOOOXOOXOXXOOOXXOXOXOOOOOXOOOOXOOOXOXO
OXOXOOOOXOOOOOOOXOOOOOOOXXOOOOOXXOXOOOOOOOOXOXOOXXOXOXOOOOOXOOOOXOXOOOOOXXOOXOXOOOOXXOXOOOOOOXOOOOOOX
OOOXOXOXOOOXOOXOXOXXOOXOOOOOOXOXOOXXXOOXOOOOOOOOOOOOOOOOXOOXOOOOXOXOXOXXOXXOOXOOOXOXOOOXOXOOOOOOOOOOO
OOOOXOXXOXXXOOOXOOOXOXOOOOOXOOOOOXOOOOXOOOOOOXOOOOOXOOOOXOOOOXOXOXXOOXXOOOOOOXOOXOOXXOOXOXXXOXOXOOOOO
OOOOOOOOOXOXOOOXOXOOOXOOOXOXOOOXOOOOOOOOOOOOXOXOOXOOOOXOXOOOOXOOXXOOOOXXXOOXOOOOOOOXXOOOOOOOOOOXOXOOO
OOXOOXOOXXOOXOXOXOXXXOOOOXOOOXOOOOOOOOOOOOXOOXXOOOXOXOOOOXOOOOOOXXOOOXOXXXXXOOOOOXOXOOOOOOOOOOXXOOOXO
XOOXOOOXOXOOXXOOOOOOOOOOOXOOXOOXOXOOOXOOOXOOOOOOOOXOXOOOOOXOOOXOXOXOXOOXOOOOOXXXOXOOOXOOOOOOOOXXOXOOX
OOOOOOOOOXOOXOOXOXXOXOOOOOXOXXOOOOOOOOOOXXOOOOOOOOXXOXXOXOOOOXOXXXOOOOOOOXXOOXOXOOOOOOOOXOXOXOXXOOXOO
OXXXXXOOXOXOXXXXXOOOOXXXOXXXXXOOOOXXXOOOOXXXOOOOXOXXOOOOOOOXOXOOXOOXXOOOXOOOXOOXOXXOXOOOOOOXOOOXXOXXO
OOXOXOXOXXOXXOOOOOXOOXOOOOOXOXOOOXXOOOOXOOOOOOOOOXOOOOOOOXOOOOXOXOOOOXXOXXXOOXOOOOOXOXOOOOOXOOOOOOOXX
OOXOOXOOOOXOOOOOXOOXXOXOXOOOOXOOOOXOOXOOXOXXXXOOOOOOOOXOXXOOXOOXOOOOOXOOXOXXOOXOOOOXXOOOXOOXXOXXOOOOX
OOXOOXXOOXOOOOOXXXOOXOOOXOOXOOOOOOXOOOOOOXOXOXXOOOXXOOOOOOOOOOXOOXOOOXOOOOXOOXOXOOOXOOXOXOOOXOOOXOOOO
XOXOOXXOOXOOOOXOXOOOXOXOXOXOOOXOOOOOOXOOOOXOXOOOXOXOXOXOOXOOOXXOOOOXOOOOXOOOOXOXOOOXXOOXOOOOOXOOXOOOX
OOOOXOXXXOOXOOOXOOXOXOOOOOOOXXOOOOOXOOOOOOOXXOOOOOOXOOXXOXOOOOXOXXOOOOXXOOXXOOOOXOOOXOXXOXXXXXOXXOOXO
XOXOXOXOXXOXOXOOOOOOOXXXOXOXOOOXOOOOOOOOOOOOOOXOOOXXXXOOOOOOOOOOOXXXOXOOOOXXOOOOXOOOXOXOOXOXXOOOXOOOO
OXOOOOOOOOXXOOXOOOXOXOXOXOXOOXOOOOXOOOOXOOOOOXXOOOXOOOXOOXOOXOXXOOOXOOOOXOOXOOOOOXXOOOXXOOXOOOXOOXOOO
OXOXOOOXOOOOXOOOOOOOOOOOOOOOOOOXXOOOXOXOOOOOOOOXOXXOXOXOOXOOXOOOOOOXXXOOXOOOOXOOXOOOOOOOOOOXOOOOOXXOO
OOXXOOOOXXOOXOXOOOOXOOXXOXOOOOOOXOOXOXOXOOXXOOOOXOOXOOXOOOOOOOOOOOXXOXXXOXXOOOXXOXXOXOOOOOXXOOOXXOXOO
OOOOOXOOOOXXOXXXOOOOOXOOOOOOOOOOOXOOOXOOXXXOOOOXOOOXOOOXOOXOOXOOOOOOOOOOOOXOXOOOOXOOOOXOOXOOXOOXXXOOO
XXOOXOOXXOOXOOOOOOOOXXXXXXXOXOOOOOOOOXOOXOOXOXXXOOOXOOOOOOOOOOOOOXOOOXOOOOOOOOXOOOXOOOOXOOXOXXOOXOXXO
OOOOOOOOOXOOOXOXOXOOOXOOXOOOOOOOOXOOOOXXOOOOOOOOOXOOOOOOOXOXOOOOXOXOOOXOOXXXOOXOOOOOOOOOXOOOXXOOXOOXO
OOOXOOXOOOOXOOOXOXOXXOXOOOOXOOOOOOOOOXXOOXOOXOOXXXOOOXOXXXOOOOOOOXOOOOOXOOOOOOOOOOOOOOXOOXOOOXOOOXOOO
XOXOOOOXXOXOXOOOOOOOOXOOXOOOXOXXOOOOOOOOOXOOOOOOOOOOOOOXOOOXOOOXXOOOOXXOXOOXXOOOXOXOOXXXOOOOOOXOOXOOO
XXOOXOOXXOXXOXXOXOXXOOOOOOOXOXXOOXOOOOXOXXOOXOXOOOXXOOXOOOXOOXXXXXXOOXOOOOOOXXOOOOOOXOOOOOXOXOXOOOOOO
OXOOOXOXXOOOOOOOOOOOXXOOOOOXOXXOXOOOXXXXOXOXOXOOOOOXOOOOOXOOOOOXXOOOOOOOOOOOXOXXOOOOOXOOOOOXOOOXOXOOO
OOXOOOXOOXOOOOOOXXXOXXOXOOOOOOOOOOOXOXOOOOOXOXXOOOXXOOXXXOXXOXOXXOOOXOOXXXOOOXOOXXXXOXOOOXOOXXOXOOOXO
OOOXOOOOOOXXOOOOXOXOOOXXOOOOXOOOOOXOOXOOOOOOOOOOOXOOOOXOXOOOOOOOOOOOOOOOOOOXXOOOOOXXOOOXOOOXOXXOOXXXO
OOOOXXOXOXOOXOOOOOXXXOOOOOXOOXXOOOOOOOOOOOXXOOOOOOOXOOOOOOXXXOOXOOOOOOXOXXXOOOXOOOOXOOOOOOXXOOOOOOOOO
OOXXOOXXOOOOOOOOOOOOOXXXOOXXXOOOOOOOXOOXXXOOOOOXOOOOOOXOOOXXOXOXXOOOOXOXOOXOXOOXOOOOOOOOOOXOOXOXOOOOO
