OXXOXOOOOOOXOOOOOXOXOOOOXXXOOXOXOOOOXOOOOXOOXOXOOOXXOOXOXXOOXOOOOOOOXOXOXXXOXXOXOOOOOXXXOXOXOOOXOOOOO
OOOOOXOOOOXOOOOOXOXXOOXOXOOOOXOXOXOOOOOOOOOOOOOOOOOOOXOXOXOXOOOOOXOOOXOXOOOOOOXOOOXOOXOOOXOXOOOOOOXOX
XOOOOOXXOOXXOOOOOXOOOOXOXOOXOXXOXOOXOOOXOXOOXXOOOXOOOOOXOOOOOOXOOXOXOOOOOOOOOOOOOXXXOOOOOXXOXXOXOXOOX
OOOXOXOOXOXOOXOOXOOOOOOOOOOOXXOOXOOOOOOOXOOOOOOXXOOOOXXOOOOOOOXOXOOXOOXOOXOOOOOOOOXOOOXOXOOOOXOOOXOXX
OOXOOOOOOOOOOOOOOOOXOOOOOOOOXXOXOOXXXXOOXXOOXXOXOOOOOXOOOOOOOXOOOXOOOOOOOOXOXXOOOOOXXXXOOOXXXOOOOOXOO
OOOOOOOOOXOOOXOXOOOOOOOOOXOXOOXXOOXOXOOXOOOOXOOOOOOOOOOXOOOXOOXXOOXOXOOOOOOOOOOOOOXOOOOOOOOXOOOOOOXOX
XOOOOOOOOOXOOOOOOOXXXOOXXOOXXOOOXXOOOOOXOOOOOOOOXXOOOXOOOOOXOOOOOOOXOOXOXOOOOXOOXXOXOXOOXOXOOOOOXOXOO
XOXXOOOXOOOOXOOOXXOXXOOXOOOOOOOOOXOXXOOXOXOOOOOOOOOOOXOXOOOXXOOXOXOOXOOOOOOXXXOOOOOOOOXOOOOOOOOXOOXOO
OXOOOOOOXXOOXXXXOOOOXOXXOOOOOOOXXOXOOOOOXOOOOOOOOXOXOOOOOOXOXXOXOOOXOOXOOXOOOOOOOXOOOXOOOOOXOOOXXOXXX
OOOOOOXOOOXXXOOOXOOOOOOOOOOOOOXOOOXOOOXXOXOOOOOOXOOOOOXXOOXOOOOOOXOXXOOXOOOOOXXOOOXXOOOXOXOOOOOXXOOXX
OOOXOOOOOOOOOOOOOOOXXOXOOOOXOOXXOOXOXOXOOXOXOOOXOOXOXOOXXXOOXOOOOOXOOOOXOOOXOOOOOOOXOXOXOOOOXXOOOXOOO
OOOOOOXOOOOOOOXXOOOOOXOOOOOOXOXXOXXOXOXOOXOOOOOOOOOXOOOOXOOOXXOOXOOXOXXOOOXXOXOOOOOOOOXOOXOXOOOOXXXOO
OXOOOOOOOXOOOOOOOOXOOXOOOOOXXXOOXOXXOXXOOXOOOOXOOXOOOOOOOOOOOOXXOOOXXOXOOOXOOOOXOXOOOOOOOOXOXOOOOOOOO
OOOOOOOOXXXOOOOXOOOOOXOXXXOOOXXOOOXOOXXOXXOXOOOOXOOOOXXXOOOOOXOXXXOOOOOOOXOOOOOXOOOOOXXXOOOOOOOXOOOXO
OXOXOXOXOOOOOOOXOXXOOXXXOXXOOOOXOOOOOOOOOXXXXOOXOOXXOXOXOOXOOXOXOOOXOXXOXXOXXOOOXOOOOOXOOOXOOXOXXXOOO
XXOXOOOOOXOOXOOXOOOOOOXOOXOOXOXXOXOXOOOOOXOOXOOOOOOXOXXOXOOOOXXOOOXOOOXOXOXOXOXXXOOOOXOOOXXXOOOOOOOOO
OXXOOOXOOOOOXOOXOOOOOOXXOOOOOOOOOOOOOOOXOXXOOOOOOXOOOOOXXOXXOXOXOOXOOXOXOOOOOOOOOOOOOOOOXOOXOOOOOOOOO
XXOOOXOOOOXXOXOOOOOOOOXOOOOOOOOOXXXOXOXOOXOOXXOXOOXOOOOXOXOOOOOOXXOOOOOOXXXOXXXOXOXXOOOXXXOXOOOXXXOXO
XXXOOOOOXOXOOOOOOOOOOXXOOOOOOXOOOOOXXOXOOOOOXOOOOOXOOOOXXOXOOOOOOOOOXOOOOOOOOXXOOOOOOOOXOXOXXOXOXXOXX
XXOXOXOOOOOOXXXXOXOXOXOXXOOXOOOOOXXOOXXOOXXOXOOOXXOXXXOXOOOOOOOOOOOXOOOOOOOXOOXOXOOOOOOXOOOXOOOXXOOXO
OOOOXOOOOOOXOOOXOOOOOOXXOXOOOXOXOOXXOOXOOOOOXXOOOOXOXOOXOOOOOOXXXOXXOOXOOOOOOOOXOOXOOOXOOXOXOOOOOOXOO
XXOOOOOXOXOOOOOOOOXOOOOOOOOXXXOOOOOOXOOOOOOOXOOOOXXOOOOXOOOXOOXOOOXXOOOOXOOOXOXOOOXXXOOOOOOOXXXOOOOXO
XOOOOXOXOOOXOXXOOOOOOOXOXOXOOOOOOXOXOXOOOXOOOOOXOOXOOOOOOXOXOXOOOOOOOOXOOOOOOXOOOXXOOOOOXOOOOOOXXXOOO
OXOOOXXXOXXXOOOXOOOOOOOOOOOOOXXOOOXOXOXOOOOOOOOOOOOOOOOOXOOOXXOOOXOXOOOOOOOOOXOXOXXXOOOXXOXOOOXOOOOXO
OOXOXOOOXOOOOOXOOXXOOOOOXOXXOOOOOXXOOOOXXOXOXOOXXOOOOOXOOOOOOOOOOOOOOOOXOOOOOOOOOOXOXOOOOOOOOOOOOXXXO
OOXOOXXXOOOOOOOXOOOXXOOOOOOOOOOOOOXOOOOOOOXXXOXOOOXOXXOXOXOOOXXOOOOOOOOOXOOOXOOOXOOXXXOXOOOOOOXXOOOOO
OOOOOXOOOXXXOXXOOOOOOOOXXOOXOOOOOOOOOOOXOOOXXXXXXOOOOXXOXOOXOOOXOOOOXOOOOOOOXOOOOOOXXOOXOOXOOXOOOOXOX
OOOOOXXOXOOOOXXXXXXOOOOOXOOXOOOOOOOOOXXOOOOOOOOOXXXXXXOXOOOXXOXOOOOXOOOOOOOOOOOOOXXOOOXXOXOOXOOOOOOOO
OOOOOXOXOOXXXOXOOXOOXOXXOOOOXOOOXOXOOOOOOXXOOXOXOOOOXOOXXOXOOOXOXOOXXXOOOOXOOOOOXOXOOOXOOOOOOOOOOOXOO
OXOOXXOXOXOOXXOOXOXXOXOOXOOOOXOXOXOOOOOOXOOXXOXOXOOXOXOOOXOXXOXXOOOXOOXOXOOOOOOOOOOXXOOOOOOOXOXXOOXOO
OXXOXXOOXOXXOOOOOXOOOXOXOOXXOOOOOXOXXXXOXOOXXOOOOOOXXOOOOOOOOOOXOOOOOOOXXOOOOOXOOOOOOOOXOOXOOXOOXOOOO
OOOOOOOOXXOXXXOOOOOXOXOOXXOXOOOXOOXOOOOXOOOXOOOOXOOOXOXOXOOOOXXXXOOOOOXOOOOOOOXXOXXOOOOOOXOXOOXOOXOOO
XOOOOOOOXXOOXXOXOXOXOXXOOOOOXXOXXOOOOOOOOXXOOOXOOOOXXOOXOXXXXOOXOOOXXOOOOXXOOXOOOOXOXOOOOOOXOOOXOOXXO
OOOOOOXOOOOXOXOOOOXOXOOXOOXOXOXOXOOOOOXOXOOOOOXOOOXOOXOOOOOXOOXOOOOOOOOOXOOOOOOOXOOOOOXOOXXOXOOOOOOOO
OXXXXXOXOOXOOOOOOOXXOOXXOXOOOOOOXXXOOOXOOOOXXXOOXOOXXOOOOOOOOOOOOOXOOXOOXXXOOOOOOXOXOXOOXOXOOOXOOOOOO
OOOOOOOOOOOOOOXOXOOOOOXOOXOOOOXOXOOXOXOOOOOOXOXXOXOXOXXOOOOOOOOOOXXXOOOOOXXOOOOOOOOOXOOXOXOOOXOXOOOOX
XOOXOXXOOOXOOOOXOOOOOXOXOOOOXOOXOOOOXXOOOOOXOXOOOXXXOXOOOOOOOOOOOOOOOOXOOOOOOXXOOOOXOOXOOXXOOOOOOXXOO
OOXXOOOOOOXXOOOOXOXOOOOOXXXXXOOOOOOXXOOXOOOOXOOXOXOOXXOOOOXOXOOXOOXOXOXOXXXOOOOOOOXOXOOOXOOXOOXOXOOOO
XOXXOXOOOXOOOOOXOOXOOOOOOXOOXXXOXOXOOOOOXOXXOOOOXOOOOOXOOOXOOOXOOOOOXOXOOXOOOOOOOXXXOOXXOOOXOOXOOOXOO
XXOXOOXOOXOXXOOOOXOOOOXOOOOXOOOXOOOXOOOOOOOOOOOOOOOOOOOOOXXOOOOXXOOXOOXXOOOXOXOOXOOXOOOOOXXOXOOXOOOXO
OOXXOOOXOOOOOOOOXOOOOOXOOOXOOOXOOXXOOXOOOOXOOOOXOXOOOXOXOOOOXOOXXXOOOXXXOOOXOOOOXOXOOXOOOOOOOOXOOOOXO
OOOOOOOXXOXOXOXOOXXOOOOOOOXXXOOOOXXOOOOOOOOOOXOOXXXOOXOOOOXOOOXOOXOOOOOOXOOXOOXOXXXXOOOXXOOOOOOOOXOOO
XOOOXOOOOOXOXXOOOXOOOXXXOXOOOOOOXOOOOXOOXOXXXOOOOOOOOOOOXOOOOXXXXOOOXXXOOOOOOOOOOOOOOOXOXOOOXOXOOOOOO
XOOOOXOXOOOOOOOOXOOOOOOOOOXOXXOXOOOXXOOOOXXOOOXOOOXXOOOXOOOOOOOXOXOXOOOXOXXOOOXOOOOXXXXXOXOXOOOOOOOOO
OXOXOXOOXOXXOOXOOOOOOOOOOOXOOOXOOXOOOXOOXOOOXOXOXXOOOOXXXOOOXOXOOOOOOXXXOXOXOOOXXOXOOOXXOOOXOOOXXXOOO
XOOOOOXOOXXOOOXOOXOOOOXXOOXOXOOOOOOOOOXOOOXXOXXXOOOOXOOXOXXOXOXOOOXOOOOXXOOOOOOXOOXOOOXOOXOXXOOXOOOOO
XXOOOOXOXXXXOOOOOXOXXOOXOOOOOXOOOXXXOOXXXOOOXOXOOOOOOOOOOOOOOOOXXOOOOXOOOOOOOXXOOXXOOOOXOXOXOOOXXOXOX
OOXXOOOOOOOXOOOOOXOXOXOOOOXOOOOOOOOOXOOOOOXXOOOOXOXXOOOOOOOOOXXXOXXOOOOOXOOOOOOOOXOXOOXXXOOOXOOXOOXXO
XOXOOOXOOOOXXOOXXOOXOOXXOOOOOOOOOXOOOXXOOOOOXOOOOOOOXOOOOOOXXOOXOXOOOOOOOXOOXOOOXOXOXXOXXOOOOXXOXOOXO
OOOXOXOXXOXOOOOOXOXOOOOOOXXOOOXXXOOOOOOOOOXOOOXOOOOOOOXOOOXOOXOOXOOOXOOOOOXXXXXOOXOOOOOXXOOXOOXXOXXXX
OXOOOOOXXXOOOOOXOXOOOXOXOOOOOXOOOXOOOOOOOXOXXXOXOOXOOOOOXOOOOOOXXOXOOOOOXOXXXOOOOOOXXOOOOXXOOOXOXOXOX
OXOXOXXXXOOXXXOXOXOOOOOOXOOOOOOOXOOOXOXOOOOOXOOOOOOXOOXOOOOOOOXOOOXOOOOOOOOOXXXXOOOOOXOOOOOOOOXOOOOXO
OOOOXOOOOOOXXXXOOOOXOXOXOOOOOOXOOXOXOOOOOOOOOOOXOOOOOOXOXOOXXOOOOXOOOOOOXXXOXOOOOOOOOXOOOXOXOOOOXOOOX
OXOOOOOXXOOOXOOOOXXOOOOOXOXXOXOOXOOOXXOOOXOOXOOOOXOXXOOXOXXXOXXOXOXOOXXOOOOOOOXOOOOXOXOOOOOXOXXOOOOXO
OOOOOOOXOOOOOOOOOOOOOOOXOOOOOXXOOXOXXOOOXOXOOOOOOXOOOXOXXXXOXOOOOOOOXOOXXOOXXOXOOXXOXXXXOOXOOXOOOOOOX
OXOOXOOOOOXOOOOXXOOOOXOOXOOOOOOOXXOOOOOOXOOOOXOOOOXOOOOXXOOOOOXOOOOOOXOOOOXOOOOOOOXXOOXOOOXOOOXOOXOXX
OOOOXXOOOOOOOOOOXOOOXOOOOOOOXXXXOOXOOOOXXOOOOOOXXOXOOOOXOOOOXOOOOXOXXOOOOOOOOOXOOXOOXOXOOOOOOOXOXXOXO
OOOXOOOOOOOOOXOOOOOOOXOXOXOOXXOXOOOOOOOXOOOOOOOOXOXXOXXXXOOXOOOOXXXOOXOOOXOOOOOOOOOXOOXOOOOOOOXOOXOOO
OOOXXOOOOOXOOOOOXOOOOOOOOOOOOOOOOOOXXOOOOOOOOOOOXOXOXOOOOOOOOXXOXXXXOOXXOXOXOXXOOXXOOOOOOOOOOXOOOXOOO
OXOXOOXXXOOOXXXOXOOOXXOXXOOXOOOXOOOXOOOXOXOOOOOXOXOXXOOXOOOOOOOOOOOXXOOOOXOOOOOOOOXOXOXXOOXOOXOOOOOOO
OOOOOOXXOOOOXOXOOOXOOOOOOOOOOOOOOOXOOXOXXOOOOOOOXOOOOOOOOXOOOOOXOOOOXXXOXOOOXXOOOOOXXOXOOOOOOOOOOOXOX
OOXOOOOOOOXOOXOOOOXXXXOXOOOXOOOOXOOOXOOOOOXOXOOOOOXOXXOOOOOXOOOOXXOXOOOOOOOOOOOOOOXOXXOOOOOOOOOOXOOXO
XOOOXOXXOOOOOOOOOXOXOOXXXXXOOOOXOOOOOOOOOOOOOOXXOOXOOOXOOOOOXXOOXXOOOXOXOOOXXXXXOOOOXXOOOXOXOXXOOXXOO
OOOOXXOXXOOOOXOXOOOOXOOXOXOOOXXOXOOOOOOOOOXOOOOOOOOXXOOOOXOXXOOOOXXOXOOXXOOOOOOXOXXOOXOOOOOXOXOOOOOOO
OOOOXOXOOXXOOXXOOOXXOOOXOOOXOXOXOOXOOXXOOXOOOXOOOOOOOOOOOOOXOOOOOOXOXXOOOOOOOXOOOXXOXOOOOOOOOXOOXOXOX
XOOOOOOOOOOXXOXXOOOOOXOOOOOOOOXXOXOOXOOOXOOOOOOOOOOOXOOOOOOOOXXOOOXOXOOOOXOXXOOXXOXOOOOOOXOOOOOOOXXOX
OOOXOOOOOOXOOXOXOOOXOOXOOOOXXOOOXXOOOOOOXOOOOOOOOOOOXOOXXXOOOXOOXOOXOXOOOXOXOXOOOOXOXOOOOOXOXOOOOOOOO
OXXXOXOXOOOXOOOOOOXOOXOOOOOOXOXOOXXOOOOOXOOXXXXOOXXOOOXOXOXOOXXOOXOOOXOOOXXOOXOOXOXOOOOXOOOXOOOXOXOXX
XOOXOXOOXOOOOXXOOOXOOXOOOOOXOOXOOOOOXOOOXOOOXOOOOXOOOOOXOOOOXOXOOXXOOOOOXOXOOOOXOOXOOOXOOXOOXOOOXOOOO
OOXXOOOXOXOOXXXXXOOOOXOOOOOOOXOOOOOOOOOOXOOOXOOOOXOOXOOXXXOOXOOOOOOOOXXXOOOXOOXXOOOXXXOOXOOXXOXXOXOOO
XOXOXOOOXOOOOXOOXOXOOOOOOOXOOOXOOXXXOOXOOOOOOOOOOOOXXOOOOOOXOOOOOOOOOOOOOOOOOXOOOOOOXOOXOOOXOOOOOOOOO
OXXOOOOOOXOOOXOOXOOXOXOOOOOOOOOOXXOOOOOOXOOXOOXOXOOXOXXOOOOOOOOOXOOXOXOOOXOXOOOXOOOXOOXOOOOOOOOXOOOXO
OXOOOOOOOOOXXOOOOXOOXXOXOOOOXOOOXOXOOOOOXXOXOOOXOOOOXXOXOOXOOOOOOOOOOXOOXOOXOOOOOOXOOOXOOOOOOOOOOOOOO
OOOXOOXOXOOXXOXOXOOXXOOOOXOOOOOOOOXXOOOXOOOXXXOOXXOOXOXXOOOOXOOOOOXXXOOOXXOXOXOXXOOOOOXOXOOOOOOOOOOOO
OOOOXXOOOOOOXOOXOOXOOXOXOXXOXOOOOOXOOOOOOOXOOXXXOXOXOOOOOOOOOOOXXOOOOXOXOOXOOOXOXXOOOOOOXOOOXOOXXOXOO
XXXOXXXOOXXXXOOOOOXOOOOOXXOXOOOOXOOXOOXOOOOXXOOXXXXOOOOOOOOXOOOXOOOXXXXOXOXOOXOXOXXXOOOOXXOOOXOXOOOOO
OOXXOOOXXOXOOOOOOXOXXOXXOOOOXOOXXOOOOOOOOOOOOOXOOXOOXXOXXXXOOOXOXXOOOOXOXXOOOOOOXOXOOOOOXXOOOXOOXXOXX
XOOXOOOOXXOOOOOOOOOXOXOOOOXOOXXXOXOOXOXOOOOOXOOOOXOOOXXXOOOOOOOOOOOOOXOOOOOOXXOOOOOOOXOXXOOOOOXXOOXXX
XXOOOXOXOXOXXOOXOOOOXXXOOOOOXOOOOXXOOXOOOOOOOXXXOOOOOOOOXOOOXOOOXXXOOXOXXOOOXXOOOOXOOXOOOOXOOOOOXOOOX
OXOXOOXOOXOOOOXOXOXOXOXOOOXOOOOOOOOOXOOXOOOXOOOOOOOOOOOOOOOOOOOOOXOOOXOOOOOOOOOOXXOOOOOXOXOOXOXOXOOXX
XOXXXOXOOXXXOXOOOXOXOOXXOOOXOXOOXOXOOOOOOOOOOXOOOOXOOOOXOOXOOOOXXOOXXXOOXOOOXOOOOOOXOXOXOOXXOOOOXOOOO
OOOOOXOOOOOOXXXOXOOOOOOXOXXOOXOXXOXOXOXOOOXXXOXOOXOXOOOOOOOXOXXOOXOXXOOOOOXOOXOOOXOOOOXXOXOOOOOOXXOOO
OOXOOXOOXOOXOXOOXOXOOOOXOOOOOOXXXOXOOOOXXOOXOXXOOOOOOXOXOOOOOOOOOOXOOOOXXOOOOOOXXOXOXOOOOOOXOOOXOOOOO
XOOOOOOOOOXOOOOOOOOOOOXOOOXOXOOOXOXOOXXOOOXXXOOOOXOXOXOOXOOOOOOOOOOOOOOOOXOOOOOOOOOOOOOXXOXOOOOOXXOXO
OXOXOOXOOXOOOOXOXOOXOOXOOOXXOOOOOXOXXXXXOOOOOXOOOOXOXOOOOOOOOOXOOOXXOOOOOOXOOOOXXOOOOOXOXXXOXOOOOOXXO
OOXXOOOXXOXXOOOXOOXOOOOOOXOXOOOOXOOOOXOOXOXOOOXXOOOOOOXOXXOOOOOOXXXOOOOOOOOOOOOOOXXXXOOOOXXOOOOOOOXOX
OOXXOOOXOXOOOOOXOOOXOOXXOOXOOXXOXXOOXXOOXOOXOXOXXXXXOOOOOOOOOXOOXOOOOXOOOXXXXOXOOXOOOXOXOOOOXOOXOOOOO
XOXXXXOXOOOOXOXOXOXOOXXOOOXOXXXOOOOOOXOOOXOOXOXOOOXOXXOOOOOOOXOOOOXOXOOOOOOOOXOXXOXXXXOXOXOOOOOOOOXOO
OXOXOOOOOXOXOOXOOOOXOOXOOXXOOOXOOXOOOOOOOOOOXOXOOOXOXOOOOOOOXOXXOOOOOOXOOOOXXOOOOOXOOOOOOOXOOOXXXOOOO
OOOOXOXOXOXOXOOOXXOOXXOXOXOOOXXOOOOXOOOXOXXOOOOOXOXXXXXOOOXOXXXOOXXOXOOOOOXXOXXOOOOOOOOOOOOOXXOOOOXOO
OXOOOXXOOOOOOOOOXOOXOOOOOOOOXOXOOXOOOOOOXOOOOOXOXOOXOOXXXXOOOOXOOOOOOOOOOOOOOXOXOOOOXXXXOOOOOXOOOXXOO
XOOXOOOXOXOOXOXOXXOOOOOXOOOOXOOOOXOOOOOOOOOXOOOOOXOOOOOOXOXXXOOOOOOOOOOXOOXXOOOOOOXXOOOXOXOXOXOOOOOOX
XOOXOOXOOOOOOXXOOOOOOXOOOXOOOXXOXXXOOXOOOXOXOXXOOOOOXOXOOOXOOOOOXOOXOOOOXXOOOOOOXOOOOOXOOOXOOOOOOXOOO
OOOOOXXOXOOOOXOOXXOOOOXOOOOXOOOOXOOOOOXOOOXOXXXXOOXOXXOXXXOXOXXOXOXOOOOOOOXOOOOOOOOOOOXXOOOOOXOOXOOXX
OOOOOOOOXOOXOXOOOOOOOXXOOOXOOXOOXXOOOXOXOOOXOOOXOOOOOXOOOOOOOOOOOXOXOXOOOOOOOOXOOOOOOOOOXXOXOOXXOOOOX
OOOOOXXOOOXOXOOOXOOOOOOOOOXOOOXOOOOOOXOOXOOOXOOOXOOOOOOOOOOXXOOOXOXOXXXOOOOOXOOOOOOOOOOOOOOOOOOXOXOOX
OOOOXOOOOXOOOXXXOOOOXXXOXOXOOOOOXOOXOOOOOOOXOOOOOOOXXOXOXOOXOOOOXOOOOOOOOXOOOXXOXOOOOOOOXOXOOOOOXXOOO
OOXXXOOOOXOOXOOXOOXOXXOOXOOOOXOOOOXOOOXXOOXXOOOXOOOOOOOXOOOXOOXOOOOXOOXOXOXOOOOOOOOXOOOXOXOOOOOOXOOOO
OOXOXOXXXOOOXOOOXXOOXOOXOOOXOOOOOOOXXXOOOOOOOOOXXOOOXXXOXOOXOXOXOXXOOOOOOXOOOOOOOOOOXOOOOXOOOXOOXOOXO
OOOOOOXOXOXOXOOOXXOXOXOOOOOXOOOXXOXOOXXOOOOXXXXOOXOXOXOOOXOXOXOOOOOXOOOOXOOOOXXOOOXXOOOOOOOOOOXOOOOXX
OOOOOOOXOOOOOOOOOOOXXOOXOOXOOOXOOOOOXOOOOXOOOOOOOXOOOOOOXXOOOXXOOOXXXOOOXXOOOXXXOOOOXOXOOOOOOOOOXOXXO
