XOOOOOOOOOOOOOXOXXOOXXOOOXOXOXOOOXOOXOOXOOOOOOOOOOXXXXOOOOXXOXOOOXOOXXOOOOOOXOOOXXXOOOOOXOOOXXOOOXXXO
OOOOXXXOOOOXOXXXOOOOXOXXOOOXXOOOOXOOOOXOXXOOOOXOOXOXOOOOOOOOOXOOOOXOXXXOXOOXOOOOOOOOXOXXOOOOOOOXOOOOO
XOOXOOOXOXOXOXOOXOXXXOXOOOOOOXOOXXOXOXOOXOOXOXXOXOOOXOXOXOOXOOXOXOOOOOOOOXOXOXXXOXOXOOOOOXOOXXXOXOOXO
OXXOOXOXOOOOXOOOXXXXOOOXOOOOOOOXOOXXOOOXXOOOOOOXOXXOXOXOOOOXXOOOOOOOOXOOXXOOOOXXOOOXOXXOXOXXOOXOXOXXO
XXXOXXOOXOXOXOOOOOOOOOOXXOXOXXOOOOXXOOOXOOXXOOOOOOXOOOOOOXOXOXXOXOOOXOOOOOXOOOXOXOOXOXOXOOOXOOXOOOXXO
XOOXXXOOOOOOOOOOOOOOXXOOOOOOXOOOOOOOOOOOXOOOOOOOXOOXOXXXOOOOOOOXOOOOOOOOOXXOOOOOOOOXOOOOOOOOOOOOOOOOX
XOOOOOOOOXOOOOXOXOXOOOOXXOXOXXXOXOOOXOXXOOXOOOXOXOOOOOXOOOOOOOOOOOOOOOOXOOOOXXOXXOOOXOXOXXXXXOXOOOXOO
OOXXOXOOXOOOOOXOOOXOXXOOOXOOOOOXOOOOOOOOXOOOOXXXXOOOXOOOOOOOXXOXXOOOOOOOXXOOXOXOOXOOOOXOXOXOOOOOXOXOX
XOOOXXOXOXOOOXOOXOXOOXOXOOXOXXOOOOXOOOXXXOOOOOOOOOOOOOOOXOOOXOXOOOOOXOOXOXOOOOOXOOOOXOOXOOXXOOOXOXOXO
XXOOOOOOOXXOXOOOOOOXOOXXXOOOXOXOOOXOOXOOOOXOOOOOXOOOOOOOOOOOOOXOOOOOOOOOOXXXOXOOOOOOOOOXOOOXOOOOXXOXO
OOOOXXOXOXOOXOOOXOOOOOOOOOOOOOOXXXXOXOOOXOXOXOOOOOOOOOOOXOOOOXXOOXOOOXOOOXOXXXOOOXOOXOOOOXXXOOOOOXXXO
XOOXXOXXOXOOXOXOOOXXOOOOOOOOOOXXOOOXOOOOOOOOXOOOOXOOOXOOOOOOOOOXOOOOOOOOOXOOXOOOOOXXOOXOOXOXXOOOOXXOO
OOOXOOOOOOXOXOOOXOOOOXOOOOOOOOOOOXXOOOXOXOOXOXOOOXOXOOOXOOOXXOOXOOOXXOOOOXOOOOXXOOOOOXOOOOXOXOOOXOXOO
OOOXOOOOXOOOOOOOOOOXOOOOOOOOXOOOXOXOOOOOOXOOXXXOOOOOOOOOOOOOXOOOOOOOOOOOOXOOOOXOOXOOXOOXOOOXOOOOXOOOO
XXXOOXOOXOOXXXOXOOOOOOOOXOOOXOOXOOXXOOXOOOOOXOOOOOOOXOXOOOOOXXOXOOOOOOOOOOOXOXOOOXOOXOXOOXOXOOXOXOOOO
OXOXOOXOOXOOOXOXOXOOOXOOOXOOOOOOXOXOOXOOXOOXOXOXOOOOOOXOOOXXXXOOOOXOXOOOXOXOOOOOXOOOOOXXOOXOOXOXOXXOO
XOOXOOOXXOXOOOOOXOOOOOOOXOOXOOOOOOXXXOOXXXOOOOOXOXXXOXXOOXOXXOOXXXOXOXOOXOOOOOOOOOOOXOXOOOOOOOOXXOXOX
OOOOXOXOOXXXOOXOXOOXOXOOOOXXOOOOOXOOXXXOXOOOOOXXXOXOXOOXOOXOXOOOXOOOOXXOXOOOXOOOOOOXXXOXOXOXXOOOOOOOX
XOOOOOOXXOOXOXOXXOXOOXOXOOOXOOXXOOXXXOOOOXXXOXOXXOXOXXXOOOOOXXOOXOOOOOXOOOOXOOOXOOOOOOOOOOOOOOOOOOOOO
OOXOOOOOOOXOOXOOOOOOOOOOXOXOXOOXOXOOXOOOOXOXXOOXOOOXOXXOOOOOXOXOXOOOXXOXXOXXXOOXOOOOOOXOOOOOXOOXOXOXX
OXOXOOXOOOOOXXOXXXOOOOOXXOXOOXXOOXOOOXOOXOXOOOOOOOOOXXOXOOOOOXXOOXOXXOXXOOOOXOOOXOXOXOOOXXOXOOXXOOOXO
XXOOOXOOXXXOOOOXXOOXXOOXOOOOXOOOOOOOOOOOXOOOOOOOXXOOOXXOOOOOOOOOOOOXOOXXXOOXOOXOOOOOOOOOXXOOXOOOOOOXO
OOXOOOXOXOOOOOXOOOXOXOOOOOOOOOOOOOOOOOOOXOOOOOOOOOOXXOXOOOOOOOOOOOOOOOOOOOOOXXXXXOOOXOXOOOOXOXOOOOOXO
OOOOOXOOOOXOOOXOOOOOOOOOXOOXXOXOXOXOOOOXOOXOOXXXOOOOXOOOXXOOOOOOOOOXOOOOXOOOOXXXOOOOOOOXXOOOOXOOOXOOO
OXXOOOOOOOOOOXOXXOXOOOOOXOXXOOOOXXOOXOOOOXXOOOXXOOOOXOOOOOOXOOOOOXOXXOOOXOOXOOXXOOOOOXXOXOOOXOOXOOOOO
OOOXOOXXOXOOOOXXOXOOOOOOXOOXXOOXOOOOOXOOXOXOOOXXXOOOOOOOOXXOOOOXOXOOOOOXOOXOOOOXOOOOOOOOOXOOOOOOXXXOO
OOOXXOOXXOOXXOOOOOOOOOOOXOOOOOOOOOXOOOOOOXXOXXOOOOOOOOXXOXXOOOOOOOXXOOOXOOOOOXXXXOXOXXOXOOOOOOOOOXOOX
OXOOOOOOOXOXOOOOOOXOOXXOOXOXXOOXOOOOOXXOOOOXXXOOOXOXOOOXXOOOOOOXXOOXOOOXOOOOOOOOOXXOOOXXOOXOOXOXOOOXO
OXXOOOXOOXXOOOOOOOOXOXOOOOXOOOOXOXOXXOXOXOOOOXXXOOOOXOXXOOXOXOOXOOOOOOOOXXOXXXXOXOOOOXOOOOOXXOXOOOOXX
XOOOXOOXOOXOOXOXXXOOXOOOOXXXOOOOOXXOOOOXXXOOOOOOOXOXOOOOOXOXOXXOOOOOXOOOOXOOOOOOOOXOOOOOOXOXOXOXOOOXX
OOOXOOXOXXOXXOOOOOXOOOXOXOOXXXXXOOOOXOOOOXOOOOOOXXOOXOOOOOXOXOOOXOOOOOXOOOOOOXOOOXOOOXOOXXOOXOOXOOOXO
OOOXOXOOOOOOOOOOOOOOXOOXOOOXOXXOXOOXOOXOOOXXOOOOOOOXOOOOOOOOOXXOOXOOOOOOXOXOXOOOOOOOOXOXOOXOXOOOOOOXO
OXOOOOOXOOXOXOOXOOOXOOOOXXXOOXXXOOOOOXOOOXOOXOOXOOOOOOXXXXOOOOOXXOOOOXOXOOXOXXOXOOOOXOXXOOOXOOOOXOOOO
XOXOOOOXXOXOOOXOXOOOOOOOXOOOXOOOOOOXOXOXXOOOOXOOOOOOXXOOOOXXOXOOOXXOOXOOOOOXXOOOXOOOOOOOOOOXOXOOOXXOO
XOOOXXOOOOOOOOXOXOOXOXOXOXOXXOOOOOOOXOXXXXOXOOOOXXOOOOOXOOOXOOXOXOOOOOOXOOOXXOOOXXOOOXOOOXXXXOOOOXXOO
OOOOOOOOXXOOXXOXOOOXXOOOOOOOXOOOOOOOXXOOXOXOOOOOOXOOXOOOOOXOOXXOOXOOOOOOXXOOOOOXOOOOXOOOOXOOXXOOOOOOO
XOXXOXOXOOOOOOXXOXXXXOOOOXXXXXOOOOOOOOOOOOOXXOOOOXOXXXOOOOOOOOXXOOOOOOOOXOOOOXOOOOOOOXOOXOXXOOOOXXOOX
OOOXXOOOOOOOXOOOOOOXOOXOOXXOOOXOOOOXOOOXXOOOXOOXOXXOOOOOXOXOOOOOOXOXXOOOXOOXOXOOOOOOOOOXXXXOOOOOOOOOO
OOXXOOOXOOXOXOOOOOOOOXOXXXXXXOXOOXXXXOOXOOOXOXOOOOXOOOXXOXOXOXOOOOOOOOXXOOOOXOXXOXOOOXOOOOOOXOOXXOOOO
OOXOOOXXXOXXOOOOOOOOOXXXXOOXXOXXXOXOXOOOXOXXOXOXOOXOOXOOOOOOOOXOOXOOOOOOOOOOXOXXOOXOOOXOOOOXOOOXOOXOX
XOOOOOOOOOOXXOOOOXOXOOOOOOOOOXOOOOOXOXXOOOOOOOOOOXOOXOOOOXOOOOXXOOOOXOOXOOOOOXOOXOOXOOOOOOXXOOOOXOXOO
OOXOOOXOXOOXOXOOOOOOOXXOXOOXOOXXOXOXXOOOOOOXXOXOOOOXOXOOOOXXOXOOXOXXOXOXOOOXOXOXOOXOOOOOOOOXOOOXOOXXX
OOOOOOOOXOOOOOOOOOOXXOOXOOOOOOOOOOXXOOXOOXOOOOOOOOXXXOOOOOOOOXXOXOOOXXOOXOOXOOOXXXOXOOOXOOOOOOOOXOOXO
OXXXXOXOOOOOOOOOXOOOOXOOOOOXOXXOOOOOOOOOXXOOOXOOOOOOOOXOOOXOXOXXOOOOOOOOOOOXOXOOXOOOOOXOXXXOOOOXOOOXO
OOXOXOOOOOXOOXOOOOOOOXOOOOOOOOOOOOXOOXOOOOOXOOOOOOXOXOXXOXOXOOXOOOOOOOOXOXXOOOOOXXOOOOOOOOXOOOOOOXOOO
XOXOOOOOOXOOXOOXOOOOXOOOOXXOOOXXOXXOOXOOOOOOOOOXXOOOOOXOOOOOXXXXOXOOXXXOOOXOXXOOXOOXXOOOXOOOOOXOOOXOX
OOOXOOXOXOOXXOXOOOOOXOOOOXXOOOXOXOXOOXOOOXOOXXOXOOOOXOOOOXOOOOXOOOOOOXXOOOOOOOOOXOOOOXXXOOOXOOOOOOXOO
XOOOOOOOOOXXOOOOXXOOXOXOOOOXOXOOOOOOOOOXOXXOOOOOXOOOOOOOOOOOXXOOOOOXXXXOXXOXOOOOOOOOXOOOOXOXOOOOOOOXO
OOOXOXXOXOOOOOOXXOOOOOOOXXXOXOXXOXOXOOOXXOXOXOOXOOOOOXOOXXOXOXOXOXOOXOOOOOXOOXOOXXOOXOXOOOOXOOOXXOOOO
OOOOOXXOOXOOOOOOOXOXOOOOOOXOXOOOOOOXXOXOXXOOXOOOOXOOXOOOOOOXOOXXXOOXOOOOXOOOOXOOOOXOXOOOOOOOOOOXOOOXO
XXOOOXOXOXOOOXOOOOOOXOOXOOOOXOOOOXOOXOOOOOOXOOOOOOXOOOOOOXXOOOOOOOOOOXXXOOOOOXOOOOOXOOXXXOOOOOXOOOOOO
OOOXOOOOXOOXOXOOOOOOOXXOOOOOXXOOXOOOOXXOXXOOXOXXXOOXOXOXOXOOOOOOOOOOOXOOOOOOOOXOOOXOOXXXOXOXOOOXOOOOX
XOXXOOXXOOOXXOOOOXOOOOXOOXOXOOOOOXXXXXOOOOOOOOOOXOOXOOOOOXOOOOOXXOOOOOXOOOOOOOOXOOXOOXOOXOXOXXXXOOOOO
XOXXOOXOOXOOOXOOOOXXXOXOXOOOXXXOXXOOOOOOOOOOXXOOXXOOXOOOOOXOXOOXOOXOOXOXOOXXOXOOOOOXXOOOOOOOOXOOOOXXO
OXOOXOXXOOOOOOOXOXXOXXOOXXOXOOOOXOOOXOOXOOXOOOOOOXOXXOXXOOOXOXXOXXXOOOOXOXOOOOXOOOOOOOOOXXOOXOOXXXOOX
OXOXXXXOOOOOOOXOOXOOXOOOXOOOOXOOOXOOOXOXXOOOOOOOOOOOOXOOOOXOOOOXOOOXXOXOOOOOOOXOOXOOXXXOOOOXXOXOXOOOO
OOOXXXOOOXXXXOXOXXOXOXOOOXOXOOOOOXOOOXXOOXOOOOOOOXOOXOXOOOXOOOOOOXXOOOOOXOOOOOOXOOXOOOXOOOOXXOOOXOOOO
OOOOOOXOXOOOOOOOOOXOOOOOOXOOXXOOOXOOXOOOXXOXOXXOOOXOOXOOOOOXXOOXXOXXXXXXOOOOOOXOOOOOOXOXXOOOOOXOXXOXO
OXOOOOXOXOOXOXXXXXOOOXOXOXXOOOXOOXOXOXXXXXOOXOOOXOXOOXXXXOOOXXOOOXOOXOOXOXOOOOOOOXOOOOXOXXOOOOOXOOOOX
OXXXOXXOXXXXXOXXOOXOOOOOOOOOXOOOOXOXOXOXOXXXXXXOOOXOXOXOOXOOOOXXOXOXOXXOOOOOOXOOXXOOOOOOOOXOXOXOOOOOO
XOOXOXOXXOOXXOOOXOOOXOXOOXOOXOXOOXOOXOOOOOOOXOXOOXOOXOOXOOXOOOXXOXOXOOOOOOXOOOOOXXOOXOOOOOOXOOOOOOXXO
OOOOOOXOOOOOOOXOOOOOOOOOXXOOOOXXOOXOOOOXOXXOXOXXOOOOOOXOXXXOXOXOXXOOOOOOOOOOXXOOOOOOOXOOOOOXOOOXXOXOO
XOOXXOOXXOXOOOOOOOOOXXOOOXOOOOOXOOOXOOXXOOXOOOXOXXOOXXOOXXXOOOOOOOXOXOXXOXXXOOOOOOOXOXXXOOXOXOOXOOXXX
XOXOOOXXXOOOOOOOOXOOXOOOXOXXOXOOOOOXOOOOOOOXOOOXOOOXOOXOXXOOOXXOXOOOOOOOXOOOXXOOOOOOXOOOOOXOXXOOOOXOX
OOOOOOOXOXOOOOOOOXOOOXXXXOOOOOXOXXOXOOOOOOOXOXOXOOOOXOXOXOOOOOOXXXOOXXOOOOOOOOOOOXOOOOOOOXOXXOOOXOXXO
XOXOOXXOOOXOOOOOOXOOOOOOXOOOOXXOOOXOOOXOXOOXOXOOXOOOOXOXOXOXOOOOOOOOOOXXOOXXOOXOOXXOOXOOXXXOXOOXOOOOO
OOOOXXXXOOOOXOXOOOOOOOXOOOOOOXOOOOOOOOOOXOOOOOOOOXXXOOOXOXOXOXOXOOXOXOOOOOOOXXOXOXOOXOOOOOOXOOOOOOXOO
OXOOOOOXOOXOOOXXXXOXOOOOXOXOOOXOOXOXOXOXOOOXXOXXOOXXOOOXOXOOOOOOOOXOOXXXOXOOXXXOOXOOOOOOOOOOXXXOOOXOO
OXOOXOXOXOXXXXOOOXOXXOXXOOOOOXOXXOOOOOXXOOOOOOOOXOOXOOOOOOXOOOXOXXOOOOOXOOXXOOXOOXOOOOXOOXOOOOOOOOOOO
XOOXOXOOOOOOOOOOOXOXOOXOOOOOOXOOOOOXOOOOXOOOOOOOOOOXOOOOXOXOXXOOOOOOOOOOOOOOOOOOOOXOOOXOOOOOOXOOOXOOO
OOXOXOOXXOOOOOOOOOOOOOOOOOOXOXOOOXOOOOOOOOOOOXOOXXOOOOOOOOOOXXOOOOXOOXXXOXOOOOOOOXOOXOOOXOXXOXXOXOOXO
XOXXOXOXXXXXOOOOOOXOOOXOOOOOOXXXXOOXXOXOOOOOOOOOOXOXOOOOOOXOOOOXOXOOOOXOOXOOOOOOXXOOOXOOOXOOOOOOOOOOO
OOOOOXOXOXXOXOXOXOOXXOOOOOXXOXXXOOOOOOOXOXOOOOOOOOOOOOOOOOOOXOOOXOOXOOXXOXOXOOOXXXXOOOOOOOXOOOOXOOOOX
XOOOOOOOOXXOOOXOOXOOOOOOOOXXXOOXOOOXOOOXOXXOOOOOOOOOOOXXOOOXOXXOOOOOOOXXOOOXOXOOOOOOXXOOXXOXOOOOOXOOO
XOOXOOOOOOOOOXXOOOXOXXOOOXOOXOXOOOXXOXOOXOXXOXOXXXOOOXXOOOOXOOOOXOOOOOOOOXXOXXOOOOOXXOOXXOXOOOXOOOXOO
XOXXXOXOOXOOXXOOOXOXXOXOXXXXOOXOOOOOOOOXXXXXOXOOXOOXXOOOOOOOXOXXOOXXXOOXXOOXOOOOOOOXOOXXXOOOOOXOOXOXO
OOOXXXOXXOOOXOXOOOOOOXOOOXOXOXOOXOOOOOOXOOOXOXOOOOXOOOXOOOXOXOOOXOOOOOOOXXOXOOOXXXOOOOXXOOXXOOOXOOXOO
OXXXOOXOOOOOOOOOOOOOOOOXOXXOXXOOOOOXOOXXXXOOXOOOOOOOXOOOXOXOOOOXXOXOOOXOOOXOOOOOOOOOOOOOOOOOOXOOXOXOO
XXXOXOOXOXXOXOXOOOOXOOOXOOOXXXOXOOOOOXOOXOOXXXOXXXOOXOXOOOOOOOXOXOOOXOOOOOOXXOOOOOOOOXOXOOOOOOOOXOOOX
OOOOOXXXOXOXXOOOXXXXOOOXOXXOOOOOOOXOXOOOOOXXXXXOOOOOOOOXXOOOOOOOOOXXOOOOOOOOOOXOOOXOOXOOXOOOOOOOOOOOX
OOOOOOOXOXOXXOXOOXOOOOOOXOOXXOOXOOXXXXOOOOOOXOOXXOXOOXXOOOOOOOOOOXOOOOOXXXOOOOXOOOOOXXXXOOXOOOXOOOOXX
OOXOXOOOOXOOXXOOOXOXOXOOOXOXOOOOXOOXOOOXXOOOOXXOXOOOOXOOOOOXOOXOOXXOXOXXXOOOOXOOXOOOOXOXOXOOOOOOOXOOO
XXOOXOOOOOOXOOOXXOOXOOXOXOXOOOOOXXOOXOXXOOOOOXOXXOOOXOOOOXOOOOXOOOXOOOOOXOOOOOOXXOOXOOXOXOOOOXXOOXOXX
OOOOOOOXOXOOOOXOOXOXOOXOOOOXXOOXOXOOXOOOXOOOOOOOOOOXXOXXXXOOOXOOOXXXXOXXOOXOOOOXOOOOOXXOOXXOOOOOOXOOO
OXOXOXOOXXOOOOXOOOOXOXOOOOXOOOOOOXOXOOOOOOOOXOOOOXOXOOXXOOXOXOOOXOOOOOOOXOOOXXOXOOOOXOXOXOOXOXXXOOOOO
XXOOOOOOOOOOOOXOOOOOOOOXOOOOOOOOOXOXXOOOXXOXOOOOOOOXOOOOOOOOOXOOXOOOOOOXOOXOOOXOXOOOXOOOOOOOOOOOOOOXO
OOOXOOOOXOXOOOXXOOOXOOOOOOOOOOOOOXOOOOOOXXOOOOXOOOXOOOXOOXOOOOOOOXOOOOOOOXOXOXXOOOOOOOXOXXOXXOXOXOXOX
OXOXOOXOOOOXXOOOXXXOOXOOOOOOOOOOXOOOOOOXOXXXOOOXXOOOOOOOOOOOXOXOXOOOXOXXXOOOOOXOXOOOOOXOOOXOOXOXXXXOO
OOOOOXOOOOOOOOOOOOOXXOXOOOOOXXOOOXOOOOOOOXOOXOOOOOOOXOXXOOXOOXOXXOOXXOXOOOOOOOXOXOOOXXOOXOXOOOOOOXXOO
OOOOOOOXOOXOXOOXOOOOOOXXOOOOOOXOOXXOOXOXXXOXOOOOOOXOOXOXOOOOOOOOOXOOXOXOOXXOOOOOOOOOOOOOOOOOOXXOXOXOO
OOOOOOOOXOXOOOOOXOXOXOOOOXOOOOOOOOOXOOOOOXOOOOXOOOXOOOOOOOOOOOXOXXXOXOOOOOOOXOOOXOOOOXXOOOOOOXOXOXOOO
OOOOOOOOXOXXOOOOOOOOOOOOOOXXOOOXXOOOXOOOXOOOOOXXOOOXOOOOOOOOOOXXOXOOOOOXOOOOOOOOXOOOOOOOOOOOOOOOOOOOO
XXOOXOXOOXOOOOOOOXOXOOOOOXOXXXOXXOXOOOOXXXXXXOOOOOOOOXOOOOOOOOOXOOXOOOOOOOOOXOOOXOXOOOXOXOOOXXXOOOXXO
XOXOXOXOOXOOOOOOXOXOXOOOXXOOOXXOOOOXOOXOOOXXXOOOOXXOOXOXOOOXOXOXOOOOOOXXOXOXXOXXOXOOXOOXOXXOOOOOOXOOO
OOOOOOOXXOXXOOOXXOXOOOXOXOXOOOXOOOOXOOXOOXXOOOXOOXOOOOOOOOOXOOXXXOOOOOOOOXXOXOOXOXOOXOXXOOOOOOOOOXOOO
XOOXXOOXXOOOOOXOXOOXXOXOOOOXXXOXOOOXOOOOOOXOXOOXOXXOOOOOXOXOXOOXOXXOXOOOOOXXOOOOOOXOOOOXOOXOXOXXOOOXO
XXOXOOOOXOOOOOOOOOXOXXOOOXOOOOOOOXOOOOOXOXOXOOOOXXOOXOOXOXOOXXOOOXOOOXXOOXXOOOXOXXXXXXOXOOOOOXOOOOOXO
XOOOOXOOOOOOOXOOXOOOXOOOXOOOOXOOXOXOOXXOOOOOOOOOOXXOXXOXOOOXOOOOOOXXOXOOXOOOOOOOOOOXOOOOXOXXOOOXXOXXO
XXOOXOOXOOXXOOOOXOXOXXOXXOOOOOOOOOXXOOOXOXOXOOOOOXOOOOOXOOXXOOXXXOOOOOOOOOOXOOOOOOOOOXXOOOOOXOOOOOOOO
OOOXXOOOXOOXOXOOXXOOOOOOOXXOOXOOOOOXXXXXOOOOOOOOOOOOOOXOOOOOOOOOOOOOXXXOOOOOOXOOOOOXOOXOXOOOOXOXOXOOO
OOXOXOOOOOOOXXOXOOOOOOOXOOOOOOXOOOXOXXOXOOXOXXXOOXXOXXOXXXOOOOXOXOOXXXOXXOXOOOOOXOOOOOOOOXOOXOXOOXOOO
