OXOOXOOOOOOXOOOXOOXOXXXOOOOOXOOOOOOOOXOXOOXXXXOXOOXOOOOOOOOXXOOOOXXOOOOOOOXOXOOOOOOOOOOXOXOOOOOOOOOXX
OOOXOOOXOXXOOXOOOXXOOXOOOOOOXOOOXOXOXXOOOXOOOOXOXOOXOXOXOXXXXOOOOOOOXXOOOOOOXOOXOOOXOXOXOXOOOXOOOOOXO
OOOXOXOXOOOOOOXOOOOXOOOXOXOOOOOOXOOOOOOXOOXOOXOOXXOXOOOOOOOOXXOOOOOXXXOXOXXXOXXOOXXXOXOOOXOXOOOXOOOXO
OOOOXXOOOXOOOXOOOOOXXXOOOXOOOOXXOOXXOOOOOOXXOXOXXXOXOOOXOOOXXXOXOOOXXXOOXXOOXXOXOOOOXXXOOXOXOOOOXOXOO
OXOXOOOOXOXOOOXOOOXOOXOOOXOOXOOOOOOOOXOOOOXOXXOOOOOXXOOOXOOOOOOXOOOXOOOOXXXOXOOOOOOOXOOOXOOOXXXXOOOOO
XXOXOXOXOXXOXXOXXOOOOXXOOOOOOOXOXOOXXXOOOXXXXOOOXOOOOXOOXOXOXXXOXOOOOXOOXXOXXOOOXOOXOOOXOOOOXOXXOOXXO
OXXOXOOXOOOOOOXOXOOOOOOOOOXOOOOOOXOXOOOXOXXXXXOXOXXXOOXOOOOOOOOOOOOOXOXOXOOOOOXOXOOOOOXOOOOOOOOXOOOOO
OOOOOOOXOOOOXOOOOXXXOOXOXOXOOOOOOXOOXOOXOOOOOOXOOXXXXXXXOOOOOXOOXOOOOOOOXOOXOOOXXOXOOXOXOXOOOXOOOXOOX
OOOOXOXOOOOOXOOOOOOOOXXOOXOOXOOXOOOOXXOXOOXOXOOOXXOOOXOOXOOXOOOXXOOOXOOOOOOXOXOOOXXOXOOXXOXOOXOXOOOXO
OOOXOOXXOXOXOXOOOXOOOOOOXOOOOOOOXOOOOXXOXXOXOOOOOOOXXOOOOOOXXXOXOOOOOOOOXXOXXOOOXOOOXOOOOOOOOOXOOOOOO
OXOOOXOXOOXOOXXOOXXOOOOXXOOOXXXOXOOXXXXOXOXXXXOXOOOOOOOXOOXOXOOOOXOOOOXXOOOXOOOOXOOOXOXOOOOOOOOOOXOOO
OXOXOOXOOOOOOXOOOOXXOOOOOOXOXOOOOOOXXXOXOOOOOOOOOOOOOOOOOXOOOOOXXOOXOOXXOXOXOOXXOOOOOOOXXXXXOOOOOXOOO
OXXOXOOOOXOXOXOXOOXOXOOOOOXOOXXXXXXOXOOOOOXOOOXOOXXOOOXOOOOXOOOXXOOOOXOXOOXOOXOOXOOXXOXOXXOXOOOOOXOOO
OOXXOOOOOOOOXOOOOXXXOXOOOOOOXOXOXOXOOXOOXOOXOXOXOOOOOOOXOOOOXOXOOOOOXXXOXOOOOOOXXOXOOOXOOOXXOOOOXXOOO
OOOXOOXXOOOOXXOOOXOOOOOXOOOXXOOOOOXXOOXOOOXOOOXOXOXOOXXOOOOOOXOOOXXOOXOOXXOOOOXOXOOOXOXXOOXOXOXXOOOOO
OXOOOXOOOXOOOOOXOXXXOOOXXOOOOOOOXXOXOOXOOOXOOOOXOXOXXOXOOOOOOOOOOOXOOOOOXOOOOOOOXOOXOXOXXXXOXOOOOOXOX
OOOOXOXXOXXOOOOOOOOXOOOOOOOOXXOOXOOOXOOOXXOOOOOOOOOOOOOOOOOOXOXOXOXXXXXOXOOOOOOOXXXOXXXOOOOXOXOXXOXXO
OOOXOOOOOXOOOXOOXOOOXXXOOOOOOOOOOOOXOOXXOOOOOXOXOOOXXOXOOOOOOXOXOOXOOOXOOOOOOXOOXOOXOXXOOOOXOOOOXOXOO
OXXOOOOOOOXOXOOOOXOOXOOOXOOXOOXOOOOOXOOOXXOOXXOOOOOOXXOXOOOOOOOOOOOXOOXOOOOOXOOOOXXOOOOXOOOOOOOXOOOOO
OOOOOXOOOXOXOOOXOOOOOOOOXOOOOXXXOOOXOOOXOOXOOOXOOXOOOOXOOOOOOXXOXOXXOXOOXXOXOOOXOOOOOXOOOXOOOOXOXOXOX
OXOOXOXXOOXOOXOXOOXXXOXOOOXOOOOOXXOXOOXOOOOOOXXOOXOXOOOOXOOOOOOOXOOOOXXOOOOXOOOOOXXXOOOXXXOXOXOXOOOOO
OXXOXOOOOOOOOOOOXXXXXXXXXOXOXOOXOOOXOXOOOOOXOOOXOOOOOOOOOXOXOOOOOXXXXOOXOOXOOXOOOXOOXOOOXXXOXXOXOXOOO
OOOOOOXXOOOXXOOOOOOXOOOOXXOXOXOOOXOXOOOXXXOOOOXOOOOOXOOOXOOXOOOOOOOOXOOOOOXOXOOOXXOXOOOOOOOOXOXOOOXXO
OXOOXOOOOOOOXXXOOOOOOOXOOXXOOOOOXOOXXXOOXOOOOOOOOOOOOOXXOOOOOOOOOXOOOXOXOOOOXOOXOOOOXOOOXOOOOOXXOOXOX
OOXXOOOXOOXOXOXOOOXOXOOOOOOOOXOOOOXOOXOOOOOOXXOXXOXOOXOXOOOXOXXOXOOXOXOXOXXXOOXOOOOOOOOXOOOOOOXXXOOOO
XOOOXXXXOOOOOOXOXXOOOOXOOOOXOOOOOOXOXOOOXOOOXOXOXXOOXOXOOXXOXOXOXOOOOOOOOXOXOOOOOXOOOXXXXXXOOXXOOOOXO
XXOXOOOOOXOXOXOOXOXXXXOOOOOOOOXOXOXXOOOXOOOOOXXXOXOOOOOOXXOXXOOOOOOXXXXOXXOXOOOOOOOOOXXOXOOOOXXOOOOOO
OOOOOOOOOOOOOXOOXXOOXXOOXXXOXOOOOXXOOXOOXXOOXXOXXOXXOOOOOXXOOOXOXXOXOXOOOOOOOXXOXOOOOOOOOXOXXXOOOOOOO
OOXOOOOOOOOOOOOOXOOOXOXXOOOOOOOOOXXXOOOOOOOOOOXOXOXOOOOXOXOOXOOXOOXOXOOOOOOOOOXXOXOOXXXOOOOXOXOOOOOOO
XXXOOOXOOOXOOOOXOOXOOOOOOOOOXOXOOOOOXOOXXOOOOOOOOXXOOOOOXOOOOXOXOOOOXOOOXOOOXOXOOXOOOOOXXXOOXXOOOXOOO
OOOOXOOXOOOOOXXOXOOXOOOOOOOOXOOOOXXOOOOXOOOXOOOXXOOOOOOOXOOXXXXOXXXXXOOOXOOOXXXOOOOOXXOOXXXXXOOOXOOXO
OOXOXOXOOOOXOXOXOOXXXOOOOXOXXXOXOOOXXOXOOOOOOXOOOXOOXOOOOOXXOOOXOXOXOXOOOXOOOOOXOXOOXOOOXOOXOOOXXOXOX
OOOXOOOXOOOOOXXOOOOOOXOXXOOOOXOXXOOOXXOOOOXXOOXOOOXOOOOXOOOOXOOOOOOXOOOOOOXOXXXXOOOXOOOXOOXOXXOOXOOXO
OXOXOXOOOOOOOXOXOOOXOXOOOOOOOOXOXOXXXOOXOOOOOOOOOOXOXOXOOXOXOXXOOOOXOXOOOXOOOXOOOOXXOOOXOOOOOOXXOXOOO
OOOOXOOOXOOXXOXXXXOOOXOOOOOXXXOOXOOOOOOXOOOOOOOOXOXOXXOOXXOOOOOOOOOXOOOOOOOOOXOXXOXOOXOXXOOOXOOOOOOOO
OOOXXOXXXOXOOOOOOOOOOOOXOXOOOOOOXXOOOOXOOOOOOOOXOXOXOOXOOOOOOOXXOOXXXOOXXOOOXOOOXOXOXOOOXOOOXOOOOOOXX
XXOOXOOXXXXXXXOXOOXOOOOOOOXXOOOOOOOOXOOOOOOXOOXXOOOOOOOXXOOOXOOOXXXOOOOOOOOOXOXXOOOOOOXXXOOXOOOXOOOOO
OOXOOXOOXXOOOOOOXOOOXOOOXXOXOXXOOOXXOOOOOOOOOOOOOOXOOOOOOOOXOXOOXOXXXXOOOOXOOOOOOOXOOOOOOOOOOOOOXOOOO
OOOOXOOOXOOXOOOXOOOOOOOOXOOOOOXOOXOOXXOOXXOXXOXOOOOOXXOOOOOOOOOOXXOXOXXOOOOOOXXXOOOOOOOXXXXOOXXOXOOXO
OOXXXXOOXOOOOOOXOOOXOXOOOOOXOOOOOXXOOXXOOOOXXXOXOXXOOXOOOXOOXOOOOOOXOOOOOOOOOOOOOOOOOOOOXOOOXOOOOXOOX
OOOOOXOOOOOOOOXOXOOOXXOOOOOOOOOOXXXOOOXOOOOOOOOXXOOOOOXXOXOXOXOOOOOXOXOOOXXOXOOOXXOOOOOOOOOOXOOOXOOOO
XOOXOOOXXXOXOOOXXOOXOOXOOOOOOXOOXOOOOOOXOOXXXOOOOOOOOOOOXXXOOXXOOXXXOOOXOOOOOOXXOOOOOOXOOXOOOOOOXXOOO
OXXXOOXOOOOOOOOOOXOOXOOXOXOOXOXXOOOXOOOOOOOXXOOOOOOOOOXXOOOXXXXOOOXXOOOOOXOOOOXXXOXXXOOXOOOOOXOOOOOXX
OOOOXOOXXOOOOXOOOXOXOOOXOOOXOXOOOOOXOOXXOOXOOXOOOXOOOOOOOXOXOOXXXXOXOOXOOOXXOOOXOOOOXOOOXOOXOXOXXOOOO
XOXOXXXOXOOXOXOXOOXXOOXXOOOOOOOXOOXXOOOOOXOXOXOOXOOXOOOOXOOOOXOOOOOOOOOOOOXOOOXOOOXOOOXOXOOOOOXOOOOOO
XOOOOXOOOXOOXOOOOXOOXOOOXXOOXOXOOOOOOXOXOOXXOOOOOOOOOOOOOOOOOXOXOXOOOOOOOOOXXXOOOOXOOXOOXOXOOXOOOXXXX
OOOOXOOOOXOOXOOOOOOXOOOOOOOXXOXXOOOOXOOOOXOXOXOXOOOXOOXOOOOOOOOOOXOXXOXOXXXOOOXOOOOOOOOXOXOXXOOOOOOOX
OXOXXOOOOOOOXXOXOXXXOOOOOXOXXOXOXOOOOOXXOOXOOOOOOOOOOXXXXOOOXXOXOOOOOOOXOOOXOOOOOXXOXOOOOOOXOOOOOXOXX
OOOOOOOXOOXXXXOOOOOXOOOXXOXOOXOOOOXOOOOOOOOXOOOXOOXOXOOOOOXOOOXOXXXXOOOXOOXOXOOXOOOOOXXOOOOXOOXXOOOOO
OXOOXXXOOOOXXXXOOOOOOOOXOOXOOOXOXOOXOOOXOOOXOOXXXOOXOOOXOOXXOOOXOOOOOOOOOOXOXOOOXOXOXOOXXOOOOXXXOXOXX
OOXXOOXXOOOOOXOOXOXXXXXXXXOXOOOXOOOXOXXXOOOOXXOOOXOOXOXXOOOXOXXXOOOOOOOOOOOXOOOOOOXOOOOOOOXXXXXOOOOXO
OOOXOOXXOOOOOXOOOOOOOOOOXOOOOOOOOOXOOXOOXXOOOOOOXOOOXOOXOXXXXOOOOOXXOOOOOOXOOXOXXOOOOOOOOOOOOXOOOXXOX
OXOOOOOOXXOOOOXOXXOOXXOXXOXOOXXOOOOOOOXXXXXOOXOOXOXOXXOOOOOXOOOXOOOOXOOOOOXXOOOOOXOOOXOOOOOOOOXOOXXOO
OOOOXOOXOXOXOXXXOOXOOOOOOOOXOXOOOOXXOOXOOOOOOOOXOOOOOOOOOOXOOXOOOXOOXOOOOOOOXOOOOOOOOOOOXXOOOOOXXOOOX
OOXOOOOOXOOOXOOOOOXOXOOOOOOOOOOOOOOOOOOOOOOOOOOXOOOOXXXOOOXOOOXOOXXOOOOOOOOOOXOXOXOOXOXXOXOOOOOOOOOXX
XXOOOOOOOOOOOXOOOOXOOOOOXOOOXXOOOOXOXOOXOXOXOOOXXOXOOXOOOOOOOXXOOOOOOOXXOOXXOOXOOOOOXOOXOXOOOOOOOOOXX
OXOOXOXOOOXOXOXOXOOOOOXOOOXOOXOOXOXOOOOXXOOXOXOXOOOOOOOXOOOOXXOOOOOOOXOOOOOXXXXOOOXOXOOOOOOXOOOOOOOXX
OXOXXOOOOOOOXXOXOOOXOOOXXOXOOOXOOOXXOOXXOXOOOXOOOOOOOXOOXOXXOXOOXOXXXOXXOOOOOXOXOOOOOOXOOOXOOOXOXOOOX
OXXOOOXOXOOXOOOOXOOXOXOXOOXXXOXOXOOXOXOOOXXXOXOXOOXXOXOOOOOOXXXXOOXOOOOOOOOOXXXOXOXXOXOXOOXOOOOOXOOOO
OOXXXOXOXOOOOXOOXOXXOOOOOOXOOOOXOXOOOOOOXXOOXOOXOOOOXOOXXOXOOOXOOOOOOOOXOOOOXOOXOOOOOOOOOOXOXXOOOOOXX
OOOOXXOOOOOXOXXOOOOXOOOOOOOOOOOOXXOOOXOOOOOOOOXOOXOOOXOOOXOOXXOOXOXOXOXOOOOXOOOXXOOXOOXXOXXXOOOOOOOOX
XOXXOXOOXOOXOOOOXOXOXOOOXXXOXOXOOXOXOXOOOOOXXOOOOOOOOOOOOOOXOOOOXOXOXOOXOOXOOXOOOOOOOOOOXXOXOOOOOOOXX
OOXOOOOXOXOOXOOOOXOXOOXXOOXOXXOOOXXOXOXOXOOOOXOOOOXXXXOXOOXOOXOOXXOOOOOOOXXXXOOOOOOXXOXXOOOOOOXOOXOOO
OOXOOOOOOOOOOOOXOOOOXOOOOOOXOOOXOOXOOOOOOOOOXOOOOOOOXOOOOXOOOOOXXXOOOOOXXOOOOOXXOOXXOOOOOXOOOOXXOOOOO
OOOXOXOOOXOOOOXOOOXXOOOXOXOXOOOXOOOXOXXOOOOOOOOXXOXOOOOOOOOXOOXOOOOXOOOOXOOOOOOOOOOOXOOOOXXOOOOOOOOXX
OOOOOOOXOOXOXOOXOOOOOOXOOOOOOXXXXOOOOOOOOOOOXXOXOOXOOOOOOOXXXXXOXOOOXOXXXOOXOOOOOOOXOOOXOOOXOOXOOOOXO
OXOXXOXOOOOOOOXOOOOOXXXOOXOOOOXXOOOOXOOOOXOOXOXOXOOOOOOOOOXOOXXXOOOOOOXOXXOXOOOOOXOOOXOOOOOOOXOOXOXOO
OOOXOOOXXOXOOXOXOOOOOOOOXOXXXXOOOOOOOOXOOOXXOXXOXXOXOOOOOOOOOXXOOXOOXXOOOOOXXOOXXOXOOOOXOXOXXXXOOOXOO
OXOOXOXXOOXOOOOXOOOOOXOOOOOXOOXXOOOOXOXOOOOXOOXOOXOOOXOOXXOXOOXOXOXXXOXOOOOOOOOOOOOOOOXXXXOOOXXOOXOXX
OXOOXOOXOOOOOOOOXXXOOOXOOOOOXXOOXOOOXOOOOOOOOOOOXOXOXXOOXXXOOXXOOOOOOXOOXXOXOXOOXXOOOOOOXXOOOOOOOOOXO
OXOXXXOOOOOOOOXOOOXOOOOOOOXOXXOOXXOXOXOXXOOOXOOXXOOOOOOXOXXOOOOOOXOXOOOOXXOOXOXOOOOOXOOOOOOOOOXOOOOOO
OOXOXOOXOOXOXOOXOOOOOOOOOOOXOOOOXXXXOOXXOOOXXXOXOOOOXOOOXXOOOOXXOXOOOOXXOXOOOXOOOOXXXOOOOOOXOOOXXXOOO
OXOXOOOOOOOXXXOXOOOXOXXOXXXXXOOXXXXOOOOOOOOXXXOOOOOXOOOOOOOOOOOOXOOOOOXOOOOXOXOOXOOOOOXOOXOOOOXOOOOOO
OXOOOXOOOOXXOOOOXXXOOOOOXXOOOOOOOOOXOXOOOOOOOOOOOOOOOXOOOOOOOOOXXOXXXOXOOOOXXXOOOXOOOOXOOXOOOOXXXOOOO
OOOOXOOOOOOOOXXOXXXXXOOOOOOXOXOXOOXXXXOXOOOOOOOOOOOOXOOOOOXOXOXOXOOOOXOOOXXOOXOOXOOOOOOOOXOXOXOXXOOXO
XOXXXXOOOOOXOXOOOOXXOOOOOXOXXXOXOXXXXXOOOOOXXOOXOOOOOOOOXOOXXXOOOOOOOOOXOXOXOXXXOOOOOOOXOXOOOOOXXOXOX
OOXOOOOOOXXOOOOOOXOXOOXOOOOXXXOXXOOOOOOOOOXOOXXOOOOOXOOOOOOXOOOOOXOOOOOXXOOOXOOOXOOXXXOOOOOOXOOOOOXXX
OOOOOXXOOXXOOOOOOOXOOOXXOOOOOOOOXXOOXXOXOOOOOOOOXXOOOXOOXOXOOOOOOXXXXXOOOOOXOOXOXOOOXOOXOOXOOXOOOXOXO
OOXOOOXOXOOOOXOXOOXOXOOOOOOXXXXXOXOOOXOOOXOXOOOOOOOXOOOOOXOOOOOOXOOOOOOOOOOOOXOOOOOOOXXXOOXOOOOXOOXXO
OOOXOOXOOOOXXXOOOOXOOOXOOOXOXXOOXOOOOOOOOXOXOOOOOOOOOOOOOOOOOOOXOOXOOXOOXXOOOXXXOOOOXOOOOOOXOXXXOOOXO
OOXOXXOOXXXOXOOXOXOXOOOXOOOOOOOOXOOOOOOOXXOOOOXOOOOOXOOXXOOOOOOXOOOOOOOOOXOOOOOOOOOOOXOXXXOXOOOXOOXOO
XXOOOOOOOOOOOXOOXOOXOOOOOXXOXXOOOXOXOOOOXOOOOXOOXOOOOOXXOXXOXOOXOOXOOXXXOOOXXXOOOOOOOOOOOXXOOOXOOXXOO
XOOXOOOOOOOOOXOXOOOOXXOOOOXOOOOOOOOOXXOOOOOOOOOOXXOOXOOXOOOOXXOOOXXOXOOOOOXXOOOOOOOOOOOXOOOXOXXOOXOOO
OOXOOXOOXXOOOXOOOOXXXOOXXOOOOOXOOOOXXOOOOOXXOXOOOOXOXOOOOOOOOOOXXOXOXOOOOOOOXOXXOXOOXOXOOOOOOOXOXOXOO
OOOOXOOOOOOOOOOOOOOOXXOXOXOOXOOOXOOOOOOOXOOOXXOOOOOOOOOXOOOOOOXOOOOXOOXOOOXOOXOOOXXOOOOXOOOOOXOOXOOOO
XOXOOOOXOOOXOOXOOOOOOOOXXOOOOOOXXOOXOOOOXOOXOXOXOOXXOXXOOOXOXOOOXOXOOOOOXOOOOOOXOOXOXXOXXOXOOOOOOXXOO
OOOOOOXOXOOOOXOXOXXOXOOOXOOXOOOOOXOOOOOXOXOOXOXXXOXXOXXXOOXOOXOOOXXOOXOOOOOXXXOXOOOOXXOXOXXOXOXXOXOOO
OOXOOXOOOXOOXOOOOOXXOOXOXOOOOOOOOOOXOXXOOOOOXOOOOXOOXOOXOXOOXOXOXOOOOOOXOOXOOOXOOOXOOXOOOOOOOOOXOXOXX
OOOOOOXOOOOOOOOOXXXOXOOOOOOOOXOOOXXXXXXOOOOOXOOOOXOOOOXXOOOOOXOOOOOOOOXOOXOOOXXXXXOOXOXOOXOOOOOOOXOXO
OXOXOOOOXOOXXOXOXXOXOOOOOXOOOOOOXXXOOOXOXOOXOOXOXOOOOOOXOOXOXOOOXOOXOOOOOOOOOOOOOOOOXXXXOOOXOOOXOOXOX
OXOOOXOOOOOOOOOOOXOXOOOOXXOOOOXOOOOOOXOOOOOOXOOOOXOOOOOOXOOOXOOOOOXOOOOXOOOXXOOXXXXXXOXXOOOXOOOXXOXOX
OXXOOOOOXOOOOXOXOOXOXOOXXOOOXOOOOOOOOXOXOOXOXOOXOXXOOXOOOOXOXOOOOOOOOOOOXOOOXOOOXXOOOOOXXOOOXOOXXOOOO
XOOXXOOOXOXOXXOOXOOOOOOOOOOXOOXOOOOXXOOOOOOOOOXOOOOXOOOOXXOOOOOOOOOXOXOOOOOXOOXOOXOXXOOXOXOOOOXOOOOOX
OXOOXOOOXOXOXOXOOXXXOOXXOOXXXOOOXOOXXOOOOXOOOXOOOXOOXOXOOOXOXXOXXOOOXOOOXOXOOXOXOXOOOOOXXXOOXXXOXOOOO
OXOOOXOOOXXXXOOOOOOOOOOOXXXXXOXXOOOOOXOOXXOOOOOOOXOXOOOOOOXOXXXXXOOXXXOOOXOOXOOOOOOOOOOXOOXOOOOOXXOOO
OXOOXOOOOOOXOXOXOOOOXOOOOOOOOOOXXOOOOOOXOOXOXOOOOXOXOOOOOOXOOXOXXOOXOOXOOXOOOOXOOOXOXXOXXOOOOOOOXOOOX
OOXOXOOXXOOXOOXOXOXOOOOOOOOOOOOOOOOOOXXXOOOXOOOXOXXOOOOOOOOOXOOOOXOOOOXXOOOOXOOOOOOXXOXOOOOXOOOOXOOOO
OXOXOOOOOOXOXOOXXOXOXOXOOXOOOXXOOOXXOOOXXOOOOOXOOOOOOOOOOOOXXXOXOOOOXXOOOXOOOXXOXOOOOOOXOOOXOXXOXOOOO
OXXOOOXOOOOOOXXXOXOOOOOOOOOXXOOOOOXOOOXOOOOOOOOXOOOOOOOOOOOOOOXOOXXOXXOOOOOOOOXXOOOOOOOOOOXOOOXOOOOXO
XXXXOOXXXOOOOOXXOOOXOOOOXOOOOOOOOOOOXOXOOOOOOOOOOXXOOOOXOOOOOOOXOOOOXOOOOXXOOOOXOOXXOOOXOXOXOXXOXXXXO
XXOOOOOOOOOOOOOOOOOOOOXOXXOOXOXOOOOOXXOXXXXXXOOXOOOXXOOOOXOOXOXOXOOOOOOXOOXOOOOOOOOOOXOXOXOOOXOOXOOOO
