OXXOOOXOXXOOXOOOOOXXOOOOOOOOXXXOOOOOXOXOOXXXOOOOOOOOOOOOOXOOOOXOOXOOOXOOOOOOXXXOOOOOOOOXOOOOOOXOOOOOO
XOOOOOOXOXOXOOOOXXOOOXOXXXOOOOOXXOOXOOOOOOOXOXOXXOOOOOXXOOXOOXOOOOOXOOOOXOOOXOXOOOXOOOOOOXXOXOOOOOOXO
XOOOOOOOOOXOOOOXOOXOOOXOOXXOXOOXOXOOOXXXOXOOOXXXOXOXOOOOXOOOXXOOOOXOOXXOOOOOOXOXOXOXOXOXOOXOOOOOOOOOO
OXXOXOXXXOXXXOOOXOOOXOXXOOOXOXXOOOOXOOXOXXOOOOOXOOXOXOOOXOXOXOOXOOXOOXOOXOOOOXOOOOXOOXOXXOOXOOOOXXOOO
XOOOOXOOOXOXXOXXXXOOOOOOOOOOOXOOOXOOOOOOXOOOXXOXOOOOXOXOOOOXOOXOOXOOOXOOOOOOOOOXOOOOXOOOOXOXXOXOXOXOO
OOOXOOOOOOXOXOOOOOXXOOOOXOOOOOXXOOOOOOOXOOOOXOOXXOXXOOOOOOOXOXXOXOOXXOOOOXOOOXXOOOOXOOXOOOOOXXOXXOXOO
OOOOOXOOOOOXXOOOOOOOXXOXOOOOOXOXOOOXOOOOOOOOOOOXXOOOXXOOOOOOOOXOOOOOOXXOXXOOOXXOOOXOXOOXOOXOOOOOOOOXO
OOXOXOXOOOOXOOOOOOOOOXOOOOOOOOOOOOOOOOOOXOXXOOXOOOOOXXOXXOXOXOOOOXOXOOOOOOOOXOOXXXOXOXXOXOOOXOOOXOOOX
OXOXOOXOOOXXOXOXOXXOOOXXOXOOXOXXOXXOOOXOOOOOXOOXOOOXXXOOOXOOXOOXOOOOOOXOOOXXOOXOOXOOOXOOOOOOOOOXOOXXO
XOOXOXOXOOOOOOOXXXOXOXOXOOOXOOOOXOOXOOOOOOXOOXOXXXOOOXXOXOXOOOXOXOXXOOXOOXXOOXXOOOOOOOXXOOOOOOOXOXOXO
XXXOOXOOOOOOOOOOOOOOXXOXOOXOOOOOXOOOOOOOXXOOXOOXOOOXOOOOOOOOOOOXXXOOOOOXOXOXOXOOOOXOXOOXXXXOXOXOOOOOX
OOOOOXXOOOXOOXOXXOXOXOOOOXXOOOOOXOXOXXOOOXOXOXXOOXOOOXOOOOXOXOXXOOXOOOOOXXOXOOOOXOOXXOOOOOOXOOOXOOXOO
OOOXOOOOOXOOXOXOXOXOXOOOXOXOOOOOXOOXXOOOXXOOOOOOXXOXOOOOXOOOXOXOOOOOOOOOOXOOXOOOXOOXXXOOOOOOOOOXOOOOX
OOXOOXOXOOOXXOXXOOOOXOOOOOOXXOOOOOOOOOOXOXOOOOXXOOOOXOOOOXOOOXOOXXXOOXOOOXOOXOXOOOOOOOOOXXOOXOOXOOOXO
XOOOXOOXOOOOXOXOOOOXOOOOXOOXOOOOOXOXOOOOOXXOOXOOXOOOXOXOOXOOOOOOOOOXOOOXOOOXOOOXXXXOXXOXXOOOOXOXXXXOX
OOOXOOOXOOXXOXXOXOOOOXXXXXOOOOXXOOOOOOOOOOOOOXOOOOOOOXOOOOOOOOOOOXXXOOOXXOXOOOOXOXXXXXOOOOOXOOOXOOOXX
OOOXOOOOOOOXOOOOOOOOOOXOOOOOOXOOXOOOOOXOOXOOOOOOOOOOOOOXOXOOOOXOOOOOOOOOOOOOOOOXOOOOOXXOOXOOOOXOXXOOX
XXOOXXOOOOXOXOOOOOOOOOXXOOOXOOOXOXOOOOXOOOXOOOOXOXOOOXOOOOXOOOOOXOOOOOXXOOOOOXXOXXOOOOOOOOOXOOOOXXOOO
OOOOOOOOOOOOOOOOOXOXOOOOOOOOOOOOOOOXOXOXOOOXOOXOXOOOOXOOOOOOOOOOOXOOOOOOOOXOXOOOOOXOOXOOOXOOOOOXXOXOO
XOOOOXXOXOOXOOXXXOOOOXOOXXXXXOOOOOOOXOXOOOXXOOXOOXXOXOXXOXOOOOOXXXOXOXOOXXXOXOOOOOOOOXXOOOOOOOOXOXOOO
XXOOOXOOOOOXOOXXOOOXOOOOXXXXOOOXOOXOXOOOOOXOOOXOOOXOXXOOOOOOOOOOOOOOXXOOOOOXOOOOXOOOXOOOXXOOOOOOOOXOO
OXXOOOOXXXOOXOOXOOOOOOXXOXXOXXOXOOOXOOOXOOXOOOXXOOOXXOOOXOOXOXOXXOOOOOXXXOOOOXXOXXOOOOXOXOXOXXXOXOOOX
OOXOXOOOOOOOXXXOOOOOXXOOOXXOOOOXOOOXOOXOOXXXOOOOOOOXOXOOXOOOXOOXOOOOOXXOOOOXOXOOOOXXOOOXOXOOXOXOOOOOX
XOOXXOOOXOOOOOOXXXOXOXOOOOOOXOOOOXXOOXXOOXOXOOOXOOXXOOOXXOOOXXXOOXOOOXXOOOOOXOXOXXXOOXOOOOOOOOOXXXOOO
OOOOOOOOOOXOOXOOOOOXOOXXOXXXOOXOOOOOXXXOXXOOXXXOOXXXOOXOOOOXXOOOXOOOOOOOOXOXOXXXOXOOOOXXOOOOOOOOXXOXO
OOOOXOXXOOXOXOXXOOOOXXOOXXOOOOOOXOOXOXOOXOOOOOOOXOOXXXOOXOOXXXOXOOXXOOOOOXOOOXXOOOXOXOOOOOOOOXXOXOOXX
OOOXXOXOXXOXOOOOOOOXOXXOOXXOOOXOXOOXOXXOOOOOOOOOOOOXOOOXXXOOOOOXXXXOOOOOOOOOXXOOOOXXOOOXXOOOOOXOOOOXO
OOOOOXOOOOXOOXXOXOOXOXOOXOOOOXOXXXOOOOXOXOXOOOXXOOOOOOOOOOXXOXOXXOXOOOOOOXXOOOOOXOOOXXOOOOXOOOOOOOOOO
OOOOOXXXOOOOOXOXOOOOOOXOOOOOOXOOOXOOXOOOOOOOOOOXOXOOXOXOOOOXXOOOXOOOXXOOOOOOOOOXOXXXOOOOXOXXOXOOOOXOX
XOXOXOOXOXOXOOOOOOOXXXXXXOOOOOOOOOXOOOOOOOOXOXXOOXXOXXOOOOXOOOOOOOOXOOOOOOOOXOOXXOOOOXXOXXXXOXXOOXOXX
OXOOOXOOXOOXXOOOOOXXXOOXXOOXOOOOOOOXXOOOOXOOXOOXXOXOOOOOOOOOOXOOOOOXOXOXOXOOOOXOOOXOXOOXOOXXXOXOOXOXX
OOOOXOOOXOOXOOOOXOXOOOOOOOOOOOOXOOOOOOXOXOOOOOXOOOOOOOXOOOXXOOXOXXOOOXOXOOOOXXOOOOOXXOXXOOOOXXXXOOOOO
XOXOOXXXOOXXOOOOXXOOOOOOXOXOOOOOOOOOXOXXXXOOOOXXOOOOOXOOOXOOOOOOOOOOOXOXXOXOOOOOOOOXXOOXOOXOOOOXOOOOO
XXOXXOXOOXOOOOOXOOXXOXOOXOOOOOOOOOOOOXXOOXOOOXOXOOXXOOOOOOOXOOOXOXOOOXXXOXOOXOOOXOXXOOXOOOOOXOOOXOXOX
XOXOOOOXOOOXOOXXOOOOXXOOOOOOOOOOOOOOOOOOOOXOOXOXXOOOOXOXXOOOOOOOOOOXOXOOXOOOOOXOOOXXXXOXOXOXOOOXOOXXO
OOOOOXXXXXXOXOOXOXOOOXOOOXOOXOOOOXXOXOOXOOXOOOXOOOXOOOOOOXOOOOOOOOOOXXOOXOOOXXOXXOOOOOXOXOXOOOOOOOOOO
OXOOXOOOOOXOOXOOOOOOXXOOOXOOOXXOXXOOOOOOOOOOXXXOOOXOOXXOOXXOOOOOXXOXXOOOXOXOOXOOOOOOOXOOOOOXOOXOOOOXX
OOOOOOXOOOOXOXOOXOOOXXOOOOOOOOXOOOXOOOOOOOOOOOOOOOOOOOOXXOOXOOOOXOOXOOXOOOOOOOOOXOOOOXXXOOXOXOXOOXOXO
XOXOOXOOXOOOOXOXOOXOOXOXOXOXOOOOXXOOOOXOOOOXOOXOOOOOOOOXXXOOXOOXOOOXOOOOOXOXXXOOXOOOOXOOOOOXOXOXOXXOO
XOOXOXXOXOOOOXXOOXXOXOXOOOOOXXOOOXOOOOOOOXXXXOOXXOXOOOOOXXOOOOOXXXOOOOXOOOOXOOOOOOOOOOOOOOOXOOXOOOOOX
XXXOXOXOOOOXXOOOOOOXOOOOOOXXOXXOOXOOOOOXXXOOOOOOOOXXOXXXOXOOXXOOOOOOXXOOXOOXXXOOOOOOOOOOOOOOOXOOXOOXO
OOOOOOOOOOXOOOXXXXXOOXOOXOOOOXXOXOOOXOXOXOOOOOOOOXXOXOOXXOXOOXOXOXOOOXXOOOOXOOOOXOOOOOOOOOXOOXXOOOOOX
OOXOOOXXOOOOOOOOXOXOXXOOXXOOOOOXOOOOOXXOOOOXXOOOOOOXXOOXXOXOOXOXOXOOOOOOOXOOXOOXOXOOOOXOOOXOOOOXOOXXX
XOOXXXOOOOXXOOOOOOXOOXOOOOOXOOXXOOXOOOOOOOOOOOOOOOOXOXOXOOOXOOOOXOOOOXXOOXOOOOXOXOOOXOOXOXOXOXOXXOXOO
OOXXOXOOXOOOOOOXOXOXOOXOOXOOOOXXOXXOOOOXOXOXOOOXXXOXXOOOOOOXOOOOOOOOOXOOOOXOOXXXXOOXOOXXXOOXOOOOOXOXO
OOOOXOXOOXOOOXXOOOXOXXOOOXXOOXOOXXOOXOOXXOOOOOXXOXOOOXOXOOXOOOOOOOXXOXOOOOOXOOOOOXXXXOXOOOOOXOOXXOOOX
OXXXOXOOXOXXOOOOOOXXXOOOOOOOOOOOXXOXOOOOOXOXOXOOOOOOOOOXXOXXOOOOOOOOOXOOOOXOXXOOXOOXOOOOOOXOXOOOOOOOX
OOOXOXOOXOXOXOOOOOOOOOOOOOOOOXOOOOXOOXOXOOXOOOXOOOOXOOXXXOXOOXOOXXXOOOOOOXXOXOXOXOOOXOXOOXOOOOOOOOOXO
OOOXOOOOOXXOXOXOOOOOXXOOXOOXOXOOOOOXOXOXOXOOOOOOOOXOXXOXXXXXOOOOOOOXOOOOOOOXXOOOOXXOXOXOOXOOXXOOXOOOX
OOOOXOOOOOOOXXOOOOOOXOXXOOXOOOXOOOOXOOXOOXOOOXXOOOOXXOOXOXOXOOOOOOOXOOOOOOOXOOXOXXOXXXXOOXOOOOXXOOXOO
OXOOOOOOXOXXOOOOOOXOOOXOOOOXXXXXXOXOOOOXOXXXOXXXOOOOOXXOOXXXXOOOOOXXOXOOXXOOXOOXXXOOOOOOXXXOOXOXOXOOO
XOOOXOOOOOXOOOOOXXXXXOOOOOOOXOOXOOOOOXOXXXOOOOOOOOXOOOXOOXXOXXOXOOOOXXOOOXXOOOOXOOOOOXOOXOXOXXOOXOOOO
OOOOOOXXOOOXOOOOOOXOOXXOOOXOXXOXXOXOXOOOOOOOOOOXOOOXOOOOXOOOOOOOXOXOXOXXOXXOOOOOOOOOXOOXOXOXOOOOOOOOO
OOXXOOOOOOOXXOOOOOOOOXOOOXOXOOXOXOOOOOOXXOOOOOXOXOXOXOOOXOXOOOOXXXOXXXOOOOOOOOOOOOOXXOOOOXOOOXOOOOXOX
OXOXXXOXOOXOOOOOOXOOOOOOOOOOOOXOXOOXOOOXXOOXXXOOOOOXXOOOOOXOOOOXOXOOXXXOXOOOXOOXXOXOOXXXXXXOOXOOXOXOX
OXOOOOXXXOXOXXOOOXXOOXXOOOOOOXOXOOOOOXOXOOOOOXOOOXXXXOOXOXOXOOOXOOXXXOOOXXXOOXOOOOOOXOOOOOXOXXXOOOOXO
XOOOOXXOOOOOOXOOOOOOXXXOXXXXXXOOOOOOOOOOXXOOOOXXXOOOXXOOXOOOXOXXXOXOOOXOOOXOOOOOXOOOOOXOOOOXOOXXOOOOX
OXXOXOXXOOOOOOOXOOOXOOXOOOXOOOOOXXXXXOOOXXXOOXOXXXOOXXOXXOXOXXXXOXOXOOOOXOXOOXOOXOOOXOXOOOOXXOXOOOXOO
OOOOOXOXXOOOXOXXXOXXXOOOOXOXOXOOOXOOXXXOOOOOOXOOOXXXOOOXXOOOOXOOOOOXXOOXOXXOXOOXXOOXXOOXOOOOOOOXOOOXX
OOXOOOXOOOXXXOOOOXOOOXXXXOOXXOOOOXOOXOOOOOXOOOOOOOXOXXOOXOOOOOOOOXOOOOOOOXXOOXXOXXOXOXOOOOXOOOOOXXOOO
OXOOOXOOXOXXOXOOXOXOOXOOXXOOOOOOXXOOXOOOXOXOOOOOOXOXOOXOOOOOXOOXOOXOXOOOOOOOXOOOOXOXOOOOOOOOXOOOXOOXX
OOOOOXXOXXOOOOXXOOOXOXXOOOXOOOXXOOXOXOXOXOOOXOXXOXOOOOOOOXXOOXOOOOOOOOOOOOOXXXXXOOOXXXOOOXOOOOOXOOOOO
OOOOXXXXXOOXXOOXOXOOOOOOXOXXOOOXOOOOOOOXOXXOXOOXOOXOXXOOOOXOXOXXOOOOOOOOOOXOXXOOXOXOOOOOOOOOXOXXXOOOX
XOOOOOOOOOOOXXXOXOXXOOXXXOOOOOXXOOOXOOXOOOOXXOXOXOOXOXOOXOOOOOOOOXOXXOOXXOOOXOXOOXOXXOXOOOOXOXOXOXOXX
OOOXOOOXOOOOOXOOOXOOOOXOOXOOXOOOOXXXOOXOXOOOOOOOOOXOOOOXOOXXOOOOOOOXXXOOXXOXOOXOOXOOOOOOOOOXOXOOOXOOO
XOXOOOOXXOOOXOOOOOOOOOOXOXXXOOXOOOOOOXOXXOOOOOOOOOOOXOOOXOXOXOOOOOOXOOXOXOOOOOOXOOOOXXOOXXOXOOOOXOOXO
XXOOOXXXOOOOOOOOOOOOOXOXXOOXOXOXOXOOOOOOOOOOOOOOOXXXOOXXXOOOOOOXOOOOOOOXOOOOOXOOXOOOXOOOXXOOOXOOOXOXO
OXXOXXXXXOOOOOOOOOOOXOXOOXOXOXOOOOXXOOOXOOOOOOOOOOOXOXOXXOXXXOOXOXOOOXOXOOOOOOXOOXXOOOOOOXXOXOOOXOOOO
XXXOOXOOXOOOOXXOXOOOXOOOOOXOOOOXOXOXOXOOOOOOOOOOOXOOOOOOOOOOOOOXOXOOOOXXXOOOOOXXOOOOOOOOXOOXOXXOOOOXO
OXXOOXXOOXXOOXOOOOOXOOOOXXOOOOOOOOOOOOOXOOXOXXOOXOOOOOOXOXXOXOOXXXOOXOOOXOOXOOOOOXXOXXOOOOOXXOOXXOOOO
OXOOOXOXOOOOOXOOXOOOXOOOOOXOOOOOXOOOOXXOXOOOOOOOOOOOOOOOOOOOOOXOXOXXXOXOXOOXOOOOOOOOXOOOOOXOOXOOOOOOX
OOXOXOOOOOOXOOXXOOOXOOOXOOOOOOOOOXOXOXOXOOXOXOOOOOOOOOOOOOOOOXOOXXOXOXOOXOOOOOXOOXOXOOOXOOOOXOXXXOOXO
OXXOOXXOXXXXOOOOOXOOOOOOOOXOOOXXXOXOXXOOOOOOOOOOOXXOOOXOOXOOOXOXOXOXOOOOXXOOXXXXOOOOOOXOOXXXOOOXOXOXO
OOXOOOOOXOXOOOOOXOOOOOOOOOOOOXXOOOXOOXOOOOOXXOOOXOOOOOOOOXOOXOOOXXOOOXOOOXOXXXOOXOXOOOOXXOOOXOXOOOOXO
OOOOOOOOOOOOOOOOOOOOOOOXXOOOXOOXOOOXOOOOOXOXOOOOXOOOOOOOOOXOOOOOOOOXOOXXXOOOOOOOOXOXOOOOOOXOOOOOOOOOO
XOOOXXOOOOXOXOOOXXOOOOXOOOOOXOOOOOXOXXXXOOOOOXXOXXXOOXOOOXOXOOXOXOOXOXOXOXOXOOOXOOXOXXOOOXOOOXOOOOOXO
OOXOXXOOXOOOOOOOXOXXOOOOOOOOOOOOOOOOXOOOOOXXOOOOOOOXXOOXOOXOXOXOOXOOOOOXOOXXOXOOXXOOOOOXOOOOXOXOOXOOX
OXOOOOXOOOOOXXOOOXOOOOOXXOXOXOXXOOXXOOOOXOOOOOXOOXOOOXXOOOOOOXOXXOOXOOOOOOOXOXOOXOOOXOOOXXOOOOXXOOOXX
OOOOOOOOXOOOOOOXOOOXOOOOXOOOOXOXOOOOOOOOXOOOOOOXOXOXOOXXXOOXXXOXOOOXOOOXOOOXOXOOXOXOOOOXOOOOXOOOOOOOO
OXOOXOOOOOOOXXOXXOXOOXXOXOXOOOOXOOOOOOOXOOOOOXXOXOOOXOOOOOOOOOOXXXOXOOOOOOXOXXXOOOOOOOOOOOOXOXOOXOOOO
OOOOXOOOOOOXXXOOXOOOXOXXOOOXOOOOXXXXOXXXOOOXOXOOOXOOOOOXOOXOXOOOOOOOOOOOXXOOOOOXOOOOOOOOOOOOOXOOOXOOX
OXXOOXXOOOXXXOXXOOXOOXOXXOOOOOOOOOXXOOOOOOOOOOOXOXOOOOOOOOXXOOOOXXOOOXOOOOXOXOOOXOOOOXOOOOOOOXOXXOOXO
XXXOOOOOOOOOOOOXOOOOOOOOXOOXOXOXXOOOOXOOOOOOOOXOOXOXOOOOXXOOXXOOOOOOOOOXOXXOOOXOOOOXXXOXOOXOOOOXXOXOX
XOOOOOOXOOOOXXXXOXOOOOOOXXXOOOOXXOOOOOOOXXXOOXOXOXOOOOOOOXOOOOOOOOOXXOOOOOOOOOOOXOXOOOOXXXOOOOOOOOOXO
OOOXOOXXXOOOOXXOOOOOOOOXXOOOOOXOXOXOOOOOOOOOXOOXOXOOXXOOOXXOOOXOOXXXOOOOOOOOOOOXOOOOOOXXXOOXXOOXOXXXX
OOOOXOOOXOXXOOXXOXOOOOXXOOOOXOOXXOOXOOXXOOOOOOOOOOOOOXXOOXOOOOOOOXOOOXXOXOXOOOOOXOOXOOOXOOOXXOXXOOOXO
OOXXXOOOXOOOOOOOOOOXXXXOXOOOXOOOOOOOXOOOOOXOOOOOOXOOOOOXOOOOXOOOOXOOOXXOOXOOOOOOOOOXOOOOXOXOOXOOXXOOX
OOXOXXOXXOOOOOOOOOOOXOXOOXOOOOOOXOXXOOXOOXOOOOOOXXOXOOOXXOOOOOOOXXOOOOOXXOXXXOXOOXOOXOXXXOOOOOOOXXXOO
XXOOOOOOOOOXOXOOXOOOXOOOXOOXXXOXOOOOOOXOXOOXOOXXOXOXOOOOXOOOOOOXOOOXOXXXOOOOOOOOXOOXXXOOOOXXOOOOXOXOO
OOXOXOXOOOOXOXOOXOXOOOOOOOXXXOOOOXOOOOOOOOOOOXOOXOOOOXOXXOOOOOXOOXOOOOXOXOOOXXXOOOXOXOOOOXOOOXOOOOOOX
XXXXXXOXXOXXOOOOOXXXOOXOOXXOXOOOOXXXOXOOOXOOOOXOOOOOOOXOOOOOXXXOOOOOXOOOOXOOOOOOOOOOXOXOOOXOXOXOXOOOX
OOXOOOXXOOOOOOXOOOOOOOOXOXOOOOOOOOXOOXXOOOOOOOOXOOOOOXOXOOOOXXOOXOOOOOXOXXOXXOXXOOXOOOOOOXXOXOOXOXOXO
OOOOOOOOXXOOOOOOXOOOOOXOOXXOOOOOOOOXXOOOOOOXOOOXXXXOOOOOOXXOXOOOXOOOXXXOOOOOXOXOOOOXXXOOXXXOOOOXOXOXX
OOXXOXOOXXOOXOXOOOOXOOXOOXOOXOOOXOXOOXOOOOOOXOXXOXXXXOOOOOOOOOOOOOOOOOXXXXOOXXOXOOXOXOOXXXOOXOXOOOXOO
OOXOOOOOOXXOOXXOXXXOOOOOXOOOOXOXOOOXXOXOOOXOXXOOOOOOXOOOOXOXXXOOOXOOXXOOOOOOOXOOOOOOXXOOXOOOXOOOXOOXX
OOOOXOOXOXOOXOXXOXOOXOXXOXOOXXXOOOOOXOOOXXXOOOOOOXXOOOXXXXXOOOOOOOOXOOOXOOXOOXOOXXOOOOXOOOOOOOOOOOOOO
OOXOOOXOOOOOXXOXOXOXOOOOOOOOOOOOOOOOOOOOOOOOOOOXXXOOOXOOXXOOOOXXOXXXXXOXOOOOOOXXXOOXXXXXOOOOOXOXOOXOX
OXOOOXOOOOOXOOOOOOOXOOOOOOOOOXXOOOOXOOOXOOOOXXXXXOXOXXOOOOOOOXOOOOOXOOOOOOOOOOXOOXXOOOOOOOOOOXOXXOXOX
OOXXXOOXOOXXOOOXXXXOOXOOOXOOOOOOOXOXOOOOXXXOXOXOOOOOXXOOOXXOXOOXXXXOXOOOOXOOOOOOOOOXOOXOOXOOXXOOOOXOO
OOOOOOOXXXXXXOOOOOXXOOXOXXOXXOXOOOXOXOXXOOOXOOOOOOOOOOOOXOOOXOOXOOXOOOOOOOOXXOOOOOXOOOOXXXXXXOOOOXOOO
XXOXXOXXOXOXXOXOXOXOXXOOOOXOOOXOXOXOOOXOOOOOOOOOOOXOOXXXXOOOOOXOXOXOXOOXOOOXXOOOXXXOOOOOOXXXXOOXXXXOO
