XXOOOOOOOOOXOXOXXXXXOOOXOOXXOOXOOXXOXOOOXOOOXOOOOXXOOXOOXXXOXOOXOOXOOOOOOOOOOOOOOOXOOOOXOXXOOXOOOXXOX
OXOXOOOXOXXOOOOOOXOXOOXOOXOXXXOOXOOOOOOOOOOOOOOOOXOOOOOXOOOXOXXOOOOOOOXXOXXOOOXOOXOOXOOXXXOOOOOXOXOOX
XXOXXOXOOXXXOXXOOXOOXXOXOOOXXOOXOOOOXOXOXOOOXXXOOOXOOOOXOXOOXOXOOXOOXXXOOOOXOOXOOXOOOOXOOXOOOOXOOOXOO
XOOOOXOOOXOXOXXXXOXXOXOOOOXOXOOOXOOXOOOXOOOOXOOOOXXOOXOOXXOXOOOOOOXOOXOOOOOOXOXXXOOOXXOOXOOOXOXOXOOXO
OOXXOOOOOOOOOOOXOOXOOOOOOXXOOOOOOXOOOOOXOOOOXOOOOOOOOOOOOXOOOXOXXOOOOOOXXOOXXXOOOOXXOXOOOOOXOXOOOOXXO
XOXOXOOOOOOOOOOOOOOOOXOXOOOOXOXOOOOOXOXOOXOXOXOXOOOOOOXOOOOXOOOOOOXOOOOOXOOOOXOOOOXOOXOOOOOOOXXOOOXXO
XOXOXOOOXOOXOOXXOOOXXOOOOOOOXOOOOOOXXOOOXOOOXOOOXOOOOXOOOOXOOOOOOOOOOXOOOOXOOOOXXXXOXOXXXXXOOOOXXXOOX
OOXOOOOXOOXXOXOXOOOOXXOOOOOXOOOOOOOXOXOXOXXXOOXOOXXXOOOOOOXOXXXOXOOOXOOXXOOXXOXXOOOXOOOOOOOOOOOOOOOOO
XXOOOOXOOOXOOOXOXOOOOOOXOOXOXOOOOOXOOXOOOOOOOOOXXOXXXXOXOOOOXOOXOOOXXOXOOXOXOOXXOOOOOOOOXOOOXOOXOOOOO
OOXXOOXOXOXOOXXOOXXOOOXOOOOOOOOOXOOOOXOXXXOOOOXOOOOXOOOOOOOOXXOXXOOOOOXOOOXOOXXOXXXXOOXXOOOOOXOOXOOOO
XXOOOXOXOXXXOOXXOXXOOOXOOOXOXXXXXOXOOOXXOXOOOOOOXOOXOXOXOOOOOOOOOOOXXOOOOOOOOXXXOOOOOOOOOOOXXOOOOXOXX
OXOXOXOOOOOOOXOOOOOOXXOOOOOOOOXOOOOOOXOXOOOOOOOOOXOXOOOXOXOXXOOXOOOXOOXXOXXOOXOXXOOOOXXXOXXOOOXOOOXOO
XXXOXOOOOOOXOOXOOOXOOXXOOOXOOXOOXXOOOOOOXXOOXXXOOOOOOOOOOXOOOOOXOOOOXXOXOXXXOOOXOOOXOOOOXXOOXOXXOXOOX
OOOOXOOOOOOOOOXXOOXOOOOOOXOXOOOXOOOOOXXOOOXXOOXOOXOOOXOOOOXOOOXOOOOOOOOOOXOOXOOXOXOOXOOXOOOOOXOXOOOOO
OOOXOOOOOOOOOOOXOOOOOOXXXOXXOOOOOOXXOOXOOOOOXOOOOOOOXOOOXXOXOXOOXOOOXOOOOOXOXOOOXXOXOOOOOOOOOXOOOOOOO
XOOOOXXXOOOOOOOOXOOOXOOXOOOOOOOXXOXOOOOOXOXXOOXXXOOOOOOXOOOXOXOOXOOOOOOOXOXOOOOXOOXOXOOXXOOOOXOXXOOOO
XOXOXOOXXOOXXOOOOOXOXXOXOXOXXOOOOOXOOXXXOOOOXOOXOOOOOOOOXOOXOOXOOOXOOOOOXXOOOXXOOOOOOOXOOOXOOOXXOOOOX
OOXXOOOOOOOXOOOXXOXXXOOOOXOOXXOOXOOOOXXOOXXOXOXXXOXOXOXOOOOXOOXOOOOXXOOXOOOOOOOOOXOOXOXOXOXOOOOXXXXOO
OOOOXXOOOOOOOOOOXXOOOOOOOOXOOOOXXXOOOOOOOOOOOXOOOOOXOOOOOOOOXOXOXOOXOXOOOXOOXXOOOOXOOOOOOOOOXOXOOOOOX
OXXXXOOOOOXXXOOOOXXOXXOOOXOXOXOOXOOOOOXOOXOOXXOXOXOOOOOXOOOXXXOOOOOOXOXOOOXOXOOOOOOXXOOXXOOOXOOXOOOXX
OXOOOOOOXOOOXOOOOXXOOXOXOOOOOXOOXOXOOXXOOOXOXOXOOXOOOOOXOXOOXOXOOOOXOOOOXXXOOOXOOXOOOOXOOOXXOOOOOOOXO
OOXOXOOXXXOOOOOOXOOOOOOOOOOOOXOOXOOOOOXXOOOXOXOXXOOOOOOXXOOXXXXXXOOOOXOOOOOOOXOXXOOOXXOOOOXOOOOXOOOOO
XXXOOOOXOXXOOOOXOXOOOOXOXXOXOXOOOOOOXXOOOOOOOOOOOOXXXOOXOOOXXOXXOOOOOOOOOOXXXOOOXOOOXOOOXXOXOOXOOXOXO
OOOOOXXOXOOOOOXOOOOOOXXXOXXOOXOOOOOOOXOOOOXOOOXXXXOOOOOOXOOOXOOOOXXXXOOOXOXOOXOOXOOXXXXXOXOXOOOOOXOOO
XOOOOXOXOOOOOOOOOOOOOOOXOOXXOXXOOXOOOOOOXOOOOOOOOXXXOXOXOXOXXXOOXOOOOOOXOOOOXXOOOOXOXXXOOOOOOOOOOOXOO
OOOOOXXOOXOOXXOOOOOOOOOOOXOOOOOXOOOOOXOOOOOOOOXXOXOOOOOOOOXOXOXXOXOOXXOOOOXOOOOOOOXXXOXOOXOOOXOOOOXXO
OOOOOOOXOXXOXXXOOOOOOXOOOOOOOXOOOOXXXXOOOXXXOOOXXOOXOOOOXXOOOOOOOXOOOOOOOXOOOOOOOXOXOXOOOXOOXOOOOXOOX
OOOOXXOOOXXOOOXXOXOXXOXXOOOXOOXOOXOXOOOOOOOOXOOOOOOOOOOOOOXOXOOXOOOXXOOOXOOOOXXXOOOOOOXOOOOXXOOXOOOOO
XOXOOXXOXOOXOOOOOXOXOOXXOOOOOXXOXXOXOOOXOOOOOOOOOOXOOOXXOOOOOXOXXOOXOOOOXXOOOOOXOXOOOOOXXOXXOOXOOXOXO
OOOOOOOOOOOXOXXOXOOXOOOXXOOXOOOXXXOOOOOOOXOOOXXXOOXXOOOOXOOOOOOOXOOOXOXOOOXXOOOXOOXOOOOXOOOXXXXXXOOOO
OOOXOXOOXXXXOOXXXOOXOOOXOOOOXXOOXOOOOXOOXXOOOOXOOOOXOOOOOOOOOXOXOOOOOXOOOOXXOOOOXOOXOOXOOOOXXXXXXXOXO
OOOOOOXXOXXXXXOOXOXXXOXOOXOXXOXOXOOOOXXOXOOOOOOOOOOOXOOOOOOOOXOOOXOOXOOOOOOXOXXOOOOXXOOOOXOOXOXOXXOXO
OXOOXOOOOOXOXOOXOOOOOXOOXOOOOXOOOXOOOOOOOOOOXOOXXXXOXOOOOOOOOXOOXOOOOOXOOOOOXXXOOXOOOXXOXOXXOOXOOOOXX
OOOOOOOOOXOXOXXOOOOOOOXOXOOOOOXOXXOOOOOOOOXOXOXXOOOXXXXOOOOXOXXOOOXXXXOOXOOOOOOOOOOXOOXXXOOXXOXXXOOOO
XXXXOOOOOOOOXOOXOXOOOOOXOXXOXOXXXOOOXXOOXOOOOXXOOOOXOOXOXOOOOOOOOOOXOOOXOXOOOOOOXOOOOOXXOOXXOOXOOOXXX
OOOXOOXOOOXXOOOXXOXXOOOOOOXOXOOOOOXOXOOOOXOOOXOOOOOOOOOXOXXXOOOOOXXXOXOOOXOOOXOOOOXOOXOXOOOXOOOOOOOOX
OOOOOXOXOXOOOOOOXXOXXXOOOOXXOOOXOOOOOOOOOOOOOOOOOXXOOXOXOXXOOXOOOOXOOOOOOOOOOXOOXXOXOOXOOOXOOXOOOOOOO
OXXOXXOOOXXOOOXOOOOOOXOOOXOXOOOOOOOOOXXXOOOXOOXXXOXXXXOXOOOOOOXXOOOXXOOXXOXOOXXOXXOOXOOOOOOXOXOOXOXOO
OOXOOOOOOXOXOOOOOXOXOOXOXOOOOOOXOXXOXXOOXOXOXOOOOOOOOOXOOOOXOOXOXOOOOOOOXXOXOOXXOXOOXOXOOOOXOOOOOOOOO
XXXOOOOOOXOOOOOOOXOOOOOOOOOXOXOXXOOOOOOOOXXXXOXXOOOXOOOOOOOXXOOOXOXOOOOXOOXOXOOOOXOOOOOOXOOOXXOOOOOOX
OOOOOOOOXXXOXOOXXOOOOXOXOOOXOOXOXOOOXXOOOOOOXOOOXOOXXXXOOOXOOOOOOOXOXOOXOXOOOXOOOOOOOOOOOXOOOOOXOOOOO
OOOOOOOOXOOOOXOOOXOOOOOOOXOOOOXXOXOOOOXOOOXOOOOXXXXOXOXOXOXXXOOOOOOOXOOOXOOXOOOOOOOOOOXOOOOXXOOOOOXXO
OOOOOXOOOOOOXOOOXOXOXOOOOOXOXOOOOOOOOOOXXXOXOXOOOOXXOOOOXOOXOOXXXOOXXOOOXXOOOOXOOXOOXOOXXXOXOOOXOOOOO
XOOOOOOOOXXOOOOXOOOOXXOOOOOXXOOOOOOOXOOXXOXOOOOOXOOOOOOOXXOOOXOOOOOOOXXOOOOXOOOOOOOXOOOOXXXOOOOOOOOOO
XXOXOXOOXXOOOOOOXOOXOOOXOOOOOOXOXOOOOOXOOOXOOOXXOOOOOXOOOOXXXXXOOXOXXXOOOXOOOXOOXOXXXOOXOOOOOOXOOOOOX
OOXXOXXOOOOOXOOOXOXXOOOXOOXOXOXXOOOXOXXOOOOOOXOOOXOOOXOOXOOOOOOOOXOXOOOOXOXOXOOXOOXOOOXOOOOOXXOOXXOOO
OOXOXXOOOXOXOOOOOOXOOOOOOXOXOOOOOOOXOXOOXXOOOOXOOXOOXXOXOOXXXOXOOOXOOXOOOXOOOOOOOOOOOOXXOXOOOOXOOOXOO
OOXOOOOXOOOOOOOOOOOOOXXOOXOOOOOOOOOOOOXOOOOOXXOOOOXOOXXOOOOXOXXOOOXOOXOOOOOOXOOOOOOOOOOOOOXOOOXOOOOOO
XOOOXOOOOOOOOOOOOOOOOXOOOOOOXXXOOOOXOOOOOOOOOXXOXOOOOOXOOOXOXOOOXXOOOOOXOOOOOOXOXOOOOOXXXOOOOOOOOOOXO
OOOOOOOOOXOOXOOOOOOOXOOOOXOXOXOXOOXXXXXXOXOOOXXOXOOXOXOOOOOOOOOOXOOXOOXXOXOOOXXXOOXXOXOOOXOOOOOXOOXOO
XXOXOXXXOOOOOOOXXXOXXOOXOOXOXXOXOOOXOOXOXOXOXOOXOXOOOOOOOOOOXOOXOXOXXOOXXOOOOXXOOOXOXOXXOOOOOOOXOOXXX
XOOOXOOXOOOOOOOOOOXOXOOXXOXOOOOOXXOOOOOOXOOOOXOOOXOOOOOOOOXXOOOXXOXOXOXXXXXOOOOOOOOXOOXOXXXOOOOOOOXOO
OXOOOOXOXXOXOOOOOOXXOOXOOOXXOOOOXXXXOOOOOXOOXOOOOOOXOOOOOOOOOOXOOOOOOOXOXOOXOXOXOXOOOXXOXOOOOOOXOOXOO
OOOXOXOOXXOXOXXOXOXOOOXXXOOOOOXOOOOOXOOOOOOOOXXXOOOXOXOXOOOOXOOOXOXOOXOOOXOOOXOOXOXOOOOXOOXOOOOOOXOXO
OOOOOXOOXOOOOOOXOOXOXOOOXXOOOXOOOOXOOXOOXOOOOXXOOOXOOOOXOOXXOOXXOXXOOOXXOOOOOXOOOXOOOOOOOOOOXXOOOOOOX
OXXOOOOOXOXOOOXXOOOOOOOOOOOOXOXOOOXOOXXXOOOOOOOOOOOOOOOOXOOOXOOOOOOXOXXXOOOOOOOOXOOOOOOXOXOOXOOOXXOOO
XXOXXOOOOXXOOOOOOOOOXOXOXXOOXXOXXOOXXOXOOOOOOOOOXOOOXOOXOOOOXOOOOXOOOOOOOXOOOXXOOXXXOXXOXOOOXOXXOXOOO
OOXOXOXOOOOOOXXXOOXOOXXXXOOOOXOOOOOXOOOOXOXXOXOOOOOXOOOOOOOOOXOOOOXOXOOXOOXOOOOOXXOXXXXOXXOOOOXOOOOOO
OXOXOXOOOOXOOOOOOOOOOOOOOOOOOXOOXXOXOXXOOXXOOOOXOXXOOOOXOXOXOOOOXXXOOXOXOOXOOOOOOOOXXXOOOOXOOOOOXOOXX
XOOXOOOOXXOXOOOOOXOOOXXOOXOXXXOOOOOOOOOXOOOXXOOXOOOOOOOOOXXOXOOXXOOOOOXOOOOXOXOXOXXOOXOOOXOOOOOXXXOOO
OOOXXXOXXOOXOOOOXOXXOOXOXOOOOXOXOXOOOXOOXOOOXOXOOOOXOOXOOOXOOOOXOXOOOOOOOOOOOOXOOOOOOOOOOXOOOXOXOOOOX
OOOOOOOXXOOOOOOOOOOXOXOOOXOOOOXXOOOXOXXOOXOOOOOOXOXOXOXOOXOOOXOOOXOXOOOXOXOOXOOOOOOXXOXOXOXXOOXXXOOOO
OOOXXOOOXXOOOOXXOOXXOXXOOXXOOXOOOOXXOOOOOOXOOXOOXXOOOXOOOXXXOOOOXOOOXOOOOOOXOXOOOOXXOOOOOOOXOXOOOOXOO
XXOOXOOXOOOOXOOOOXOXOXOOXOXXOXOOOXOOOOOOOOOOOOOXXOXOOXXOOXOOOOXOOOXOOOOOOOXXXOOOXXOXOOOOOXOOOOOOXOOOO
XXOXOOXOOOXOXOOXOOXOXOOOOOOOXOXXXXXXOXOXOXXOOOXOOOXOXOOOOOOXOOOOXOOOOXOXOXXXOOOOOXOOOOOOOXOOOOOOOOOOX
OOOXOOXXOXXOOXOOXXOXOOOOOOXOOOOXOOOOXXXXOOXXXOOXOOOOXOOOOXOOOOOOOOXOXXOOOXOOXOOOOOOXXOOOOOOXXXXOOOOOO
XOOOOOOXXXOOOOOXXXOOOXOOOXXOOOXXXXXOXOOOOOOOOOXOOOOOOOXOOXOOOXOXXOOXOOOOOOOXOXOOOOOOXOXOXOOOOOOOOXOXO
OOOOXOXOOOXXOOXXOOOOXOOXOOXOXOOOOXOXOOXOXOXOXXXXXOOXOOXOOXOOOOOXXOOOXOOOXOXOOXXOXOOOXXXOOOXOOXXOOOXOO
OXOOOOOOOOOOXOXOOXXOOOOOOOOOOXXOOXXOXOOOOXOOOOOXXXXXOXOOOOOXOOOOXOXXOOOXOOOXOXXXXOXOOOOOOXOXOOOXOOOOX
XOXOOOXOOOOOXOOXOOXOXOXXXXOOXOOXOOOXOXOOXOOOOOOOOOOOOOOXOXOXXOOOOOOOOOXXOOXOOOOOOXXXOOOOOOXOOXXOOOOXX
OXXOXOOOXOXXOOXXXOXOOOOOXOOOOOOOOXOOOOXXOOXOOXXOOOOOOOXOXXXOXOOXXOOOOOOOXOOOOOXOXOOXOOOOXOOXOOOOOXOOO
XOOXOOOOOXOOOXOXXOXOOOOOOOOOOOOOXOXOXXXOXXOOXOOXOOXOOXOXXOOOXOXXXOOOOOOOOXXXOXOOXOOXOOOOXXOOOOOOOXOOX
XOOOOOXXOOOOOXOXOOXOOOXOOOOOOOXOOXOOOOOOOOXOXOOXOXOOOXOXOXOXXXOOOOOXOOXOOOOXOOOXOOOOXOOXXOOXOOXOOXOOO
OOOOOOXOOOOOXOOOOOOXOOOOOOOXXOOOOOOOOXOOXXXXOOXOOOOOOOXOOXOOOOOOOXOOXOOOOOOXOXOOXOXXXOXOOOOXOOXOXOOOX
OOOOXOOOOOXOXOXOXOOXXOXOOOOXOXOXOOOXOOXOOXOXOXOXOOOOOOOXOXXOOOOOOOOXOOOOXOOOOXOOOXOXXXXOOXXOOXOOOOOOX
XOOXOOOXOOOXOXOOOOOOOOXOOOOXOXOOOOOOOXXOOOXOXXOOXOOXOXOOOOOOOXOOXOXXOOOOOOOXOXOOXOOXOXOOXXOXXOOOOOXXO
OOXOXXXOOOOOXXOOOOXOOXOOOOXXOOXOXXOOOOXOXXOOOOXXXOOOXOXXXOOXXOOXOXOOXXOXOOXOOOOXOOOXXOOOOOXXOOXOOXOOO
OOOOXOOOOOOOXOOOOOOOOOOOOOXOOOOOXOOOOOOOXXOXOXOOXOXOOOOOOOOOXOOXXXOOOXOOOXOXXXOXOXOOOXOXOOOOXOOOOOOOO
OOOOXOOOXOOOOOOOOOOOOOOOOXOOOOOOOXXOOOOOOOOXXOOOXOOXXOOXOOOOOOOOOOOOOOXXOOOOXOOXOOOOOOOOOOOOOOOOXOOOO
OOXOOOOXOOOOXXOOOOXOXOOOOOXOOXOOOOOOOOXXOOOOOOOOOOOOXOOOOOOOOXOXOOOOXXOOXOOOOOOXOOXOXOOXOXOOOOXXOOOOO
XXOOXOXOOOOOOOOOOXOOXOOOOOOOOOOOOXOXOXOOOXXOOXOOOXOXXOXOOOXXXOOOOOOOOOOXOOXOOOOOOOOOOOOOXOOOOXOOOOXOX
XXXOXXOXOOOOOOOXXOOXXOXOXOOOXXOOOXOOOOXOOOXXXXXOOOOOOOOOOOXOOOXOOXOXOOXOXOOXOOOOOOOOOOOOOOOXXOOOXOOXO
XXOXXXOOOXXXOOXOOOOOXOOXOOOOOXXXOOOOOXOOOOOOOOOOXXOOOOOOXOXXXOOOXOXXXOOOXOOXOOXOXOOOOXOOOXOXXOXOOOOOO
OOXXOOOOOOOOOXOXOXOOOOXOOOOOOOOOXOOXOOOXOOOXXXOOOXXOOOXOXOOOOXOXOOOOOOOOXOOXXOOOOOXXXXOXXXXXOOXOXOOOO
OOOOXXOOXXOOXOOXOOOOXOXXOOOOOOOOOOXXOOOOOXOXXOOOOOXOOOOOXOOOOOOXXOOOOOXXOOXOOOOOOXXOOOXOOXXXXOOXOXXOO
XOOXOOXOXOXOOOXOOXXXXOOOXXOOXOOXOOOOOXOXOOOOOXXOXOOOXOOOOXOOOOOXOOOOOOXOOOOOOXOOOOOOXXOOOXOOOOOOOOOOO
XOXXOOXOOOOOOOOXXOXOXXOOXXOXOOOOOOOOOXXOXOXOOOOXXOOXOXOOOOOOOOOOXXXOXXOOXOOOXOOXXOOOOOOXOXOOXOOOOOOOO
OOXXOOXOOOOOOOXOXXXOOXOXOXOOOXOOXOOXOXXOOOXXXOXXXOXOOXOOOOOOXOXOOOOOOOXXOOXOOOOOOOOOXOXOXOOXOOXXOOOOO
XXXOOOXOOOOXXOXOXXXXOOOOXOOOOOXOOOOXOOOOOXOOOOXOXOOXOOOOOOXOOOOXOOOOOOOOOOXOXOOOXOOOOOOOOOOOXXOOOOOOO
OXOXOXOXXOOOOOOOOOOOOXXOOOXXOOOOOOOOOOXOXOXXOOOXXXOOOOXOOOXOOOXOOXXXXOOOOOOOOXXOXXOOOXOOXXXXOOOXXOOOO
XOXXXXXOOOOOXOOOOOOXXOOOOXXOOXOOOOXXOOOOOOOOOOOOXXOOOOOOXXXOOOOOXXXOXXXXXOOOOXOXOXOOOOOOOOOOOOXOXXOOO
OOXXOOOOXOXXXOOOOXOOOOOOOOOOOOOXOOOOXXOOXXXXXXXOOOXXOXXXXXXOOXXOOOOOXOOOOOXXOOOXOOOXOXOOOOOOOOOXXXOOX
XXOOOXOOOOOOOOXOOOOOOOXOOOOOOXOXXOXOXOOOOOXOXOXOOOOXXOOXOXOXOOOOOOOOXOOOXOOOXOOOXOOOOOOXOOOOOOOOOOOXO
XXOOOOOXOOOOOXXOOOXOOOXOOOOOOOXOOOOOOXOXXOOXXOOXOOOXOOOOOOOOXOXOOXXOOOXOOOXOOOOOOXOOOOOXOOOOOXOOOOXOO
OOOXOOOOXXXOOOOOXOOOOOXOXXXOOOOOXXOXXOOOOXOOOOOOOOOXOOOOOOOOOXOOOOOXOOXXXOOOOXXOOXXOOOOOOOOOOOXXOOOOO
XOOOOOXOXOOXXOOOXOOOOOXXOOOXXOOOOOOXOOOOOOOOOOXOOOOOOOOOOOOOOOOOXXOOOXOOXXOXOOOOOOXOXXOOXOOOOXOOOOOXX
OOOOOXXOXOXOXOXXXOXOXXOOOXOOXOXOXXXOXOOOOOOOXOOOXOOOOOXOXOXOOXOOXOOOXXXOOXXXOXOXOOOXOXOOOOXXOOOOOXOXX
OOXOOXXOOOOOOOOOOOOOXOOOOOXXOOOXOOOXOOXXOXOXOXOOOXOXOOXOOOOOOOOXOOOOXOOOOXOXOOXOOOOXXXOOXOOOOOOOXXOOO
OOXOOOXOXOXOOOOOXOXOOOOXXXXOXOOOXXXOOXOOOOOOOOOOXOXOXOOXOOOOOOOXOXXOOOOOOOOOOOOXXXOXOOOOXOOOXXOOOOXOX
OXOOOOXOOXOXXOXOOOOXOOOOXOOOOXOXXXOOOOXXOOOOXOOOXOOOOOOXXOXOXXOOOOOXXXOOXOOOOOOXXOXOOXOXXOXOXOXOOXOOO
OOOOOOOOOXOOOOOOOOXOOXOXOOOOOOOXXXOXOOOOXOOOXOOXOOOOOOOOXOXXOXOOOOOXOXOOOOOOOXOOOXOOXOOOOOOOXOOOOOOXO
