OOXOOXOOOOXXOOOXOXOOXOOOOOOXOOXOOOOOOOOOOOOOOOXOOOOOOOOOOXOOOOOOOOOOOOXOOOOOXOXOOOOXXOXOOOOXXOXOOOOOO
OXOOOOXOXOOOOOOOXOOXXOOOOXOOOXXOOOOOXOOOOXOXOOXOOXOOOOXOXXOOOOXXXOOXOXOOXOXOOXOOOOXXOOOOXOXOOOXOOOXOX
OOOXOXOOOXOOOOOXOOOXOOXOOOOOXOOOOXOOOOOOXOOOOOXXOOXXOXXOOOOXOOOOOOOOOXOXOXXOXOXOOOXOOOOXXOOOXOXXXOOOO
OOOXOOXOOOOOXOOOXXXOOOOXXOOXOOXXOOOOOOXOOOOOOOXXXOOOOOOOXOOOXOOOOOOOXOOXOOOOOXOOOOXXOXOOXXOOOOOOOXOXO
OOOOXOOOOOOOXXOOOXXOOOOOXXOOOOXOXOXXOXOXOOOXOOXOOOOXOXOOOXOOOOOOXXOXXOXOXXXOOOOXOXXOOOXOOXOXOXOOOXOOO
OXXOOOXOXXOOXXOOOOOOOOOOXXOOOOOOOOXXOOXOOOOOOOXOOOOOOOOOXXOOXOOOOOOOOXOOOOOOOOOOXOOXXOXOOOOXOOOXOXOOO
XOOXOOOXOXXOXOOXOOXXXOXOOOOOOOXXOOOOOOOOXXOXXOOXOXXOOXXOXOXOOXXOOXOOOOOOOOOOOOOOOOOXXXOXOXOXXOXOOOOOO
OOOOOOOXXOOOOOXXOOXOOXXXOOXOXOXOOOXOOXOXXOOOOOXOXOOXXOXOOXOOXOOOOXXXOOOOOXXOOXXOOXOXOOOOOOXXOOOOXXOOO
XOXOOOXOOOOOOXOOOOOXXOOOOXOOOOXOXXXOOOOOOOOXOOOOXXOOOOOXOXXXXXOXOOXOXXOOXOXOXOOOOXOXOOOXOOXXXOOXOOOOO
OOOOXXOOOOOOXOXOOOOXXOOOXOOOOXOOOOOOXOOOOXOOXOXOXOXOOXXOOOOXOOOOOXXXOOOOOOOOXOOXOOOOOOOOOOXOXXXOXOOOO
OOOXOXOXXOOOXXOOOOOOXOXXXOOOOOOOXOOOXXOOOOXOOOOOOOOXOXXOOOOOXOXXOOOOOOOXOOOOOOOXXOOOXXOOXXOOOOOXOOXOX
XXOOOXOOXOOOOXOOOOOOXXXOXXOOXOXXOOOXXOXOXOOXXXOXOOOOOOOXXXXXXOOOOOOOOOOOXOOXOOOOOOOXOOOOOXOOOOOOOOXOX
XOXXOOOOOOOOOOOXOOXXOXOXOOOOXXOOOXOOXOOOOOXOOOXXXOOOOOOXOOOOOOOOXXOOXOOXXOOOXOOOOOOOOOXOOOOOXOOOOOOXX
OOOOOOOOOXOOXOOXOOXXXXXOOOXOOOOOOOOXOOOOOOXOXXXXOXOOOXXOXOOOXXOOXOXOOOXXOXOOOXOOOOOOOOOXXOOOOXOXXOOOX
OOOOOOOOXOOOOOOOOOOOOXXXOOOXOXOXXOOOOOOOOXOXOOOOOXOOOOOOOOOXOOOXOXXOXOXOOXOOXOOOOXOXXOXOOOXXXOOXOXOOO
OOOOXOOOXXOOXOXXOOOOOOOOOOXOOOXOOXOOOXOOOOOOOOXOOOOOXOXOOOOOOXOXXXXXXOOXXXOXOOOOOOOOOOOXOOOXOOOOOXOXO
XOXOOOOOXOOXOXXOOXXXXXXOXOXOXXXOOOOXOXOOOOOXOOXXXXOOXOOOOOOOOOOOOOXXOOOXOXXOXOOXOOOOOOOOOOOOXOXOXOXOO
OOOOOOOOXOXOOOXOXOOXXOOOOOOOOOXOXXOXXOXXOXOXOOOOOXXOOXXXXOXOOXOOXXOXOXOOOOXOOOOOOOOXOXOOOOXXOXOOOXOOO
OOOOOOXOOOOOOOOOOOOOOOXOOXOOOOOXXXXOXXOOOXXOOXXXOOXXXOOXXOOXXXOXOOOOOOOOOOOOOXOXOXXOOOXOOXOOXOOOOOXOO
XXOOOOOOXOXOOOOXOXOOOOOOOOOOOOOXXXOXXOOXXXXXOOOXOOOOOOOXXOOXXOXXOOOOOOOOOOOOOXOOXOOOXXOOOOOXXOXOOOOOO
OOXOXOOOXOXOOOOXOOOOXOOXOXXXOXXXOXOXOOXOOOOOOXOOOXXOXOXXOXXOXXXOXOXXOOOXOOOOOOXOOOOOOOOOOXOOOOXOOXOOO
OOOXOOOXOXOOXOXOOOXXXXOOXOOOOOOOOXXOOXOXOOXOXOOXXOXOOXOXOOOXOOOOOXXOOXOOOXOOXXOXOOOOOOOOOOXOOOOOOXOXO
OOOXXOXOXOXOOOXOOOOOOXOOOOOOOXXXOXOXXXXXXXOOOOOXOOOOOOOOOOXOOXOOOOOOXXOXOOOOOXXXOOOOXOOOXOOXOOOOOXXOX
XXOOOOOXOOXXOOXOXOOOOXXXXOOOOOOOOOOOOOOOOOXOOOOOOOOOOOOOOOOXXOOOOOOXOOOOOXOOXXOOOOOXXOOOXOOOOOOOXOOOO
OOOOXOXXXXXOOOOOXOOOOOOOOOOOOOOOOOOXOOOXOOOOOOXOOOOOOXOXOOOOOXXOOOOOOXOOOOOOXXOOOOOXXOOOOOOOOOOOOXOOO
OOOOXOOOOOOOOXOOXOXOXXXOOXOOXOXOOOXXXOOXOOXOOOXXOXOOOOXXOOOOXOOOOOXXOOOXOOOOXOXXXOOOOOOXOOOXOOOOOXOXO
OOOOXXXXOOXOOOOXOXXXXOXOOOXOXOXOOOOOOOOOOOOXXOXOXXXOXOOOOXOOOOOOOXXOXOOOOOXOXOOXOOOXOOXXXOOOXOOOOOOXO
OXXOOOXOOOXXOXOOOOOXXXOOOOXOOOOOOXOXXOOOXXOXOXOOOOXOOXOOOOXOXOOOOOOOOXXOOOOOOXOXOXOOOXXOOOOXOOXXOOXOX
OOXOOXOOOOXOOXXXOOOXXOXXOOOXOXOOOOOOXOXXOOOOXXXOOOOOXOOOOXOXOOOOOXXXOOOXOOOOOOXXOXOOOOXXXOOXXXOOOOOXO
OOOXXOOXOXOOOOOOXOXOXXOOXOOOOOOOXOXXOOOOOOOOXXOOOOOXOOOOXOOOOOXXOOXOOXXXOXXOOOXXOXOXXOXOXOOOXOOOOOOOX
OOOXOOXOXOOOXOXOOOOXXOXOOOOOXOOXOOOXXOOOOOXOXXOOOXXOOOXXOOXOXOXOOOXOOOOXOOXXXXXOXOOXOXOOOXOXOOOXOXOXX
OOOXOOXOXXOOXXOOXOXOXXOXXOXOOOOXOOOOOOOXXXOOOOOOOXOOOOXOOOOXOXOOOOOOOOOOXOXOOXOOOOXOOOOOXXOOXXXOOXOOO
XOOOOXOXOOOOOOOOOOXXXOOOXXOXOXXXOOOOOXOOOOOXOXOOXOXXOOOOOOOOOXOOOOOOOOOXOOXOOOXXOOOOOXOXOXOXXOOOOXOXX
OOOOXOOXOOOOOXOOOOOOOXOOOOOOOXOXXOOOOOOOOOXOOOXXXOOOOXXOOXOOXOOOXOXXOOXOOXOOOOOOOOOOOOOOOOOOOOOOOOOOX
OXOOOXOXXXOOXOOOXOOOOOOOOOOXOOOXOOXOOOOOXXOOXXOOOXXOOOXOOOOOOXOOXXOOOOOOOOOOOOOOOOOXOXOXOOOXOOOOXOXXO
XOOOOOOOOXOOOOOOXXXOOOOOOXOOOXXXOOOXOOOOOOOOOXOXXOOOOXOOOOOOOOOOOXOOOOOOOOOXOOXOXOXXOOOOXXXOXOXOOOOXX
OOOOXOXOXOOOXOXXOOOOOOOOOOOOOOOOXOOOOOOOOOOOXOXXOOXOOOOOOXOOOOOXXOOXOOOOOOXOOOOOOOXOOOOOOOOXXXXOOXOOX
OOOOOXXXOXOOOOOOOOOOOXXOOOOOOXOXOXOXOXXOOOOOOOOOOOOOOOOOOOOOOOOXXXOOOOOOXOXOOOOOOXXXOOOOXXOOXOXOOOOOO
OXOOOOXXXOXOOOOXOOXOOOOXOOOOXXOXXOOXOXXOXOOOXOXXOOXOOOOOXOOOXXOXOOOOOOOOOOOXXXOOXOOOOOOOOOOOOOOXOOOOX
XXXXOOOOXOOOXOOOXOOOXOOOOOOXOOOXOXOXXXOXOOOOOXXOOOOOOXOXOOOOOOXOXOOOOXXXOXOOXOOXXOOXXOOOOXXOXOXOXOOOX
XXOOXXOXOOXOOOXOOOOOOXOXXOXOOOXOOOOXXXOOOXOOOXXXOOXOOOOOOOOOOOOOOXOOXXXOXXXOOXOXOXOOOOOXOOOOOXOXOOOXO
XXOOOOOXOOOOXOOXXOOOXOXOOOOOOOOOOOOOOOOOOOOOOXXOXXOXOOOOOOOXOOOOXOOXOXXOOOXOOOOXOOOOOOOOXOOOOXOOOOXOO
OOOOXXOOOOOXXOOOOOOOXXOOXXXOOOXXOOOOOXOOOOXOOOXXOOOOOXOOOOOXOOOOOXXXOOOOOXOOOOXOOOXOOOOOOOOXOXOOXOOOO
OOXOOOOOOOOOOOOOOXOOOXOOXOOXOOOXXOXXOXOOOOXXXOOXOOOXOOOOOXOXOXOOOXOOOXOXOXOOOOOOOXOOOXOOOXOOOOOXXXOOO
OOOOOOOXXOOXOXOOXXXXXXOOXOXOOOXOXOOXXOOOOOXXOXXOOXOXOXOOOOOOOXOOOXXOOOOXOOOOXOOOOXOXOXOXOOOOXOXOXXXXO
OOXOXOOOOOXOXOXXXXOOXOXOOOOOOXOOOOOOXOOOOOOXOOOXOOOOXOOXOOXXOOXOXXOOOOXOOOOOOOXOXOXXOOOOXOOXOOOOOOOOO
XOOOOXOOXOXOXOOOOOXOXOXXOOOOOOOOOOOXXOXOOXOOOOOOOOOOOOOOOOOOOOOOOOOOOOXOXOOOOXOXOOOOXXXXOOXOOOXXOXOXO
XOOOOOOOXOOOOXOOOOOOXOOOXXOOXXOOOOXXXOOOOOXOXOOOXOOOOXOOXOOOOOXOXOOXOXXXXOOOXOOOXOOXOOOXOOOOXOOOOXOOO
XOXOOOOOOXOOXOOOOOOOOXXOOOOXXOXOXOOOOOOOOOOOOXXOOOXOOOOOOXOOOXXXXOOOOXOOOOOOOXOOOXXOXOXOOOOXXOXOOXXXX
OOOOOOOXOOXOOOOXOOXOOOOXOXOOOOXOXOXOOOOOOOOOOOXOOOOXXXOOXOOXXOOOOXOXOOOOOXOOXXOOOOOXOXOXXOOOOXXXOXXOO
OOOOOOOOOOOXXOXOXXOOXXOOOOOOOXOXOOOXXXXOXOOOOOXOOOXOOOOXOOOXOOOXXOOOOOOOXOXOOOOOOXOXXXOOOOXOOXXXOOXXO
OOXOXOOXOOOOXOOOOXOXXXOOOOOXOOOXOXOOOXOOOOOOOXOXXXXOXXOOOOOOOXOOOXOOXXOOOXOXOOXXOXOOXOXOOOOXOOOOXOOXO
XOOOOXOOXOOOOXXXXOOOOOXXOOOXXXXOOOOOOOOOXOOOXOXXXXOOOOXOXOOXOOOOXOOXOOXOXOOOOOOOXOOOXOOOXOXOXOOOOOXXO
OXOXOXOOOXOOOOOOOXXXOOXXOXOOOXOXOOOXOOOOOOOXOOXXXOOXOXXOOXOXXOOOXOOOOOOOOXOOXOOOOXXXOXOOXOOOXOXXXOOOO
XOOOOOOOOOOOOOXOOXOOOOOXOOXOXXOXOOOOOOOXOOOOOOOOOXXOXOOXOXXXXOOXOXOOXXXXXOOXXXOOOOOOOOOOXXXOOOXOXOXOX
OOXOOOOOXXXOOOXOOOOOXOXOOOOOOOOOXOOOXOOOOXXXOXXXXOXOOXOXOXOOOXOOOOOXXOOOOOOOOOXXOXOOOOXOOXXOXOXXOOOOO
XOOOOOOOOOOOXXOOOOXOOOXXXOOOXXXOOOOOXOOOXOOOOOOXXOXOOXXOOOOXXOOXOXOOOOOOOOOOXXXOOOOOXXOOOOXXXOOOOXOOO
OOXXXXOXXXXXOOOOOXXOXOXOOOOXOOOXOOOOOOOOOOXOOOXXOOXOXXOOOOOOXOXOOOOXOOOXOXOXOOOXOXOOOXOOOOOXOOOOOOXOO
OOOOXXOXOXOOOOOOOOXOOOOXXXXOOOOOOOOXXOOOXOXOXXOOOXOOOOOXOXOOOXXOOXOOOOXXOXOOXOXOOOOOOOOOXOOOOXXOXXXXO
OOOOOOXOOOXOOXXXOOOOOOOOOOOXOOXXOOOXOXOOOOOOXXOOOOXOXXXOOOOOOOOXXXXOXOOXOOXOOOXOOXOOXOOOOOOOOOXOXXOOO
XOXOOOXOXXOOOXOOXOOOOOOOOOOOXOXOOOOXOXXXOOOXOOOOXXOOOOXOXOOOOOOXOOOOXOOOOXXOXXXOOOOXXXOOOXXOOOOOXOXXO
OXXXXOOOOOOXOOOOOOOOOXXXOOOXOOOOOOOOXOOOOOXOOOXXXXXOOOOXOXXOOOOXXOOOOOOOXOOOXOOOOOXOOOXOXOOOOOOOXOOOO
XOOOOOOOOOOOXOXOXXXOOOOOOOOXOOXXOOOXOOOOOOOOOOOOOXOOOOOOOOOOXXOOOOOXOOOOOXOOOOXOOXXOOOOXOOOXXOOOOXXOO
OOOOOOOOXOOOOOXOXOXXOXOXOOXOOXOOXOOXOOXOOOOOXOOOOOOOOOOOOXOXOOOXOXOOXOOOOOOXXOXXOOOOOOOOXXOOOOOOOOOOX
OXOOOOOOXOOOXOOOOOOOOXXOOOOOOOOOXOOOOXOOXOXOXOXOOOOOOOXOXOXOOOOOOOOXOOXOOOOOXXXOOXOOXXXXOXOOXOXXOOXXO
XOOOOOOXOOOXOOOOOOOOOOOXOOXOXOXOOOOXOOOOOOOXOOOOOXOXOOOOXOOXXOXOOXOXOOOOXOOOOXOOOOOOXOOOOXOXOXXXOOOOO
OOOOOOXXOOOOOXOOOOOOOOOXOOOXOOXOOOOOXOOXOOXOXXOOOOOOXXOOXOOOXOXOXOOOXOOOOOOXOXOOOOOOOXOOOOOXXXOOOXOOO
XOOOXOOXOOOOOOXXXXOXOOXOOOOOOXOXXOOXXOOOOXOOOOXOOXXOOOOOOOXOOXOOXXOOOOOXXOOOOXXOOOOXOXOXXXOOOXOOOOOOO
OOOXOXOOXOOXOXOOOOOXOOOOOOXXOOOOXOXOOOXOOOOOOOXOXOOXOOOOXOXOOOXOOXXOXOOOOOOOOOOXOXOXOOXOXOOOOXOOOOOXO
OXOOOOOOOXXXOOXXXXOOOOOOOXOOOOOXXOOXOOOOOOOOXOOOOOXOXOXOOOXXXOXOXXXXXOOOOXOOOOOXXOOOOXOXXOOOXXOXOXOOX
XOOXXXXXOXOOOXXOOXOOOXOOXOOXOXOOOOOOXOOOOXOOOOXOXOOOOXOOOXOOOOXXOOXXOXOXOXOOXOOOOOXOOXOOOXOXOOOOOOOXO
OOXOOOOOXOOOXOOOOOXOOOOOXOOOXOXOOOXOXXXOOXOOOOOOXXXOOOXXOXXOXXOXOOOOOOXOOXOOOOOOXOOOOXXOOOOXXOOOXOOXX
OXXOOOXOOXXOOOOOOOXOOOOOOOOOXOOOOXOXXOOOXOOXOOOXOOOXOXOOOOXOXXOOXOOOOOOXOOXOOOOXXXXOOOXOOOOOXOOOOOOOO
OXOOOXXXXOOXXOOOOOOOOOOOOOXOOXXOXOOXXOOOXOOOOOOOOXXOOOOOXOOXOOXOXOOOXOOOOOXOOXOOOOOOOXXOXOXOXOOOOOOOO
XOOOXOXOOOOOOOOOXXXOOOOXOXOXXOOOOOXXOOXOXXOOOOXOXOOOXXOOOOOOOXOOOXOOOOOOOOOOOXXOOOOOXOOOXXOXOOXOXOOXO
OXXOOOXOOOXXXOXOOOXOOOOXOOXOXXOOOXOOXOOOXXOOOOOOOOOXOOXOOOOOOOXOOOXOOOOOOOOXXOOOXXOOXXOOOXXXOOOXOXOOX
OOXOOXOOOXOOOOOOXOOOOOOOOXOOOOOOXOOOXXOOOOOOOOOOXOOXOXOOXXOOXXOOOOOXOOOXXOOXXOXXXOOXOOOOOOOXOOOOOOOOO
OXOOXXOXXOOOXXXXOOOOXOOOOOOOOOOOXXOOOXOOOXXXOOOOOOOOOXXXOOOOOOOOOOOOOOOXOOOXOOOOOOXOXOOOOXOXOOXOOXOOO
OXXXXOXOOOXOOOOOOOOOOXOOOOOOOXOOOOOOXOOOXOXOXXOOOOOXOOOOXOXOOXXXXXXOXXOOOOOOOOXXOXXXOXXXOOXOOXOOOXOXX
OXOOXXOXOOOOOOOOOXOXXOXXXXOXXXOXOOXOOXOOOOOOOOOOOOOOXOOOXOOOXOOOOOOOOOOOXOOOOOOOXOXOXXOXOXOOXOOOOOOOO
OXOOOOOXOXOOOOOOXXOXXOOXOOXXXOOOOXOXOOXOOXXOOOOOOXXXOOXXOOOOOXOOOOOOOXXOOOOOOOOXOXOOXXXOXOOOOOXXOOOOO
OXOOOOOOXXOOOOOXOOOOOOOOOOXOOOOXOOXOOXOOOOOOOOXXOOXOOXOXXXXOOOOXXOOXOOXXOXOOOOOXOOOOOOOOOOXOOOXXOOOOO
OOOOXOXOOOOOOOOOXXOOOXXXOXXOOOOXOOOOOOOOXOOOOXOOXOOOXOOOXOXOOOOOOOXOOOXOOXOOOXOOOXOOOXOOXOXOOOXOOXOOX
OOOXOOXOOOXOXXOOOOOOOOXOOXXOXOOXOOOOOOOOOXXOOOOOOXOOOXXXOOOOOOXXOOXOOXXOOXOOXOOOOXXOOOOOOXOOOXXOOOOOO
XOXOOOXXXXOOOOOOOXOOOOOOXOOXOXOOOXXOXOOOOXOXOOOOOXXOOOOXOXXXOOOOOXOXXOXOOXOOXOOXXOXOOXOOOOOOOOXOOOOXX
OOXXXOXOXXOOOOOOXOOOXXOOOOOOOOXOOXOOXOOOOOOOOOOOXOOXOOOXOOXOOXOOOXOOOXOOXOOXOOXOXXOOOOXXXOOOXXOOOXXXO
OXXOOOOOXOXXOOOXXXOXXOOOXOOOOOOXOOXOXOOXOOXXOOOXOOXOOXOOOOOXXOXOOXOOXOOOOOOOOOXOOOXXOOOOOOXOXOXOXOOOO
OOOXOOOOOOOOOXOOOOOOOOOOOOOXOXXXXOOOXOXOOOXOOOOOOXXOOOXXOOXOOXOOXOOXXOXOOOXOOOOXOOOOOXXOOOOXOOOOOXOOO
XOOOOOXOXOOXXXOXOOOOOOXXOOXXOXXOOXOXOOOXXOXOOXOXXOOOOXOOOOOOXXOXXOOOOOOOOOOXXOOOXXOOXOOOOOOOXXOXOOXOX
OOXOXOXOXOOXOOXOOOXXOOOOOOXOXOOOOOXOOOOOXOOOXOOOXOOOOOOOXOOOOXOOOOOXOXXOOOOOOOXOXOXOOOOOXOOOOXOOOOOOX
OXOOOXOOOOOOOXOOOOOOOXXXXOXOOOXOOOOXXOXXXOOOOOOXOOOOOOXOXOXOXOXXOOOOOXXXOXOXXOOXOOXXXXXOOXXOOOOOOOOOX
XXXOOOOOOOOOOOOOOOOOOXOOXOOOOOXOXOXXOXOOXXOOOOOOOXOXOXOOXOOXOOOOXOXOXXXOOXXXOXXXOXXOOOOOOOOXOOOOOOOOX
OOOXOOOOOOOOXXXXOXOOOOOOXOOOOOXOXXOOXXOOOOOXOOOOOOOXXOOXXOOXOXOOXOOOOXOXOOOXOOOOXXOOOXXOOOOOXOOOOOOXO
OOXOXOOOOXOXXOOOOOXXOOOOOOOOOOXOOXXOXOOXXOOXXOOOOXOXXXXOOXOOOXOOOOOOOOOXOOOXOXOOOOOXXXOOOOOXOXOOOXXXO
OXXOOOXOOXOXXOOOOOOOXXOOOXXXOOXXOXOOOXOOOXOOOXOOOOOOOOOXXOOOXOXOOOXOXOOXOXXOXOXOXOOOXOXOXXOOOXOOOOOOO
XOOOXOXOOOXXOOOOOOOOXOXOXOOOXOOOXXXOXOOOOXOOOXOOOOOXOXXOOXXOOOOXOOOOXOOOXXOOXXOXOOXXOOOXXOOXOOOXOOXOO
OXOXXXXOOOOOOXOOXOXOOOOXOOOOXOXOOOXOOXXOOOOXOOXXXOOOOXOOOOOOOXXOOOOOOOOXOXOXXOOXXOOXOOOXOOXOOOXOOOOXX
OXXXOXOXXXOOOOOXOOOXOOXXOXOOXXOOXXOXOOOOOOOOXOOXOOXOOXOOXOOOOOOOOOXOOOOOOOOOXOXOOOOXOXOOXOOOXOOOXOOOX
XOXXXOOOXXOOOXXOOXXOOXOXXOOOOOOOOOOXOOXOXXXOOOOOOOOOOOOOOOOOXOXXOXXOXXOOOXOOOOOOOOOOXOOXOOXOOOXXOOOOX
OOOXOOOOOXXXOOOXOOXOOOOOXOOOOXOOOOXXOOOOOOOOXOXXOOOXOOOXOOXOXOOXOOXOXOXXOOXOXOOOOXOOOXOXXOOOOOOOOOXOO
XOXOOOOOOXXXOXOOXOXOXXOOOOOOXOXOOOOXOOOOOXOOOXXXXXOXOXXOOOXOOOXOXXOOXXXXOOOXOOOOOOXOXOXXXXOOOXXOOOOOO
