OOOOOOXOOOOOXXOOOXOOXOXOXOOOOOOXOOOXXOXXOXXOOXXXOOOOXOOOOXOOOOOOXOXOOOOOOOOXOOOOXXOOXXXOOOOOOXXOOOOXX
OXOXOOXXOXXOOXOOXOOOOOOOOOOOOOOOOOOOOOOOOOOOXXOXOOOXOXOXXOOOOXXOOXOOXOOOOXOOOOOXOOOOOOXXOOOXOOXOOOOOO
XXXXOOOOOOXOOOXXOOXOOOXXOXOOOOOXOXOOXXOOOXOOXOOOOOOOOXXXXOOOOOOOOXOXOOOXXXXOOOOXOXOOXXOOOOOXOOXOOXOOX
OOXOOOOOOOOOXOXXOOOOOXOOOOXOOOXOXOXOOOXOOXOXXOOOOOXXXOOOOXOOOOOOXOOXXOOXOOOOXXOOOOXOXXXOOXOOXOOOXOXOX
XXOXXXXOXOOOOOOOOOOXXOOOOXXOOXOOXXOOXOOOOOXXXOOOXOOOOXOXXXOOXOOOXOOOOOXXOXOXXOOOOOOOOOOOOOXOOXXOOOOOO
XOOOOOXOOXOOOOOXXOOOOXOXOOOOOOOXOOXOOXOXXXXOXXOOOOOXXOOXXXOOXXOXOXOXXOOOOOOOOXOOOXOXOOOOXXOOOOOOOOOOO
OOOXOOOXXOOOOOOOXOOXOOXXOOXOOXOOXXOXXOXOXXXOOOOOXXXXOOOOOOXXXOXXXOOOOOXOXXOOOXXOOOXOOXOOOOOXOOXXOOOOO
OOOOOOXXXOOOOOOXXXXOOXOXOOOOXOXXXOOOOOOOOOXOXOOOXXOOOOOXOOXOOXOOXOOOXOOOOXOXOOOXXOOOOXOXXOXOXXOXOXOXO
XOOOOOOOOOOOOOOXOOOOXOOOXOOOXOXXOXXXXXOOXOXOXOXOXOXOOXOXOOOOOOXOOOOOXOOOXOXOOOOOOXXOOXXOOOXOOOOXOOOOO
XOXOOOOOOOOOXXOXOOOOOXOXOXOOOOOXOOOXOOOOOOOOOOOOXOXXOOOOXXOOOOXOXOOOOOOOXXOXOOOXXOOOXXXOOXOXOXOXOXOXO
OXOOOOXXOOOOOXOOOOOOOXOOXOOOOOXOOOOOXXXXOOXOOXOOOOXXXOXOXOOXOOOOOOOXOOOOXOOXOOXOOOOXOOOOOOOOOOOOXXOOO
XXOOOOOOOXOOXXOXOOOOXOOOOXXXXXOOOOXXOXOOOXXOOOOOXOOXOOOXOXXOOOOXOOXOOOOXOXXOOOXOXXOOOOOOXOXOOOXXOXOOO
OOOOXOOOOOOOOXXOOOOXOOOOOOXOOOOXOXOOOOOOOOOOOOOOOXOOOOXOOOOOOOOXOOOOXXOOOOOOOXOOXOOOOOOOXOOOOOOOXXOOX
OOOOOOOOOXOXOOOOOOXXXOOXOOOXXOOOOOXOOXXOOXOOOOOOXXOOOXXOXOOXOOXXOXOOOXOXOXXOXOOXXXOXOXOOOOOXXOXOOXOOO
OOXOOXOXXOOXOOXOOOXOOOXOOOOOOOOOOOOXOXOXOOXOOOOXOXOXOOOXOOXOOXXOOOOOXOOOOOOOOOOXOOOOXOOOOOOOOOOOXXOXO
OXOOOOXOOOOOXOOXOXOOXOOXOXXOOOOOXOXOOOOXXOOXOOOOXXOXXXOOXXOXXXOOOOOOOOOOXOOOOXOOOOOOOOXXOXOOXOOOOOXOO
OOOOXOXXOOOOOOXOOOOXOOOXXXXOOXXOOXXOOXOOOOOOOOXOOOOOOXXXXOXOOOOXXXXOOOOOOOOOOOXOOOOOOXOOOOOXOXXOOXXOX
XOXOXOXXOOOOOOXXOXXXOOXXOOXXOOXOOXXOOOOXOOOOOXOOOOOOOOOOOXXOOOOOOOOOOOXOOXXXOOXOOOOOXOOOOXOXOXOOOOOOX
XXXXOOOXOOOOOOOOOOOOOXXOOOXOOOOOOOOOOXOOXOXOOOOXOOOOOOXOXOOOOOOXXOOOOOXOOOOOOXXOOXXOOXOXOOOOOXOOOXOOO
XOXOOOOXOXXXOXOOOOXOOOXOXXXOXXOOOXOXOXXOOOOOOOOOOXOOOOOOOOOOOOXOOXOOOOOXXOOOXOOXOXOXOOOOOOOOOOXOXOOOO
XOOXOXOOOOOOOOOOOOOOOOOOXOOOOXOXXXOOOOXOOOOOOOOOXOOOOXOOOXXOOOOOXOOXOOXOOXOOOXXXOOOOOXXOOOXOXOOOXXXOO
OXXOOXXOOOXOOOOOOOXXOOOOOOOXOOOOXXOXXOOOXOOOXOXXXXOOOOOOXOOOOOOOOOXOXOOOXXOXOOOXXXXXXOOOXOXOXOOXOXOOX
OOXOXOXXOXOXXOOXOXXOXOOXXOOOOXOOXOOOOOXOOXOOXOOOOOOOOOOOXXOXOOXOOXOOXOOOXOOXOOOOOXOOOXXXOOOXOOOOOOXOO
OOXXXOXOXXXXXOOOOXOOOOOOOOOXOOXXOOOOOOOOOOOOOXOOOOOOXOXOXOXOOXOOOXXXXOOOXOOOOOOXOXOOOXXOXOOXOOOOXOOXO
OXOOOOXOOOXXOOOOXOXOOXOOOXOOOOOOXOOXOOXOOOOXOOOOOOOOOXXXXXOXOOXOOOOOOXOOOOOOXOXXOOOXOXOOOOOOOOXXXXXXX
XXOXOOOOOOXOXXOOXOOXOOOOOXOOXXOOXOXOOOOOOOOOOOOOOOOOXXOXXXOOOOOOXOOOOOXXOXOOOXOXXOXOXXOOXOXOOXXOOOXXO
OXOXOOOXXOOXOOOOXXOOOOXOOXOXOOOOOOXOXOXOOOOXOOOXOXOXOXXOOOOXOOXOXXOOOXXOXOOOOOOXOOOXOOOOXOOOOOOXOXXOO
OOOXOXOOXOOOOOOOOOOOOOOOOOOOXOOOOXXOOOXOXOOOOXXOXOOXOOOXOOOXXXOOOXOOXOOOOOXXOOOOXXOOOXOOOXOXOXXOOOXXX
OOXOOXOOXOOOOOOOXOXXXOXOOOXXOOOOOOOXOOOXXXOOOOXOOOOOXOOOOOOXOOXXXOOXOXOXOOOOOOXXOOOOXXOOOOOXXXOXOOXOO
OXXOXOOXOOOXOOXOOXOOOXXOXXOOOOOOOXXOOOOOXOOXOOOOXXXOOOOOOOXOXOOOOXXOOXXXOOOOOXOOOXOXOOOOOOOOOOOOOOOOO
OOOXXXXXOOOXXOOOOOOOOOOOOXOOXOOXOOXOOOOXXOXOOXOXOOOXXXOXOOOOXOOXOXXOOXOXXOXOOOOOOOOOOXOOXOOOXXXOXOOOO
OXOXOOOOOOOOXOOOXXOXOXOOOOOOOOXOXOXOOXOOOXOOXXXOOOOXOOOOXOOOXOOXXXOOOXOOXOOOOOOOOOXOOOOXOOOOOOXOXOXOO
OOXOOOXOXOOOOOOOOXOOOOXXXOXOOOXOXOOOOXOOOOOOXOXXOOXOOOOOOOOOOOOOXOXOOOOXOOOOXXOOXXOOXXOOOXOOOXOXOXOXX
OOOOOOXOXOOOXXOOOOXOOOOOOXXOOOOOOOOOOOOOOXXXXXOXOOXOOXOOXOOOOOOOXOXOOOXXOOOOOOOOXOOXXOOOOOXXOXOOXXOOO
XXOOOOOXOOOXXXOOOOOOXOOOOOOXOXXOXXXOXOXXXXOOOOOOOOOOOXOXXOOOXXOOOOOOOOOOXXOOOXOXOOOOOXXOOOOOXOOXXOOXO
OXXOXOOOOXOOXOOOXXOXOXOOOOOOXOOOXXOXOXOOOOOOOXXXOOOOOXOOOOOOXOOOOOOOOXOOOOXOOXOXOOOOOOOOOOOXOOXXOXOOO
OOOOXOOOOOOOOXOOXOXOOOOOXOOOOXOOOOXOOOXXOOXOXOXXOOXXOXOOOXOXOXXXOOXOOOXOXOOXOXXXOXXOXOOOOOXXXOXOXOOXO
OXXOXXOOXOOOXOOXXOXOOOOOOOOOXOOOXOOOOOOOOOXOOOOXOXOOOOXOOOOOOOOOOOOOOXOOOXXOOOXXOOXXOOOOOOOOXOOXOXOOX
OXOXXOXOOXXOOOXOOXXOOOOOOXOOOXOOOOXXXOOOXXOOOOXOXXXOOOOOOOXXOOXXOOXOXXOXOXXOXOXOXOOOOOOOOOXXXOXXOOOOO
OXOOOOOXOOXOOXOXXOOOOOOOOOOOOXOOOOOOXOOOOXOXOOOXOOXOXXOOXOXOOOOXXOOOOOOOOOOXXXXOOOXXXOOOOOOXOXOOOOOOO
OOOOOXOOOOOOOOOXXXOOOXOOOXOOOXOOXOOOOOOOOOXOOOOOOXOXOXOOOOOOXOOOXOOOOOOXOXOOOOOOOXXOOOOXOOXXXXOOOOXXO
XXOXOOXOXOOXXXXOOOOOOOOOOXXOOOXXOOOXXXOOOXXOXOOOOOXOOXXOOOXOOOOOOOOXXOXOOOOOOXXOOOOXXXOOXXOXOOOXOOXOO
OOOOOXOOXOOOOXXOOOOOOXOOOXXOOOXOOOOOOOOOOOXXOXOOOOOOXOXOOXXOOXOOXOOOXOOOOXOOOOOOOOOXXOXOXXXXOOOOXOOOX
OOOOOOOOOOOOOOOOOOXOOXOOOOOOOOXOOXOXOXOOXOOOOXOOOOOOXOXOOOOOOXOOXOXOOOOOXXOOXXOOOOXXOOOOOOXOOOXOOOOOX
OOXXOOXOOXXXXOOOXOOOOXXOXOOXXOXOXOXOOOOOOXOXOXXXXOOXOXOOOOOXOOXOOXOOXOOOXOOOOOOOOOOOOOOXOOXOOXOOXXXOO
OOOOOXOOOOOOOOOOXOOOXOXOXXOXOOOXXOOOXOXOXOXOXOXXOXOOXOOOOOOOXXXOXXOOOXOXOOOOXOOOOOOOOOOXXOXXOOOOOOXXO
XOOOOOOOOOOOOOOOXXXOOOXOXOXOOOOOOOOXXOXXOOXXXOOXOXOOOOXOOOOOXXOOXOXXXXOXXOXOOOXOXOOXOOXOOXOOOXOOXOOXO
OOOOXXOXOXOOOOOXOXOXOOOOOXXXOOOOOXXOOOOXOXOXOOOXOOOXXXOOXOOXXOOOOOXOOOOOXOXOOXOOOOOXOOXOOOOOOXXOOXOXX
OOOOXOOOOXOOOOXOXOOOOXOXXOOOOOOXOXOOXOXOXOOOOXOOOOOOXOOXOOOOXOOXXOOOXOXOXOOOXOXOOXOOOXOOOOOOOOOOOOOOO
OOOOOOXOXOOOOOOOXOXOXOOOOOXOOOOXOOOOOOOXOOOOXOOOXXOOOOOXOOOXOOOXXOOOOOOXOOXOXXXXXXOXOXXOXOXOOOXOOOOXO
XOXOXXOOXOOOOOOOXOXOOXOOXOXOOOOOXOOXXOOXOOOOOXOXOOXXXOOOXXOOOOOOOOOOOXOOOOOXOOOXOOOXXXXXOOOXOOOOOXOOO
OXOOOOOOOOOXXOOOOOOXOOXOXXOOOOOOOOOOXXOOXOOOXOOOOXXXOXOXOOOOOOXOXOOOXXOOOOXOOOOXOOOOOOOOXOOOOOOXXXOOO
OXOOXOXOOXOOXOOXXOOOXOXXOOXXOOXXOOOOOOOOOOOOOOOOOOOXOOOXOOXXXOOOOXOXOXOOXOOOOXOXOXXOOXXOOOOXXOOOOXOOO
OOOOOOOXOOOOOXOOOOXOOOXOOOOXOOXOOOOXXOOOOOOXOOOXOOOOOOXOXOOOOOOOXOOOOXOXOXXOOXXOXOOOOOOOOXXXOXOOOOXOO
XOOOXXOXOOXOOOXOOXOOOOOXOOOOOOOOOXXOOOXOOXXXOOOOXOOOOOOOOOXOOOXXXXXXOOOOOXXOXOOOOXOOOOOOXOXOOOOOOOXOO
OOOXOOOOXXOOXOXXOOOOXOXXOOOXOXOOOOOOXOOOXOOOOXOOOOOOOOOXXXOXOOXOXOOXOOOOOXOOXOXOOOOXOXOOOOOXOOOOOOOOO
XOOXXXXOOOOXOOXXXOOXOXOOOOOOOOOOXOOOXXXOXOXXOOOOOOOOOOOXXOXOXXOOOXOOXOOOOOOOOXOOOXXOOXXXOOOXOOOOOOXXO
OXOOXOOOOOXOXXXOXOOXOOXOXOOOOOOXOXOOOOOOXXOXOOOOOXOOOOOOXOXOOOOOXXXOXXOXOOOOOOOOOXOXOXOXOXOOXXOOOOXOO
OOXOOXOOOOXXXOXOOOXOOOOOOXOXXOOOXOOOXOOOXXOOXOOOOOXOXOOOXXOOOOOXXXOOOXXOOXOXOOOOOOOOOXOOOXOOOOOOOOOOO
OXOOOXXOOOOXOOOOXOOOOOXXOOOOXOXOOOXOOOXXOOOOOOOOOXOXOOOXOOOOOOOOOXXOOOXOOOXXOOXXOOXOOOOOOOXXOXOOXXOXO
OXOXOOOOXOOXXOOXOXXOOXXOOOOXOOOOOXOXOXXOOOOOXOOOOXOXOXXOOOOXOOOOOOOXXOOXOOOOXXOOXXOOXOXOXXOXOOXOXOOOO
OOOOOOOXOXOOXXOOXXXOOOXOOOOOOXOOOOXOOXOOXOOOXOOOOOXXOOOOOXOOOXXOOXOXOXOXOOXOXOXOOOOOXOOOOOOOOOXOXOXOO
OOOOOXOOOXOXOOOXXOOOXOXXXOOOOXOOOOOXOOOOOOXXXOOXOXXOOXOOOOOXOXOOXOXOOOOXOOXOOOOOOOOXOOOOOOOOOOOOXOOOO
OOOXOXOOOOXOXOXOOOOOOXOOOOOOOOXOOXOOOOXOXOOOOOOOOOOXOOXOXOOOXXOOXOOOOOXOXOXXOOOOOXXXOOOOOOOOOXOOOXOOO
OOXOOXXOOOXOOOOOOXXOOOOOXOXOOOOXOOOOXOOOOOOOOOXXOOXOXXXOXOOXOOXOOOOXOXOXOOOOOXXXXOXOXXXOOOOOOXXXOOOOO
OOOOOOXOXOOXOOXOXXOOXOXOXXOXXOXXOOXXOOXOXXXXXXXXOOXOOXOOOXOOOOXOXOXOXXXOXOOOXOXXOXOXOXOXOOOXOOOOOOOOO
OXXXOOOOOOXOOOOXOXOOOOOOOOXOXOOXOXXOOXOXOXOOOXOXXXOXOOXOOOOOOOOOXXXOOOOXOOOOOOXOOOOXOOOOXOOOOOOXOXOOX
OOOXOOXOOXXOXOOOXXXOXOOOOOXXXOOOXOXOXOOXOXOXOOXOOOOXXOOOXOOXXOXXOOOOXXOOOOXOOOOXXOOXXOOOOXXOXOOOOXOOO
XOXOOOXOOXOXOOXOOOOXXXOOOXOOOXOOXOOXXXOOOXXOOXOOOOOXOXOOOOXOOOXOOOOOXOXOOXOOOXOXOOXXOOOXOOOOOOOXOOXOX
OXXOOOOOXOXOXOOOXOOOOOOOOOOXXXOOOOOOXOOOOOXOOOOOOOXXXOOXXXOOOOOOOOXXOOOOOOOOXOOXOOOXOOXXOOOOOOXOXXOOX
XXOXOOOXOOOXOOOOXXXXOOOOOOOOXOXOOXOXOXXXOXOXOOXOOOOXOOOXOOOOOXOOOOOXOOOXOXOOOXOOOOOXOOXOOOXOOXOOOOOOO
OXOXOOOXOXOOXOOXXXOXOOXOOXOOXOXOOOOOOXOOOOXXXOXXOXOOOXOOOOOXXOXOOXOOOXXXOOOOOOOOOOOOOOXOXOOOOOXOOOOXO
OOOXOOOOXOXOOOOOXOXOOOOOXOOOXXXOOOOXOXOOOXOOOOOXOOXXOXOXXXOXOOOXXOOOOXOOXOOOOXOXOOXOOOOOOOOOOXOOOOOOO
OOOOOOOOOOXOOXOOOOOXOOOOOOOXOOXXOOXOOOOOXOXXXOOOOXXOOOOOXOOOXOOXOOOOOOXOOOOOOOOOOXOOOOXXOOXOOOXXOOOOO
XOXOXOXXOOOXOOXOOOXOOOXXOOOXXXOOOOXXOOOOOOOOOOOOXOXOXOXXOOOOOXOOOXOXXOOXXOXOOXOOOOOOXOXOOOOXXOXXOOOXX
OOXXOOOOOOXXOOXOOOXXOXOOOOOOOOOXOOXOXOOOOOOOOXXXOOOXOOOOXXOXOXOXOXOOOOOXOOOXOXOOOXOXOXOOOOOOOOOXOOOOO
OOXXOXOOOOOXOOOOOOOOOXOOXOOOOOOOOOOOXOXOOOOOOOOXXOXXOOOXOOXOXOOXOOOXOXXOOOOOXOXOOOOXXOOXOXXXOOXOXOOOO
OXOXXOOOOXOXOOOOXXXOXOXOOOOOOOOOXOOOOOOOXOOXOXOXOXOOXXXXOOOXOOOXXXOXOXOOOXXXOOXOOXOXOOXXOOOOXOOXOXOOO
OOXOOOOOOOOOOXOXOOOOXOOOOOXOOXXOOXOXOOOOOOOOXOOXOXXOXOOOXOOXOOOOXXOXOOOOOXOOOOOOXOOOOOXOOOXOOOXOOOOOX
OOXOOOOOOOXOOXXOOOXOOOOXXOXOXXOOOXOOOOOOOXOOOOXXOOXOXOOOXXOOOOXOOOOXOOOOOOOXOOOOOXOXOXOOOXOOOOOOOXOOO
XOOOOXOOOXOOXOOOXOOOOOOXOOOOOOOXOOOOOOXOXOOXOOOXOXOOOOOXOXOXXXOXOXXOXOOOOOOOOOXOXOXXOOOXOOXOXOXXOOOOX
OOOXOOOOOOXOOOOXXOOOOXXOOOOOXXOOOOOOOOXXOOOOXOXXXOOXOOOOOXOXXOOOOXOOXXXOOOOOOXXOOXXOXOOXOOOOXOOOOOXOO
XOOXOOOOXOXOOOOOOOOOOXOOOOOXOOXXOXOOXOOOXXOOOOOXXOXXXOOXOXXXOXXOXXOXOXOOOXOOOXOXOOOXOXOOOXXOOOXXXXOOO
OXXOOOOOOOXOOOOOOOOXXXOXOOOOOOOXOOOOOXOOOXOXXOOXOOOOOOOOOOOOOOOOOOXOOOOOOOOOOOOOOOOOOXOXXOXXOOOOOOXOO
XOXOOOXXOOOOOOXXOXOXOOXOXOOOXXXOXOOOOOOOOOOOOOOOXXXOOXOOOOOOXOOOOOOOOOOOOOXOOOXOXOXOOOXOOXXOOXOXOOOOO
OOOXOOXXOOOOOXOOOOOOOXOOXOOXXOOOOOOOXOXOOOXXOXXOOXOOXOXOXOOOOOOOOOXOOOXXOXOOOOOOXXOOOOXOOOXXOOOOOOOXO
OOXXXOOOOXOOOXXOOXOXOXXXOOXOOOXXXXXXOXOOOOOOOOXXOOXOOOOXOXXOOOOOXOOOOOXOXXOOOOOOOOOOOOOXOOOOOOOXOXXOO
OOOOOOXOXOOXXOXOXOOOXXXOOOOOXXOOOOOOOOOXXOXOXXOOXXOOXXOOOXOOXOOOOXXOOXOOXOXOXOOXOXOXOXOOOXOOOOOXOOOOO
OOOOOOOOOOOOXOXOOOOOXXOOOOXOOOXOOOXOOXXXXOOXOOXOXOOOOOXOOOXOOOXXOOXOOOOOXXOOXXOOXXOOOOOXXXOXOOOOXXXOO
OOOOXOXXOOOXXXOOOOOOOOOOXOOXOOXOXOOOOOXXOOOOOXOOOOOOOOXOOXXOXOOOOOOOXXOOXXOOXOOOOOOOOOOXOOOXOXXXOOXOO
OXOOOOOXOOXXOOOOOOOOOXOXXOXOOXXOOOXXXOOXOOXXOXOXOOOOOXOOOOXOOXOXOOOOOOOXOXOXOOXOOOOOOXOOOOOXOOXOOXXXX
OOXXOOXXXXXOOXOXOOOOOOOXOOOOOOOOXOOXXOXOOXOOOOOOOXXOOXOOOOXOXOOOOOXOOOOOOOOOOXOOOOOXOOOXXOOOOOOOXOXOX
OOXXXXOOOOOOOXXXOXOOOOXXXOOOOXOOOOOOOOXOXXXOXXOOOOOXXOOOOOOOOXXOOOOXOOXOOXOOOXXOXXXOOOOOOXOOOXOOOXOXO
OXXOOOXOOOOOOOXOXOOXXOOXOOXXOOOOOOOOOOOOXOXOOXOOOOXOOXOXXOXOOOOXOOOOOOOXXXOOOOXOXOOOOOXOOOXXOOOOXXXOO
OOOOOOXOOXOOOXOOXXOXOXOOOXOOOOOOXOOOOOOOXOOOOXOOOXXOXXXXXOXXOOOXXXXOXOXXOXOOOOXOOXXOOOOXOOOOOOOOXOOXO
XOOOOXOXXXOXOOOXOOXOXXOOXXXOOOXOXOXXOOXXXOOXXOOOOOXXXOOOOOXOOOOOOOOXOXXOOOOOOOOXXXOXXOXOOOOOOOOOXXXXO
OOOXOXOXOOOOOXOOXOOOXOXOOXOXXOXXXOOXOXOXOOOXOXXXOXOOOXOXOOXOXXOOXOXXOOOOXOOXXOXOXOOOOOOOOXOOOOOOOOOXO
XOOXOOOOOOOOOXOOXOOOXOOXOOOXOXOXOXOOOOXOXOOOOOOXOXOOXOXOOOOOXOOOOXOOOOOOOOOOXOOOOOOXOOXXXOOXOOOOXOOOO
OOXOOOXOOXXOOOOOOOOOOOOXOOOOOOXOXOOOOOOOOOOOXXOOOOXOOOOOOOXXOOOOOOXOOOXXXOXOXOOOXOXXOXXOXOXOOOOOXOOXX
OXOOOXOOOOOOOOOOOXXOOOXOOOOOOXOOOOOXOXXOXXXXOXOOOOOXOOXXOOXOXOOXOOOOXOOXOXXOOOXXOOOOXOXXOOOOOOOOXXOOO
OXXXOOOXOOOXOOOOOXOOXOOXXOOOXOOOOOXOOOXOOOOOOOOOXXXOXOOOOOOXOOOOOOOOOOOOXOOOOXOXOOOXOXXOXXOXOXOOXXOOO
