OOXOOOXOOOXOXOXOXXOOOOOXOXOOOOOOOOOOXXOXOOXXXOOOOXXXOXOOOOOOXOOOOXOOXOXOXOOOXXOXXXOOOOOXOXOOOOOOOOOOX
OXXXOOOXOOOOOOOOXOOXOOOXOOXXOOOOOOOOXXXOOOXOOOOOOOXOXOXOXXXOXOOOOOOOOOXOOOOOXOOXOXOOOOOXXOXOOOOOXOOOO
OOOOXOOOOXOXXXOXOXOOOXOOOOOXXOOXOOXOOOOOOOOOOOXXXOOXOXOOOOOOXXXOOOOOOOOOOOXOOOOOOOXOOOOOOOXOOXOOXXOOX
OXOXOOOOOOOOXOXOXXOOXXOOOOXXOOOOOOOOOXOOOOOOOOOXOOOOOOOOOOOOOOXOXOXOOOXXOXXOOOOOOOOOXOXOOOOOOXOXOOOXO
XOOOXXXOOXXOOOOOOXOOOOOOOOOXOOOOXXOOOOOXXOXXXOOOXOOXOXOOOOOXOXOOXXOXXOOOOOOOOOXOOOOOOOOOOOXOXXOOXOOOO
OOXXXOXXOOOOOOOOXOOXOOOOXOXOOOOOOOXXXOXOOOOOOOXOXOXOOXXXOOOOOOOOXOOOOOOOOOOOOOOOOOOOXOXOOOOOXXOOOOXXO
OXOOOOOXXXOOOXXOOOXXOOXOXXXXXXOOOOOOOOOOOXOXXOXOOXOOOOOOOOOOOOOOOXOOOOXOOXOOOOOXOOOOOOOOXOOOOXOOOOOOO
XOOOXOOOOOOXOXXOOOOOOOXOOOOXXOOXXXOOOOOOXXXOOOOOXOOOOXOXXXXXOOOXOOOOOOOOOOXOXOOXOOOOOXOOXXOXOOXOOXOOO
OOXOOOXOOXXOOXOOXXXOOOXOOOOOOOOXOXOXOXOOOOXOXXOXXOXOXXOOOOXOOOOOOOXOOOXOXXXOOOOOXOOOOOXXOOOOOOOOOOXOX
OOXOOXOOXOOOOXXOXOOXOOOXOOOOOOOOOXOOOOXOOOXXOOOOOXXOOOOOOOOOOOOXOOXOXOOXOOOOOOXOOOOXOXXXOOXXOXXOOOOOX
XXOOOOOOXOOXOOOOOOOXXXOOXOOXOOOXOXOXOOOXOOOOOOXOOOXOOXOOOOXOOXOOXOOXXOOOOOOXXOOOXXOOOOXOOOOOOOXOXOXOX
XOOOOOXXXOOXXXOOOOOOXXOXXXOOOOOOXXXXOOXOOOOOOXOOOOOOOOOXXOOXOOOOXOOXOOOOOXXOOOOOOOXXOXOOOOOXOOOXXOOOO
OXXOOOOOXXOOOOOOXOOXOOOOOOOXOOXXXXXOOOOXOOOOOOOOOOOOOOOOXOXOXOXOOOXOOOOOOOXOOOOOOOOOXOOXOOOOOOXOOOOXX
OXOOOXOOOOOOOOXOOOXOXOXOOXXOOOOOOOXOXOOOOXOOOXXOOOOOXOOOOOOOOXXXOXOOOOOOOOXXOOOXXOOOXOXXOOOOOOXOOOXOO
OOOXOXOOOOOXOOXOOOOOXXXXOOOOXOOOOXXOOOOOOOXOOOXOOOOOOOOOOOXXOOOXOOOOOOOXXOOXXXXOXOOOXOOXXOXOOOOOOXOOO
XXOOOOOXXOXXOOXOOOXOXOOOOXOXOXOXOOOOOXXXOOOOXXXXXOOOOXXOOOOOOXOOOOOOOOXOOXOOOOOOXOOOOOXOOOXOOXXXXOOXX
OXXOOOOXOXOOOOXOXOOOXOOXOOOXOXOOOOXXOOOOOOOXOOXXOXOOXOOOOOOOOOOOXOOOXOOOOOOXXXOOXXXOOOXOXXXOOXOOOXXOO
OOOOOXXOOXOOOOOOXOOOOOOOOOOOXOOXOOOOOOOOXOXXOOOOOXOOOOOOOOOOXOOOXOOXXOOXOXOOOXXOOOOOOOOOOXXOXOXOOXXOO
OXOOOXOOOOOOOOXOOOOOOXOOOXOOOOOXOOOOXOXOXXOOOOOOOOOOOOOOXXOXOOOOOOOXOOOOOOOOOOOXOOXXXOOOXOXXOXOOXOOXO
OXXOOOOOOOXXOXXOOOOOOOOOXXXOOOXXOOOOXOOOOXOOXOOXXOXOOOOXOOOXOOOOXOXOOOOXOOOOOXXXOOOOOOXOOOOOOOOOOXOOO
OXXXOOXXXOOOOXOOOOOOXOOOXOXOOOOOOOXOOOOXOXOXOOOXXXOXOXOOXOOOXOOOXXXOXXOXOOXOOOOXXXOXOOOXXXOOOOOXOOOXO
XXOOOXOXOOXOOOOOOOXOOXOOXXOXOOXOOOOXOOOXOXOOOOOXOXOOOOXXXOXOOOOXXOOXXOXOXOOOOXXOXXOOOOOOOXOOOXOXOOOOX
OXOXXXOOXOOOOXXOXOOOOXOXOXOOOOOXOOOOOOOOOOXXOOOOXXOOOOOOXOXOOOOOXOXOXOOXOOOXOOXOOOXOOXOOOOOOOOOOOOXOX
XOOOOXOXXOOOOOOOOOXOOOXXOOOOXXOOXOOOXOOOOXXOOOOOOOOOXOXXOXXOXOOXXOXOXXOOXOXOOOXOOOOXOOOOXOOXOOXXOXXXO
OOOXXOOOXOOOXXXXOXOOOOXOXOXOXXOOOOOOXOXXXXOOXOOOOXOOOOXOOOOOOOXOOXXOOXOOXOXOOOXOOXOOOXOXOOOOOOOXOOOXO
XOXOOOOOOXXOOXOOOXOXOXOXOXOOXOOOOOXOOOOOOOOOXOXXOOOOOOOXXOXOOXOOXOOXXOOXOXOXOOXXOOOXOOOOOOXOOOOXOXOXX
OXXOOOOOOOOXOOOOOXOOOXOOOXXOOOOXXXOOXXOXOOOXOXOOOOOOOOOXOOOOXOXOXOOOXXOXXXOOOOOOOXXOOOXOOXXOOXOOOOOOX
XOOOOOOOOOOXOOOXXOOXXOOXOOOOOXOOXXXOOXOXOXXXOOOOXXOOOOXOOOOXXOOOXOXXOOOXXOOOOOOXXOOOOOXXOXOXOOOOOOXOO
OOXOOXXOXOXXOOXOOOOOOOOXOOOOOXXOOXXOOOOOOOOOOXOOXOXXOOOOOXOOOOOXOXXXOOOXOXOOOOOOOOXXOOXOXXOOOOXOOOOOX
XOOOOOOXOOOOXXOXOXOXOOOOOOOXOOOOOOOXOOXOOOOOOOXOXXOOOOOOOOOXOOOOOOOOXOXOOOOOOOOXOOOOOOOOXOOXOOOOXXOOO
OOOOOXOOOOOXOOOOOXOOOOOOOOXOOOOOOOXXOOXOXXOOOOOOXOXOXOOXOOOOOXOOXXOOOOOOOOOOOOOOOOOXOOXXOOXOXOOXOXXOO
OOOXOXOOOOOOOXOOOXOXOXXOXOOOOOOXOOOOXOOXXXXXOOOXOOOXXOXOOXXXXOOOOOXXOOOXOOXOOOOOOOOOOXXOOXOOOOOXXOOOX
OOOOXOOOOOOOOXXOOOOOOOXOOXOXXOXOOOOXOOOXOXXOOOOXOXOXXOXOOOOOOOOXOXOXOOXOOOOXXOOOOXOOXXOOXOXOOOOXXOXOO
OOXOOOXOOXOOOOOXXOXOOXOOOXOXOXXOOOOOXXOOOOOOOXXOXXOXXOOOOOOOOXOXXOXOOXOOOOOOXXXOXOOOOOXXXOOOXOOOOOXOO
OXOXOOXXXXOXXOOOOOOXXOOXOXOOOOXXOOXXOXOOOOXXXOOOOOXOXXOOOOOXXOOOXOOOXOOXOOOOXOOOOOOOXXOOXXOOOOOOOOOOO
OOOOOOOXOOOXXOOOXXOOOXOXOXXXOOOOOOOOOOOOXOOOOOXOOOOOOOXOOXXOOOXOOOOOOOOOOOXXOOXOOXOXXOXOOXOXOOOOOOOOO
XOOOXOOXOOOOXOXXXOOOOOOOXXOXOOOOOXOOOXOOOOOOOOOOOXOOOOOOOOOOXXOOOXOXXOOXXOOXOXXOOXOOXOXOXOXOOOOXOOOXO
OOOXXXOXXXXOXXOOOOOOOOOOOOOOOOOOXOOXXOXXOXOOOXOXOOOOOOXOOOXOOOOOOOOOOXXOOOOOOXOOOOXXOXXOOOOOXOOXXOOOX
OOOOOOXXOOOOXOOOXOOOXOXXOXOOXOXOOOOOXXOOOOOOOOOOOOOOXOOOXXOOOOOOXOOOOOOOOOXOXXOOOXOXOOOXXOOOXOOOOOOOX
OOOXOOXXXOOOOXOXXOOOOOOXXXOXOOOXOXOOXOXOXOOXOOOXOOXOOOXOOOOOOOOXXOOOOOOOXOOOOOOOOOXOXXOXXXOXOOOOOXOOO
OXXOOOXOOXXXOXOOOOXXOOOOOXOOOOOOOXXOOXOOOOOOOOOOOOOXOOOOOXOXXXOOOOOOOOOXOOXOOOOXOXXOOXOOOOOXOOXXOOOOO
OOXXXXOXXXOOOOOOOOOXOOOOOXXXOOOXOXXOXOXXOOXXOOOOOOOOOOOOOXOOOXOOOOOOXOXOOXOXOOOOOOOOOOOXOXXXOOXOOXXOX
OOOOOOOOOOOOXXXXXXOOOOOXXOXOOOOOOOXOOOOOXXXOOOOOOXOOXXOOOXOOXXOOXXXXXOOXOOOOOXOOXXOXOOXXOXXOOXOOXOXXO
XOOOOXOXOOOXOOOXOOOOOXXXOOOOOOOOXXOXXXOOOOXOXOXOXOXXXOOOOOOOXOXOOOXOOOOOOOOOXOOXOOOOOOOXOXOXOXOOOOOOX
OXOOOOOXOXXOOOOOOOOOXXOOOOOOOOXXXOOOOOOOOOOOXXXOOOOXOOOOXOOXOOOOOOXOOOOXXOXXXOOOXXOOOOOOXXXOXOOXOOOOO
OXOOOOOOOOXOXOOOOOXOXOOOOOXXOOXOOOOXOXXXOOXXOOOOOOXXXOOOXXOXXOOOOOXOOOOOOOOOOOOOOOXOOOOXOOOXOOOXOOXOX
OXOXOXOXOOOOOOOXOOOXXXOOOOOOXOOOOOOOOOOOXOXOOOOOOOOXOOXOOXOOOXOOOOXOXXOOOOOOOOXOOOOXXOOOXOOOOXOXOOXOO
OXOOOOOOOOOOOXOOOXOOXOOOOOXOOOOXOXOOOOOOOOOOXOXOOOOOXOOOOOOXOOOOOXOOOOOXOOXOOOOXOOXXOOOXXXOXOOOXOXOOO
OXXOOOXOOOXXOOOOOOOOXOXOOOOOOOXOXXOXOXXOXOOOXOXXOXOOXXOXOXXOOXXOXOXOOOOXOOXOXOXOOOOOOOOOOOOXOOXOOOOOO
OOOXOOOOXOOOOXOOOOXOXOXOOOOXXOOOXXOOOOXXOOXOXOXXOOXXOOXOXOXOXOOOXOXOOOOOOXOOXOOOOOOOOXOOXOXOOOXXOOOOO
XXXOOXOOOXOOOOOOOOOXXOXXOOOOOOOOXOOXXXXOOOOXXOOXOOOXOOXXXOOOOOOOOOOXXOXOOXOOXOXOOOOOXOOXXXOOXOOOOOOOX
OXOOOOOOXOOXXXXOXOXOOXOOOXOXXOOOXOXOOOOOXXXOXOOXOXOOOXXXOOOOOOOOXXXXXOOOOOXOXOOOOOXXOOOOOOOXOXOOOOXXO
OOOXOXXXOOXOXOXOOOXXXOXOOOOXOOXXXOOXOOOXOOOXOXXXOOOOXOOOOOXXXOXOOOXXOOXOXXOOOOOOOOOOXXOXOOOOOOXXXOOXX
OXXXOOXXOOXXOOXOOOXOOOOOXXOXOOOOXXOXOXOOOXOOOXOOOOXOXOOXXXOOOXXOXOOOOOOXOXXOOOXOOXOXOXOOOXXXOXOOXOOXO
XXXOXOXOOOOXOOXXXXOOOOOXOOOOOOOOOOOXXOOXOOXXOOOOOOOXXOOOOOOOOXOXXOOOOOOOOOOXXOOOOOOOOXOXOOXOOOOXOOOXO
OXOXOOXOOOXXOOOOOXOXOOOXOOOOOXOOOXOXXOOOOXOOOOOXOXXOOXOXOOOOOOOOOOOOXOOOXOXXOOOXOXOOOXOXOOOXOOOOXOXOO
OOOOOOXOOOXOOOOOOOOXOOOXXOOOXOOOXOOOOOOXXOXOOOXOXOOOOOOXXOOXOOXXOOOOOOXOOXXOXOOOXOOOOOOOXXXXXOOOXOXOO
XXOOXOXXOOOXOOOOXOOXOOOXOXXOOOXOOOOOOXOOOOXOOOXOOXOOOXOOXOOOXXOXXOOOOOXXOOOXOOOOOXOOOOOOOOOOXXOOOXOOO
OOXXOOOXXOOOOOOOOXOOOXXOOOOOOOOOOOOXXOOXXOXXOXXOOOOOOOOOOOOOOOXOXXOOXOXOOOOOXOXXXXOOXXOXOOOOOOOXOOXOO
OXOOOOOOOXOOOXXXOOOOXXOXOOOOOOOOOOOOOOOOXXXOOXOOOOOOXXOXOXOXXOOOXOOOXOOOOOOXXXOXXOXOOOOOXOOOXOOOXXOOO
OOOXXOXOXOXXOXOOXOXXOXOOXOOOOXOOOXOOOXOOOOOOOOOOOOXOXOXOXOOOOOXOOOOXOOXXXXOOOXXXOOOXXOXOXOXXOOOOXOXOO
OOOXOXOOXOOOOOOOOXOOOXOOXOOXXOXXOOOXOOOXOXXOOOOOXXOXXXXOOOOXOOOOOOOXXOOOXXXOOOOOOOXOOOOOXOOOOXXXOXOXO
OOOOXXOXOOXOXXOOXXOOOOOOOXOXOOOXXOOOXOOOXXOOOOOXOOOOOOXOOOOXOOOXOOOOXXOOOOOOOOXXOOOOOXOOOXOOOOXXOOOOX
XXOOOOOOOOOOOXOOXOOOXOOXOXXOXOOOOOXXXOOOOOOOOOOOOOXOOOOOOOXOXOOXOOXOOXOOOOOOOOXXXXOOOOOOOOOOOOOOOOOOO
OOXOOOXOXOXOXOOXOOOOOOXOXOOXOXOOOOOOOOXOOOOOXOOOXOOOXOXOOOOXOXOOXOXXOOOOOOOOOOOOXOOXOXXOOOXOXOOOXOOOO
OXOOXOXOOOOXOOOOOOOOOXOOXOOOOXXXOOOOOOXOOXOOOXOXOXXOOXOOOOXXXOOXOXXOOOOOOXOOOOOOOOOXOXOOOOOOOOOXOOOOO
OOOOOOOXOOOXXXXOOOOOXOOXXOOXXOOOOOOXXOXXXOOOXOXOOXOOOXXXOXOOXOXOOOOOXOOXOXOXXOXOXOOOXXOXOOXOXOOXOXXXO
XOXOOXXOXOOOXOOXOOOXOOXXXOOOOXOXOXOOXOXXXOOOOXXOOXXXOOOXOXOOOOOOOOXXXOOOXOXOXOOXOOXOOOOOOOOOOXOOOXOXO
XOOOOXOXOOXXXOXOOXOOOOXOOOXOOOOOXXXXOOOOOOOXXOOXXOOXOOOXOOXOOOOXOOXOOOXXOOOOXOOOOOOXOOOOXOXXOOOOOOOOX
OXOOOXOOXXXXOOXOOXOOOOOOXOXXOOXOXXOOXXXOOOXOXOOOOXOXXXOOOOOOOOOXOOOXOOXXOOXOXOXXOXOOXOOOOXOXOXXXOOXXO
OOOOXXOOXOOOOOOOOOXXOOXOOXXOOOOOOXOXOOOOXXOOXOOXXXOXXXOOXOXXOOOOXOOXOOOXOOXOOOOOOXXOOXOOOOOOOXOOOOOOO
OXOOOOOOOOOXOOXXOOOXOOOOOOOXOOXOXOOXOXOOOOOOOOXOOOOOOOXOXXOOOOOXOOOOOOOOXOOOOOOOOXOOXOOOOXOOOXXOOXOOO
OXXOXOXXOOOOXOOOXXOOOOOOXOXXOOOOXOOOOXOOOOXOOOOOXXOXOOXOOXXOXOOOXOXOOOOOOXOOOOXOXOXOOXXOOOOOOXOOOOOOX
OXOOOOXOOOOOOOOXXOOOOXOOXOXOXXXOXOOXOXXXOOOOOXOOXXXXXXOOOOOOOOOOXOOOOOOOXOXOOXOXXOOOOXXOOOOOOXOOOOOOO
OOOXOXOOXOXOXOOXXOOXOXOXOXOOOOOOOOXXOOXOXXOOOOOOOXOOOOOOOOOOXOXOXOOXOXXOXOOOXOOXOOOOXOOOOXXXXXOOOOOOX
XXOOXXOXOOXOXOOXOOOOOOOOOOOOOOOXXOOOOOOOOXOXOOXXOOOOXOOOOOOOXOOOOOOOXXXXOOOXXXXXXOXXOOOOXOOOOOXOXOOXO
OOOOOOXOOOOOOOXOOOOOOOXOOXOOXOOXOOOOXOOXXXOOOOOOXOOOOOOXXXOOXOXXXXXOOXXXOXOOOXOOXXOOOOOOOOOXOOXXOXXOO
OOXOXXOOOOOOOOOOOXOOOOOOXXOOOOOOOOXXOOXOXOOOOXOXOXOOOOOOXOOXXOOXXOOOOOOOOXXOOOOXOOOOOOOXXXXOOXOOXOXOX
OOOOXOOXOXOOOXOOOOXOOOOOXOXXOXOXXOXOOOOXXXOOOOOOOOXXOOOOOXOXOOOXOXOXOXOOXXOOOOOXXOOOXOOXOOXXOOXXOOOOX
OOOOXXOOXOOOOOXOOOOOOOXOXXOOOXXOOOOXOOOOOOXOXOOOOOOOOXXOOXOOOOOOOOXOOOOXOOXXOOOOXOXXOXOOOOOOOXXOOXOXO
OOXOOOOOOOOOOOXOOOOOOOOOXOOXOOOOXOXOOOOOOXXOOOOOXXXOOXOOOOOXOOOOOOXOOOOOOOXOOXOOOXOOXOOOOXOXOOOXOOXOO
OXXOXOOOOOOXOOOOOOOXOOXXOOOXOXXOXXXOOXOOOOXOOOOXXXOXXOOOXXXOXOOXOOOXOOOXOXOOXOOOOXOOOXOXOOOXOOXOXOOOO
OOOOXOOOXXXXOOOXOXOOOOOXOOOXXOXOOOXOOXXXXOOOOXOOXXXOOOXOOOOOOOOOOOXXOOOXOOOXXOXOOOOXOOOXOOOXOXOXOXOXO
OXOOOOOOXOOOXXXXOOOXOOOOOOXOOOOXXOOXOOOOOOOXOXXOOXXXXOXOXOOOOXOOOOOXOOOOOXOXOOOOXXXXXOXXOXOXOOOOXXOXO
OXOOXXXOOXOOXXOOOXOXOOXXOOOXXOXOOXXXOXXOXOOOOXXXOOXOXXOOOXXOXOXOOXOXOOOOOXOXOXOOXOOOXXOOXXOXOOXOOOOOO
OXOOOOOOXXXOXOOOXOOXOOOOXOOOOOXXXOOXOOOXXOOOOXOXXOOOOOOOOXOOOOOOXOOXXXOOOXOOXXOXOXXOXOOOXXOOOXOOOOXOO
OOOOOXOOXOOOOOOOXOOOOOOXOOOXOOOXXOXXOOXOOOXXOOXOOOOXOOXOOOOOOXOXOOOOOXOOOOOXOOOOOOOOOOXXXOXOXOOOXOOXX
OOOOOXOOXOOXOOXOOXOOOOOOOOOOOOOXOXOOOOOXOOOOXOOOOXXXOXXXOOXXOXOOOOXOXXOOXOOXOOOXXOXOOOOOXOOOOOOXOOOOO
OXOXXOOXOXOOOOOOOOOOXOOOOOXOOOOOOXOOOOOOXOOOOXOXOOOOOOXOOOOXOXOXOOOOOOOXXOOXOOOOOXOOOOOOOXOOOOOXOOOOO
OOXOXOOXOOXXOOOXXXXOOXOXOXOOOOOOOOOOXOOOOOOXOOOOOXOOOOOOXXOXXOOXOOXXXOXXXOOOXOOOXOOXOOOOOOOXOXOXOOOXO
OOOOOOOXOXOOOOXOOOOXOOOOOOXXOOOOOXOOXOXXXOOXOOOOOOOOXXXXOXOOXXXXOOOOOOXOXOXOOOOOOOXOOOXOOXOXOXOOOOOOO
OOOOXXOXOOOXOXOOOOOXOOXOXOXOXOOOOXXXOOOXOOOXXOOOXOOOOXOXOXXOXOOXOXOOOOOOOXXOOOXOOXXOOOXOOOOOXXOOXOOOO
OXXOOOOXXOXXOOOXOXOOXOOOXXOXOOOOOOOOOOOOOOOOOXXXXOOOOOOOXXOOXOOOOXOOXOOOOXOOOOOXOOOXOOXOOXXOOOXOOXOXO
OOOOOOXXXOOOOOOOOOOXOXOXOOXOOOOOOOOXOXXXOOOXXOOOXXOOOXXOOXOOOOOOXXOXOXOOOOXOXOXOOOXOXOOOOOOXOXXOOOOXX
XOOOOOOXOXOOXOOOXXOOOOXXOOOXOXOOXOXXXOXXXOOXOXOOOXOOOOOOOXOOOOXXXOOOXXXXXXOXOOOXOOXOOXXXOXOXXXOXOXOXO
OOOOXOOOXOOOOOXOXOOOOOOXOOOXOXXOOOXXOXXOOXOOOOXOOOOXOOOOXOXXXOOOOOOOXXXOOOOXOOXOOOOOOOOXXXOOOOXXXXOOO
OOOOOOOXOOOOXOOXOOOXXOXOXOXXXXOOXOOOOOOOOOXOOXXXOXXXOOOOXOOOOXOOOOOXXOOOOOOOXOOXXXXOOOOOOXOOOOXOOXOOO
OOOXOOOXXOOOOOOOOOXXOOOOOXOXOOOOOXXOOXOOOOOOOOOOXXOOOOXXOOOXOOOXOOXOXOXOOOOXXOOXXOOOOOXXOOOOOOOOXXXOX
OOXOXOOOXOOOOOOXOXOOOXOXOOXOOOOXOXOOXXOXXOOOOXOOOXOXXXOOOXOXOOOXOXOXXOOXXOOXOXOOOOXOOOOOOXOOOOXOOXOOO
OOOXXOXOXOOOOOOOOXXXOXOOXXOXOXOOOOOOOXOOOXOXXXOOOOOOOOXOOOXXOOOOOOOOOOOOOOXOXXXXOOOOOOXOOOOOOOOOOOOOO
XXOXOOOXOXOXXOOOXOXOXXOOOOXOOXOOOXOXXOOXOOOXOOOOOXOOOOXOOXOXXOOOXOOOXXOOOOXOOXOOOXOOOXXOXOXOOOOOXXOXO
