XXOOXXOOXOOOOOOOOOXOOOOXXXXXOOOOXOOOOOXOXXOOOXXOOOOXXOXOOOOXOXXOOOOXOXOOXOXOOOOXOOOOOOOOOXXOOOXOOXOXO
OOOOOOOOOOOOOOOOOOOXOOXOXOOOOOXOOXOOOOOOOXOOXOOXOXOOXOOOOXOXXOOOOOXXOOOOXOOXXOXOOOOOXOOOOOXOXOOXOXOOO
XOXXXOOXOOXXXOXOOOOOOOXXXOOXOOXOOOOXOOXOXXOOXXOOOXOXOOOXOOOOOXOXXXXOXOXOOOOOOXXXXOOOXOOXOOXOOOOOXXOOX
OOXOXXOOXOOOOOOOXOOOOXOOOXOOOOOOXOOOXOOOXOOOOOOOXXXOXOXOXOXXOXOOOOXOOXOXOOOXOXOOOOXOOOXOOXOOXOOXOXXOO
OOOOOXOOXOXOXXOXOOOOOOOOOXOOOXOOOOOOOOXXOXXOOOOOOOXOOOOOOOOOXXOOOOOOOXXXOOOOXXOXXOXXOOOXOOOXXOOOOOXOX
XXOXOOXOOOOOOOOXOOOOXOOOOOOOOOOOOXXOXXXXOOOXOXOOOXOOOOOXOXXOOXOOXOOOXOOOOOOXOOOXOXXOOXOOOXOOOOOOXXOXX
OXOOOXOOOOXOXOOXOOXOXOXXXOOOOXOOOOOXXOOOOXOOXOXXXOXOXOOOOOOOOOOXXOXXOOXOOOOOOOOOOOOOXOXXOOXOOOXOOXXOO
XXOOOXXXOXOXOOOOOXOOOOOXXOOOXOXOOOXOOXXOXXOOOXOOOOXOOOOOOXOXXOXXOOOOOOXOXOOOOOOXOOOOOOXOOOOXOXOXOXOOX
XOOXXOOOXOOOOOOOOOOOOXOOOXOOOOOOOOOOXXXOOOXOXXXXXOOOOOOOOOXOOOOOXOXXXOXXOOOOXOOXOXOXOOOOOXOOOXOOOOOOO
OOXXOOOXXOXOXXOOOXXOOOOOOOOXOXOXOXOOOOXOOXOOOOOOXOOOOXOOOOOXXXOOOOOXXOOOOOOXOOXOXXXOOOOOOXOXOXXOOXOOX
XXOOXXXOXXOOXXOXOXOOOOXOXXOOOOOOXOOXOOOXXOOOOOOOOXOOOOXOXXOOOOXOOOOOOXOXOXOOXOOXOOOOOOOOOOXOOOOOOOOOO
XOOOOOOXOOXOOOXXOOOOXOOOOXOXXOXXOOOOOOXOOXXOXOXOOOOXOOOOOOOXXOOOOOOXOXOOOXOOXXXOOOOXOOXOOXOXOOOOOOOOX
OOOOOOXOXXOXXOOXOOXXOXOOOOXOOOXOXOOOOOOOXOOXOOXXOXXOXOXOXXOOXXXOXOOXXXXXXXOOOXOXOOOOOXXXXOOXOOOXXOOOO
OXOOOXOOOOOXXOOXXOXOXOOOOOXOOOOXOOOOOOXOOOOXOXOOOOOOOOOXOXXOXOOXOOOOXXOXOOOOOOOXOOOXOOXOOOOXXOXOOOOOO
OOOOXXOOOXOOOOOOXXXOOOXOOOXOOXOOOOOXOOXOXXOOOXXXOOOXOXOOOXOOXOOXOOOXOOOOOOOOOOOOOOOOOOXOOXOOOOOOXOOXO
OOOOOOOXOOOOOOXOXOOXXOXOOOOOOOXOOOXOOOOXOOOXOOXOOOOOOXOOXOOXOXOOOOOOOOXOXOOXOOOOOOOOXOXOXXOOOOOOXOOOO
OOOOXOOOOOOOOOOOOXOOOOOOOOOXOOOXXXOOOOOOOXOXOXOOXXOXOOXOOXOOOOOXOOOOOOOXOXOXXOXXOOOOXXOOOOOOXOOXOOOXX
XXOOOXOXOOXOOOOOOXXOOOOXXOXOOOOOXOOOOOXOOOXOOOOOOOOXOOOOXOOOXOOXOXXOOOOOXXOXOOOOXOOOOXOOXOXXXOXOXXOXX
OOOOOOOOXOOXXOXOOOOOOOOOOOOOOXXXOOOOOXOOOXOXXOXOOXOXXXOOOOXOOOOXOOOOOOOOOOXXXOOXOOOOOOOOOOXOOOXOOXXOO
OOOOXOXXXXOOOXOXXXOXOXXOOOOXOOOXXOOOXOOOOXOOOOOOOXOOXOOOOOOXOXXOOXOXXXXOXXOOOOOXXOOOXOOOXOOOOOXXXOXOO
OOOXOOOXXXOOOXOOOOXOXOXOOXXOOOOOXOXOXOOOOOOXOOXOOXXOXXXXOOOOXOOOOXOOXOOXOOOOOXXOOXOXXXOOOOXXXOOOXOOXO
OXOXXOOOOOOOOOOOXOOOOXXOOOOOOOOOOOXOXOXXOOOOXXOXOOOOOOOOOOXOOOOOXOOOXOXOOOXOXXOOOXOOOOOXOOXXOOOXOOOOO
OXOXOOXOOOOOOOOOOOOXOOXXOXXOXOOOXOXOOXXOOOOOOXOXOOXOOOXOOOXOXXOOOXOOXOOXOXOOXOOXOXOOOOXOOOXXXOXXOOOXO
OOOXOXOOOOOOXOOOOOOXXOOOXOXOOOXXOOXOXOXOXOOOOOOOOXOOXOOOOOXOOOOOXOXOOOOOXOXOXXOOOOOOOOXOOOOOOOOOOOOOO
OOOOOOOXOOXOOOOOOOOXOOOOOOOOOXOOOOOOOOOXOOOOOOXOOOOXOOOOOOXOOOXXXOOOOOOOOXOOOOXXOXOXOOOXOOOOOOOOOOOOO
XXOOOXOOOXOOXXOOOXOOOOOXOXOOOXXOXOOOOOOOOOXOOOOOOOOOXOOOOXOXOXXOOXOOOOOOOOOOOOOOXOOXOXOOXOOOOOOXXXOOO
XOXXXOOOOXOXXOOXOXOXXOOOOXOOOOOOOOOOOXOXXOOXOXOOXOOOOOOOOXOOOXOOOOXXOOOXOOOXXXOXOOOOXOOOOOOXXOOOOOXOO
OXOOXOOXOOXOXOXOOOOOXOXOOXOOXOOOOOOOXOXOOXOOOOXOXOXOOOOXXXOOOXOOOOOOOOOOXOOOXXOXXXOOOOOOOOXOXOOOOOXXO
XXOXOXOOOOXOOOOOXXOOOXOXXOXOOOOOOXXOXXOOOXXOOOOOXOOOOXOOOOXOXOOOOOOXOOOOOOXOOOXOXOXOXOOOOOOOOOXOXOOOO
OOOOOOOOXOOXOOOXOOOOOXOXOOOOOOOOOOXXOOXOOOOOXOXOXOOOXOOXXOXOOOXXOOXOXOOXOOOOOOOOOOOOXOOXOXOOOOXXOOOXO
OOOOOOOOOXOXOOOOOXXOOOOOOXXOXXXOOXOOOOXOOXXOOOOOOXOOOOOXOOOOOXOOOXOOOXXXOXOOOOOXOXXOOOOOOOOOXOOOOOOOO
OOXXOOOOOOXOOXXXOOOXOOXOXXOOXXOOOOOOOOOOXOOOOOOOXOXXOXOOXOOOOOOXXXOOXXXOXOXOOXOOOOXOXXOOXOOXOXOOOXOOX
OXOOXXXOOOXXOOXXXOXOXOOOOXXOXXOOOOOOOOXXOOOXOOXOOXOOOOOXOOOOOOXOXXOOXOOOXOOXOXOXOOOOOXOOOOOXXXXOOOXOO
OXOXOOOOXOXXXOXOXXOOXXOOOXXXXOOOOOXXOXOOOOOXOXXOXOXOOOOXOXXXXOOOXOOOOXOOXOOOXOOOOOOOOOOOXOXXOOOXOOOOO
OXOOOOOXOXOOOOOOOOOXOOOOOOOOOXOXOXOOOXXOOOXXOOXOOXXOXOOXOXXOOOXXOOXOOXOXOOOXXOXXOOOXOOXOOOOXXOOOXOOXX
OXXOOXOOXXXOOOXOOXOOOXOOOOOXXOOOXOXXOOXOXOOXOOOOXXOXOOXOXOOXXXOOOXXXOXOOXXOOXOOOXOXOOOOOOOOOOOOXOXOXX
OOXOOOOXOOOOOXXOOOOOXOOOOXOOXOXOXXOOXOOOOOOOOXOOXXOOOXOOOXOXOXOXOOOXXXOOOXOXOXOOOOOOOOXOXXOOXXXOOOXOX
OXOOOXOOXXOOOOOOXXOXOOXXOOXOOXXOOXOOXOXXOOOXOXOOOXXOXOOOXOXOOOOOXOOOOOOXOOOOOOXOOXOOOOOXOOOXXOOXOOOXO
XXOXOOOXXOXXXOOOOOXOOOXOOOXOXOOOOOOOXOXOOOOOOOOOOOXXOOOOOOOOOXOOOXOOOOOXOOXOXOOOOOOXOXXOOXXOOOOOXXXXO
OOXXOOOXXXOXXOXXOXOOOXXXXOOXXXXOOXXOOOOOOXOOOOXXOXOOOOOOOOOOOXOOOOXXOOOOOXOXOOOOOXOOOOOOOOOOXOOOOOOOO
OOOXOOOOOOOOXOOOOOOOOOXOOXOXXOXOXOXXXOOOOOOOOOXXOXXOOOOOOOXOOOXOOOOOOOXOXOOOOXOOXOXOXOOXXOOXXOOOOOOOO
OOXOOOOXXOOOOOXOXOOOOOXOOXOOXOXOOXOXOOOOOXOOXOOOOXOOXOOOOOOOOOOOXOOOXOXOXXXOOOOOOOOOOOOOOOXXOOOOOXOXX
XOOXOXXOOOXOOOXXOOXXXOOOOXOXXOOOOXOOXOXXOOOXOOOXOOOOOOOXXXOXXOOXOOXOXXOXXXXOXXXOXXOXOOXXOOXXOOXOOOOOO
OXXXXXXOOXOOOOOOOXXOOOXXOOXOXOOOOXOOOOXOXOOOXOOOOOXXOOOOOXXOOOOOXOOOXXXOOOOOOOOXXOOXXOOXXOOXOOXOOXOOO
XOOXOXOOOXOOOOOOXOOOOOOOOOXOXXOOOOOOOXOOXOXOOOXXOOOXOOXOOOXOOOOXXOXXOXXOOXXOOOOOOOOOXOXOOXOOXXXOXXOOO
OOXXXOOXOXXXOOOOOOXXXXOXOOXOOXOOOXXXOOOOOXOOOOXOXOXOOOOOXOOOXOOXOOOOXXOOOOOOXOOXXOXOOXXXOOOOOOOXXOXOO
OOOOOOXOOOXOOXXOOOOOXXOXOXXOXOOOXOXOOXXXXOOXOOXOOXOOXXXOOXXOXOXXXOOOXOOXXXXXXOOXOXOOOOOXOOXOXOOXOOOOO
OXOOOOOXOOOXOOXOOOXOOXXOOOOXOOXOXOOXOXXXOOOOOOOXOOOOOOOOOXXOOOOXOOXXOOOOXOOXOOOXOOXOOOOOOXOOXXOXXOXOX
OXOOOOXOXXOOXOOOOOOXOXOOOOOOOOXOXOOOXOOOOOOOXOOOOOOXXOOOOOOOOOOOOXOOXOOOOOOOOOOOXOOOOOXOOXOOOOOOXOXXO
XOXOOOOXOXOOOOOOOOOXOOOXXXXOOOOOOOXXXOOXOOOOOOOXOOOOOOOXXOXXXOOXXOOOOOOXOXOOXOXXOOXOOXOOXOOOOOOOOOOXX
XOOXOOOOOOXXXOOOXOOOOOOOXXOOXXOOXOOXOOOOOOOOOOXOXOXOOOOOOXXXXOXOOOOOOOOXOOOOOOXOOOXXXOOOXOOXXOXOOOOXO
XOOOOOOOXXXOXXXXXOOOOOOOOXOOOOOOOOXOXOOXXOOOXOOOXXOOOXOOOOXXOOXOOOOXXOXOOOXXOXXOXOOOXOXXOOXOOXOXXXOOO
XOXXXOOXOOXXOXOXXXXXOOOOOOOOOXXOOXOOXOXOOXOXOOXOXOXOXOXOOOOOXXOOOXOXOOOOOXOOOOOOOOOOOXXOOOOXOXOXOOOOO
XOXOOXXXOXOOXXOOXOOOXOXOXOOXOOXXXOOOOOOOOOXOXOOOOOXOOOXOXOOOXOOOXXOOOOOXOOOOXOOOOOXOOOOOXOOOXOOOXOXOO
OOXOOOXOXOXOOOOXOOOXOOOOXXOXXOXXXOOOOXOOOOOXXXOOOOOXOXOXOOOOOOOOOXXOOXOOOOOOXXXXOOOOXOOOOOOOOXOOOOOXX
XOOXXOOOOOXOOOXXOXOOOOXOOOOOOOOOOOOOOXXOXOOOOOOOXXOOOOOXOOOXOOOXOOOXOXOOOOXXOOOOXXXOOOXOOOOOXOOOXXOOO
XOOXOOOOOOOOOOOXOOXXXOOOOOOOOOOXOOOXXOOOXXXOOOOXOXOOOXOOOOOOOXXOOOXOOOOOOOOOXOXOOXOOXOXOOOXOOOXOOXOOX
XOOXOOOOOXXXOOXOOXOXXOOOOOXOOOOOOXOOOOOOOOOXXXXXOXOOOOOOOXOOXOOOOXOOOOOOOOOOXOXOOOOOOOOOOOOOOOOOXOOOO
OOOXOXXXOOOOXOOXOXXOXOXOOXXXXOOOOXOOOXOXOOOOOXOOOOOXOXOOOOOXXOXOXXXXOOOOXXOXXXOXOOXOOOOOOOXOOOOXXXOOO
OXOOOOXXOOOOOXOXOOXOOXOXOOOOXOOXOOXOOOOXOOOOOXXOOOOOOOOXOOXOOOXOXXOOOXXOXOOOOXOOXXOOOOOOOOOXOXOXOOXOO
OOXOOXOXXOOOOOXOXOOXXOOOXOOXOOXOXXOOXOOOXOOXOOOOOXOOOOOOOXOXOOXOOXXOOOXOOOOOXOXXXOOXXOOXOXOOOOOOXOXOO
OXXOOXOOOOOOXOXOXXXOOOOOXXOOOOOXOOOOXOOOOOXOOOOOOXOOOOXOXOOXOOOXOXXOOXOOOOXXXOXOOOOXOOOOOOOOOOXOXXOOX
OXXXOOOOXOXOXOOOOOOOOOOOOXOOOOXOOOOOXXXOOOOXOOOXXOOXOOOOOOXOOOOOOXOOOXXOOOOOOXOXOOOOOOOOXOXOXOOOOOOOX
OOOOOOOOOOXOOXOOOOOOOXXOXOOOOOXOOXXOXOOOXOXOOOXOOOOXOOXOOOXOOXOXXOOXOOOXOOXOOOXOXOOOXOOOXOOOOOXOOOXXO
OXOOOOOXOOOOOXXOOOXOOOXXOOOOOOOOOOXOOOOXXOOXOOOOOOXOOXOOOOOOOXOOOXOOXOOXXXOOOOOOOOOOOXXOOXOOOOXOOXOOO
OOOOXXXOXXOXOOOOOOOXOXXOOOOOOXOXXOOOOOXOOXOOOXXOOOOOOXOXXOOOXOOOOOOOOOOOXXOOOOOOOOOOOOOOOOOOXOOOXXXXO
OOXXXOXXOOXOOOOXOOXOOXOXOOOOXXXOOXXOOOOOXOOOXXOOOXOXXXOOOOOOOOOXOOXXOXOXXXOOOOOOXXXXOOXXOXXOXOXOOOOOO
OXOXOOOOXXOOOOOOOOXOOXOOOXOOXOOXXOOXOOOOOOXXOOOXXXOOOOOXOXOOOOOXOXOOOXOOXOXOXOOXOOOOXOOOOOXOOOOOXOXXO
XOOXOXOOOXOXOXOOXOXOOOOOOOOXOOXOXXOXOOOOOOXOXOOXXXOXOXOOOOOXXOXOOOOOXOOOOOOXOXOOXOXOOXOOOOOOOXOXOXOXO
OOXOXXXOOOXOOOOOOOXOXXOXOXXOOOOXOXOOOOXXOXXOXOOXOOOOOOOXOOXOOOOOOOXXXOXXXOXXOOOXXOOOOXXOOXOOOOOOOOOOX
XOOXOOOOOOXXOXOXOOOOOOOOOXXOXOOOOOOOOOXOOXXOOXXXOOOOOOOXOOOOOOXXXXOOXOOOOOOOOXXXOOXOOOXOOOXOOOOOOXXXO
OOOOOOXOXOOXOXXXOXOXXOOOOOXOOXXOOOXOXXXOOOOXOOXXXXOXXXXOOOOXOXOOXOOOOXOOOOOOOOOOXOXOXOOXXXXXOOOXOOOXO
OXOOOOOOOOOOXOOOOXOOOOOXOOOOOXOXOOOOOOOOOOOOOXXOOXOOOXOXOXOOOOXOXXOXOOOOOXOOOOOOXOOOOXOXOOOOXXOXOOOOO
OOOOXOOXOOOXOOOOXOOOOXXXXOXOOOOOOOXOOXOXOXOOOOOOXXXXOOOOXOXOOOXXXXOXOOOOOXXXOOOXXOOOOOXOXOOOOXOXXXXOO
XOOOOOXOXOOXXXXXOXOOOOOOOOOOOOOOOOOOOOOOXXXOXOOOOOXOOXOXOXXOOOOXOOXXOXOXOOXOOOOOOXXOOOOXOOOOOOOOXXOOO
OOXOOOOOOOOOOXOOOOOOXOOXXXOXXOXXOOOOXOOXOOXOXOXXOXXOOOOOOXXOOXOOOXXOXOOOXXXOOOXOOOXOXOXOOOOOOOOXOOOOX
OOOOXOOOOOOOOOOXOXXXOOXXXXXOOXOXOXXOOXOOOOXOOOOOOXOOOOOOOOOOOOOOXXXOXXOOXOOOOOOXOXXXOOOOOXXOOOOOOOXOO
OOOOXOOXOOOOXOXOOOXOXXOOOOOOOOOOXOXXXOXOOOXOOOOOOXOOOXXOOXXXOXOOOOOOOXOOXOXXOOOXOOXOXOOXOOOXOOXOOOXOO
OOOOXOXOOOXOXOOOOXXOOOOXXOOOXOOOOOXXOOOXOOXOOOXXOXOOOOOOOXXOXOXOXXOXOXOOXOOOOXOOOOOOOXOOOOOXXOOOXOOOO
OOOOOOOOXXXOOOXXOXOOOOOXOXOOXOOOXOOOXXOOOOOOOOXOOOOOOOOOOOOXOOOOOOOOOOXOXOXOXOOOOOXOOXOXOOXOXOOXOOXOX
XOOOXXOOOOXOXOXXOOOOXXOOOOOOOOOXOXOOOXOOXXOOOOXXOXOOOXXOOXXXOOOXOOOOOOOOOOOOOOOOOXOOXOOOOOOOOOOOOOXOX
OXOOOOOOOOOOOXXXOOOOOOOXOXOXOOXXOXOOOOOOXOXOOXOOOOOOOOOOOOOXOOOXXOXXOOOOOOOOXOOXXXOXOOOXOOOOOOOOXOXXO
OOOOOOOXXXOXOOOXOOOOOXXXOOOXXOOOOXXXOOXOOOOXOOXOOOOOXOOXXXXXOOXXOOXOOXOOXOOXOOOXOOOOOXOOOXOOXOOOOXOOO
OXOOXXOXOOXOOXOOOOOOOXOOOXXXOOXOXOXOOOOOOOOOOOOOOXOOOXOOXOOOXXOOOXXXOOOOOOOOOOOOOOOOOXXXOOOOOOOOOOOXO
OOOXOOOOOXOOXOOOXXOOOOOXOOOXXOOOXOOOXXOOXXOXOXOXXOOOOOOXOOOOXOOXOOXOXOOXXOXOOXXOOOOOOOOOOXOXXXOOOOOOO
OOOXXOOOOOOXOXOOOOOXOOXXXOOOOXOOOOXXOXXOOXOOOOOOOOXOXXOXOOOXOOOOXXOXOOOXOXOOOOXXOOXOOXOOOXXOOOOXOOOXO
OOOOOOXOOOOOXOOOOOOXOXOXOOXOOXXXOOOOXOXXOXXOOOOXOXXOXOOXXXXOXOXXOOXOOOOOOOXOOXOOOOOXOOOOOXXXOXOOOOOXO
OXXOOOOXOOOXXOXOOXXOOXXXOOOOOXOXOXOXOOOOXOOOOXXOOOOXOOOOXOOOOOXOOOOOXOOOOXOXXXOOOOOXOXXOOXXOXOOOOOOXO
OOOOXXOOOOOOXOOOXXOOOOOXXXOOOOOOOXOOOXOOXOOOOXOOXOXOXXOXXOOXOOOXXOOOXOXOOOOXOOOOXOXXOXXOXXXOOOOXOOOOO
OOOOOOOOOOOOOOXOOOXOXOOOOXOXXOXOOOOOXOOOXXOOOOXOOOXOXXOOOOXOXXOOOOOOXXOXXXOOOOOXOXOXOXOOOOXOOOXOOOOOO
OXOXOXOOOOOOOOXOXOOOXOXXOOXOXXOOOOOXOOOOXOXXOOXXOOXXOOXOOXOOOOOXOXOOOOOOOOXOOOXOOOOOOOOOOOXXOOXOXOOOO
OOXOXOOXXXOOOOOOOOXOOOOXOXOOOOOOXXOXXXOOOXOOXXXOOOOXOOXOOOOOOOOOXXOOOOOXOOOOXOXXOXXOOOOOOXOOXOXXOOOXO
XXOOXOOOXOOOOXOOOOOXXOOXXXXOOOOOOOOOXXOOOXOOOOOOXOXXOOOOOXXOOOOOOXOOOOXOOOOOXOXOOOOXXOXOXOXXXOOOOOXXO
XXOOOOXXXOOOOOOXOXOXXXOOOOOOOOOXXOOOOOOXOXOOOOOOOOOOXOOXOOXXOOOOXXOOXOOOOXXOOOOOXXXXOOOOXXOOXOXOXXXOO
OXOOOOOOXOOOOOXOOOOOOXOOXOOXOOOXOXOXOOOOXOOOXOOOOXOOOOXOOXOOXOXOOXOOOOOOOXXOOOOXXOXOOOOOXOXXXOOOXOXOX
OOOOOXOOOXOOXOOOOXXXXOOOXOOXOOOOXOOOXOOOOOXOOOXOXXOOOOOXOOOOOOOXOXOOXOOOOOOOXOOOXOOOXXOOXOOOOOOXOXXOX
XOXOXOOXXOOOXOOXOOOOOOOOXOOOOOOXXOOOOOOOOOXOOOOOOOXXOOOXXXXOXOXOOXOOXOXOOXXOXOOOXOOOOOOOOOOOOOOOXOOOX
OXXXOOXOOXOOXXXOOXOOXOOXOXXXXOOOXOOOOOXOOOOXOXXOOOXOXOOXOOXOOOOOOOOOXOOXOXOXXOOOOOXOOOXXOOOOOOOOOOOOO
OOOOOOOXOOXXOXOXOXOXOXOOOOXXOXXOXXXXXOOOOOOXOOOOOOOXOOXOOXOOOOXOOXOOXOXXOXOOOOOOOOXOXXOOXOOOOOOOXXXOO
OOOXOOOOOOXOXXOXOOXXXOOXOOXOOXOOOOOXXOOOXOOOOOOXOOOOXOOOOOXXOOXXOXOOXOXOOOOOOOOOXOOXOOOXOXOOOOOXOOOOO
OXOOXOOOOOXOXOOXXOOOOXXXOOOOOOXXOOXXOOOOOOOOOOXOOXXOOOOXOXXOXOOOOOOXXOOOXOXXOXXXXOOOOOOOOOXOOXOOXOOXO
