OOOXXXOOOOOOOOXOOXOOOOXXOXOOOOOOXOOXOOOOXOOOXXOOOOOOOOOXOOXXOOOXXOOXOXOOOOXOOOXOOOOXOOOXOOOOOOOXOXOOO
OOOXXOOOXOOOOOOOXOOXOXOOOOOOOOXOXOOOXOXOOOOOOOXOXOOXXXOXXXOOOOOOOOOOOXOOOOXOOOOOOOOOOOOOXOOXOOOXOXXOO
OOOXXXXXOOOXOOOOXOXOXOXOXXOXOOXOOXXOOOOOOOXOXOOOXOOXOXOOOOXOOXOOXXOOXOXOOXOXXOXOOXOOOOOOOXOOXOOXXOOXO
XOOXOOOXOOOOOXOOOOXOXOXOOOOOOOXOOOXOXOXOXOOOOOOOOOXOXOOXXOOOOXOOOXXOXXOOOOOXOOOXOOOOOOOOOOXOXOOXXOOOO
OOOOOOOOOOOOOXOXXOXOXXXOXOOOOOOOXOOOOOXXOOOOXOOOOXOOOXXOOOOOOXOOXOOOOXOXXOOOOXOXOOOXOXOOXXOOOOOOOXOOO
XOOOOOXOOOOOOXOOOOOOXOOOXOOOXOOOOOXOXOXOOXXOOXOXOOOOXOXXOOOOOXOXOOOOOOOOOXOOOXOOXXXXOOXOOXOOXOXOOOXOO
XOXXOOOOXOXOOXXOOOXXOOOOXXXOXOXOOOXXOOOOOXOOOOOXXXXOOOOOOOOOOOOOXXOOOOXXOOXOOOOOXOOXXOOOOOOXXOXOOOOOO
OXOOOOOOOOXOXOOOOXOOOXOOXXXOOOOXOOOOOXXOXOOOOOOXOOOOOXOOOOOOXOOOOOXXOOOXOOXOOOXOOXOOXXOOOOXXOOXXOOOXO
OXOOOOOXXOOOOXXXOXOOXOOOOOOOOOOOXOOOOOOOOXXOXXOOOOOOOOOOOOOOOOOOOXOOOOOXOOXXXOXOOOXOOXOOOOXXXOOOOOXXX
XXXXOOOOOOXXXOOOOOXOOOOOOXOXOOOOOOOOOOXXOOXXOOOOOXOOXOOOXOOOOOXOXXXOOXOOOOXOOXXOXOOOOOOOOXOOOOOXOOXOO
OOXOOXXOXXOOOOOOXXOOXXOXOOOOOXOOOOXOOOXOOXXOOOXOXOOOXOOOOOXOOXOXOOOOOOXOXOOOOXOXOOOOXOOXOOXOOOOOOOXOX
OOOXOOOOOOXOXXXOOOOOXOOOOOXOOXOOOXXOXOOXOOXOOOOOXOOOXOOOXXOXOOOOOOOOOOOOXXXXOOOXOOXOOXOOOXXOXXXOOOOOX
OXOOXXXOOOOOXOXXXXOOOOOOOOOOOOOOOOOXXOOOXOOOOOOXOOXXOOOOOOXXOXOXXXXXOOXOOOXOOXOOOOOOOXOOOOOOOOOXOOOOX
OXOXOXXXOOXXOOOOOXOOOOOXXOOOOXXOOOOOXOXXOXXXXOOOOOOXOOXOXOOXOOXOOOXXXXOOOOOXOOOXOXOOOOXXXOXOOOXOOOOOO
XXOOXOOOOXOOXOOXOOOOXXOOOOOOOOXXXOOOXOOOXOOXXXXOOOXOXXOXXOOXXXOXOXXOOOOXOXXOXOXOXOOOOOOOXOOOXOOOXOOOO
XOOOXOOOOXOOOOXXOOXOOXOOOXOOOOXOOXOOXOOOOXOOXOXOOOOXOXXOXXOXOOXOOOOOOOOXXXXOOOOOXOOXOXOOOOOOXXOOOOOOO
OOOOOXOOOOOOOOOOOXXXOOOXOOOXOXOOOXXOOXOOOOXOOOOOOXXOOOXXOOOOOOOXOOXOOOXOXXXOOXOOOXXOOOOXOOOOOXOOXOOOX
XOOOXOOOOXOOXOXOXOOOXXOOOOXOOOOOOXOXOOOOOOXOOOOOOOOXOXOOXOXXOXXXOOOOXOOXOOXXXOXXOOOXXOXOXOOOXXOOOXXOO
XXOOOXXOOOOXOOOXOOOXOOXOXOXOOOOOOXOOOOOOOOOOOXOOOXOOXXXXOOOOOOOOOOOXXOOXXOXOOOXOOOOXOOOXOOOOOXOOOXOOO
OOOOXOOOOXXOXOOOOXOXXXXXOXOOOXOOOOXXOOXOOXXOXOOOXXOOOOOXXOOOOOOXXOOOXOXOXOXOOOOOOOOOOXOOOXOOOOOOOOXOX
OXXXOXOOOXOXOXOOOOOOOXOOOOOOOOOOOOXXOOOOXXOOXOOOOOXOOOOOXOXXXOOOOXXOXXOOXOXOXOOOOOOOOOOOOOXOOOOOXOXOO
OOXXOOOOOOXOOXOXXXOOXXOOOXOXOXOOOOXXOOOOOOXOXOOOXXXOOOXOXOOOXOOOOOOXXOXXOOXOOOOXOXOOOXXXOOOXOOOOXOOOO
XXXOOXOOXXOXOOOOOOOOOOOOOOOXXOOXOOOOXXXOOXOOXOOOOXOXOOOXXOOOOXOXOXOXOOXOOOOOOOXOOOXOOOXOOOOOXOOOXOXOO
OOXOOOOOOOOOOOOOOOXXOXOOOXOXOOXOOXOXOOOOXOOXOOXXXOOOXXOOOOOOXOOXOXOOOXOXOOOOXOOOXXOOOOOOXOOXXOOOXOOXO
OXOXOOOOOOOOOXOOOXXOOOXOOXOXOOOXOOOOOOOXOOOOOOOOOOOOXXOOOOOXOXOOOOOOOXOOXOOOOOOOOOOXOXXOOOXXXOOOOOXOO
OOOOOOOXXXXOOXXOOOXOXOOOOOXOOOOOOXOXOOOOXXXOOOOOOOOOOOOOXOOOOOXOXXOOOOXOOXOOOOOOOOOOOOOXOXOXOXXOXXXOO
XOXOOOOOOOOOOXOOOOXOOXXXXOOOOOOXOOOOOOOOOOXOXXOOOXXOOOXOXOXXOXOOXXXXOOXOOOXOXOOOXOXXOXOOXOOOOXXOXOOOO
OOOOOOOOOOOOOOXOOOXXOXOXOOXOOOOOXOXOOXOOOOXOOOXOOOOOOOOOOXXOOXOOOXOOOOOOOOXXOOOOXOOOOOOXOOOXXOOOOOOOX
OOXXOOXOOOOOXOOXXOOOOOOXOOOOOOXOOOOOXOOOOOOXOOOOOOOOOOOOOXXOOOOOOOOOOXXXXXXOOOOOXOOOOOOOXOOOXXOXOXOOO
XOXOOOOOXXOXOOXOXOOOXXXXOOOOOOOOOOOOOXOOXOOOOXOOOXXOOXOOXXXXOOOOXOOOXOOOXXOOXXXOOOOXOOXOOXOOOOXOOXOOO
OOOOOXOOXOXOOXXXOOXOOXXOOXOXOOOOOXOOOOOOOXOOOOXOXXOOOOOXOXXXOXOOXOXOOOXOOOXXOOOXXXOOOOXOOOXXXXOXOXXOX
OXXOOOXOXOOOOOOXXXOOXXXOOOOOOOXOOXOXOOOOOOXOOOXXOOOOOOOOOOOOOXOOOOOOOOOXOOXXOOOOOOOOOOXOOOOOOOOOXOOOO
OOOXOOOOXOXOOOOXOXOXXOXXXOOOXOOXXOOOOXOOXXXOOXOXOOXXXOOOOOOOXOOOOOOOOXOXXOOOXOOOXOOXOOOOOOOOOXOXOOOXX
OXOOOOOOOOOXXOOOOXXXXOXOOXOOXOXOOOOXOXOXOXXOXOOOOXOXOOOOXOOXOXOOOOOOOXXOOXXXOOOOOXOOOOOOOOXOOXOOOOOOX
XOOOOXOOOXOXOXOOOOOXOOOOOXOOXXOOOXOOOOOOXOXOOOOOOOOXOXXXOOOOOOOOXXXOOXOOOOOOXOOOXOOOXOXOXOOOOOXOOOXOX
OOXOOOOOOOOOOOOXOOOOOXOOXOOXOOOXOXOOOXOOOXXOOOOXOXXOOOOXOXOOOOOOOOOOOOOXOOXXOOOXXOOOOOOOOXOOXXOOOOOOO
OOOOOOXOXXXOXOOXOOOOOOOXOOOXOOXOOOOXOXOOOXOOXOOXOOXXOXOOXXOOXOOOOOOOOOOXOXOOXOOOOOXOOOXXOXOOXOOXXOOOO
OXOOOXXOOXOOOOOOOOOOXOOXOXXOOXXOXOOOOOOOOOXOOOXOOXOOOOOXOOXOOXOXXOXXOOOOOOOOXOOOOOOOOXXXXXOOOXOOOXXXX
OXOOOOOXOXXOOOOOOXOOOXXOOXOOOOOXXOOOOOOXOOXXOOOXXOXOXXOXOOOXOOOOOXOOOOOOOXOOOXXOOOOOOXOOOOOOOXXOXOOXO
XOXOOOXOOOOOOOOXOOOOOOOOOOXOOOOOXXOOOOXOOXOOOOXOOOOOOOOOXOOOXOXOOOXOOOOOOXOXOOXXOXOOOOOXOOOXXOOOOOXOO
OOOOXXOXOOOOOOOOXOOXOOOOOOOOOXOXXXXOOXOOOOXXOOXOXOOOOOXOXXOOOOOOXOOOOOOOOOOOOXXOXOOOOXXOOOOOOXOOOOXOX
OOOOOXXOOXOOOOOXXOOOOXOOOXOOXOOOXOOOOXXOOXOOXOXXOXOXOOOOXOOXXOOOOOOOOOXOXOOOXOOOXOXXOOOOOOOOXOXOOXXOO
OXOOOXOOOOOOXOOOOOOOOXXXXXXXXXOOOOOOOXOOXOOOXXXXXOOOXOOOOXOOOOOXXOOXXOXOXOOXOOXXOOOOOOXOOXOXOXOOOXXOO
OOOXOXXXOOOOOXOOXOOXXOXOXXOOOOOOXOXOOXOXOOXXOOOOOOXOOOXOXOXOOXOOOOOOOOXXOOXOOXXOOXOXOXXOXOOXOOOXXOOXO
XOOXOOOOOXOOXXOOOOOOOXXOOOXXOOOOOOXOOXOOOXXOOOOXXOOXOXOXOXOOOOOXOOXOXOOOOXXXOOOOXOXOOOOOOOOOXXOOXOOOX
XOOOOOOXOOOXOOOXOXOXOOOOOXOXOOXOOOOOOOOOOOXOXOOXXOOOOXOOOXOOXXOOOOOOOXXXOOOXOXOOOXOXXOXOOOXXOOXOXOOOO
OOOOOOXXXXOOOOOOOXXXOOXOOXOOXOXOOOOXXXOXXOOOOXOOOOXOOOXOOOXOOOXOOOOOOOXOOXOOOOOOOOOOOOOOOXOOOOOOXOXXO
OOOOOOOOOOOOOOOOOXXOXOOOOOOOOXXOXXXXXXOXXXOOOOOOOOOOOXOXOOXOXXOOOXXOXOOOOOOOOXOOOXXOOOXOOXOOOOOOXOXOX
XXOOOOOXOOOOOOOOOOOXXXOOXXOOOOOOOXOOXXOOOOOXOOOOXOOOOOOXOOXXOOOXOOOOOOOOOOOOOXXOOXXOXXOXOOXOXOOXOXOXX
OOOXOOOOXOOOOXXOOOOOXOOXXOOOOOOOOOOXOOOOOOOOXOOOOXOOOOOXOOOXXOXOOXXXOXOXOXOXOXXOXXOXOOXOOOOOXXOXOXOXO
OXXOXOOOXXOOOOXOOXOOOOOOXXOXXOOOOOOXOOXOXXOOOOOOXOOOXOOXOXOXOOXOOXOOOOXOOOOOOOOOOOOOOOOOXOXOOOXOOOOOX
OOXOXXXXOOOXOXOOOXOXOXOOOOOXOXOOOOOXXXOOOOXOOOOOOOXXOOXOXXXOOXOOOOOXOOOOXXXXOOOXXOXOOOOOOOXOOOOXOOOXO
OOOXOOOOOOOXOOOOXXOOOOOOXOOOOOOOOOOOOXOOXOOOOOOXOOOOXOOOOXOOOOOXOOOOOXOXOXOOOOXOOOOOOXOXXOOOOOOOXOOXX
OOOOOXOOXOOOOXOOOOOOXXOOXOXXXOOXOOXOOOXXOOOOOOOOOOOOOXXXOOOOOXOXOOXXOOOOXXOXXXXXOOOOOOOXOXOOOOOOXXXOX
XOXXXXOXXOXOXOXOOOOOXOOOOOOOOOOOOOOOXXOXOXOOXOOOOOOXOOOXOOOOOXOOOOXOOXXXXOOOXOOOOOOOOOOOOOXXOOOOOXXXO
XOXOOOOOXOOOOXOXXOOOOXOOXOXXOOXOXXOOOOOOXOOXOOOOOOXOXOOOOOOOXOOOOOOOXOOXXXXOXXOOOXXXXOXOOXXOXXXOXXOOO
OXOOXOOXOOOXXOOOOOOOOXOOOOXOXOOXOXOOOOOOXXOXXOOOOXOOXOOXXOOXOOOOOXOOXOOOOOXOOOOXXXOOOOXOOXOOXOOXXOOXO
OOOOXOOOXOXOOXOOOOOOOXXOXOXOOXOOOOXOOOOOOOOOXOXOXXOOOOOOXOOXOXXOOOXOOOOOOOOOOXXOOXXOXOOOOXXXOXXOOOOOO
OXOXOXOXOXOOOXOXOXOXOOOOXOXOOOOOXOOOOOXOXXXOOXXOOOXOOOOOOOOOOXXOXOXXOXXOOOOOXXOXOOXOOOOXOOOXOXOXOXOXO
OOOOOXXXOOXOOXOXOXOOOOXOOOXXOOOXOXOOOXOOOXOOOOOOOOXOOOOOOOOOOXOOXOXOOOOOOOOOXOOOOXOOXOOOOOOOOOOOXOOOX
XOXXOOOXXOOXXOOXOOOOXXXOOXXOOOOOOXXOOOOOOXOOXOOOOOOOOXOOOOOOOOOOOOXOOOXOXOXOOXOOXOOOXOOXOOXXXXOOXXOOO
XXXXOXOXXOOXXOOOOOXOOXOOOOOXXOOXOOOOOOOXOOOOXXOOXOOOXOOOXOXOOXOOXOXXXOOOOXOOXXOOXOOXOXOOXOOXOOOXOOOOO
OXOOXOXXOOOOXXXOOOOOXOXOOOOOOXOXOXOXOOXOOOOOOXOOOXOOOXOOOOOOOOOXOOOXOOXXXOOXOOOOOOOOOOXOOXOXOOXOXOOOO
XXXOOOXOOOOOOOXXOXOOOOOXXOXXOOOXXOOOOXXOOOOOOOXXOOOOXOXOOOOOOOOXXOOOOOXOOXOXXOOOOOOXOOOOOOOXOOOXOOOXX
OOOXOOOXOOXOOXOXOOXOOXOOXOXOOXOOXOOXOOOXOOOXOXOOOOOOOOOOOOOOOXOXOOOOXOOOOOOOXXXOOOOOXOXOXXOOOXOXOXOOX
OXOOOOXOOOXXOOXOOXOOOOXOXOOXOXOOOOXOOXOOOXOXOXOXOOXXOOOOOXOOOOXOXOOOXOOXXXXOOOXOOXXOXOOOOOXOXOOOOOOOO
OOOOXOOOOXOOOXXOXOOXOOOOXOOXOOOOOOOOOXOXOXXOOXOOXOOOOXOOXXXOOOOOOXOOOOXOXOOOOXXOOOOOOXXXOOXXXXOXOOXOO
XXXOOOOXOXOOOXOOOOOOOXXXOOOOOOOOOOOOOXXOOXOOOOOXOOOXXOXOOOOOOXOXOOOOOOXXOOXOXOOOOXOOOOOOOXXXXOOOOOOXO
XOOXOOXOOOOOOXXOOOOOOOOOOOOOXXOXOOOOOOOXOOOOXOOOXOOOXXOXOOOOOOOXOXXOXOOXOOOOXXOOOOOXOXOXOXOOOOOXXOOOO
XOOXXOXOOXOOOOOOXOOOOOXXXOOOOOOOOXOOOOXOXOOXOOOXXOOOOOOXOOOXXXOOOOOOOXOOXOOXOXXXOOOOXXOOXXOOXOXOOOOOO
XOXOXOOOOOOXOOXOXOOOOOXOOOOXOOOOXXOOOXXOOOOOXOOOOOOOXXOOOXOXOOOXOOOOXXOOOOOXOOXOOOOOOOXXOOXXXXOOXXOOO
OOXOXOOOXOXXOOXXOXXOOOOOOOOOOOOOXXOOOOOOOOXOXOOXOXOXOXOXOOXOOOOOOOOOOXOXOOXOOOOOOOOOOOOOOOOOXXOXXOXOO
OXXOXOXXXXXXOOXXXOOXOXOXOXOOXOOXOOOXOXXOXOOOXOXOOOXOOXOOXOOOOXOXOOXOOOXXOOOOOXOXOOXXOOOXOOXOOOOOXOOOO
XOOOOOOOOOOOOOOOOXXXXOOOXOOOXXOOOOOOOXOOOOOOOOOOOXOOOOOOXOOXXXXOXOOXXOOOOOXOOXOXOOOOXOOOOOOOOXXOOOXOO
XOXOXXOXOOOXXOOXOXOOOOOXOOXXXOXOOOOOOXOXXOOOOOOOXOOOXOOOXOOOOOOXOOXOOOXOXOXXOOOOOXXXOXOOXOOOXOOOOOOOO
OOXXOXOOOOXOOOOOOOOOXOOOOOOOOOXOOXOXXOOOXOOOXOXOXOOOOOOOXOXOOOOOOOOOOOOXOOOOOOOOOOOXXXXOXOOOOXOXXXOOO
OXXOOOOOXXOOOOOXOOXOXOXOXXXXXOOOOXOOOOOXOOOXOOOXXXOOXOXXOXOOOOOOXOOOOXXOOXOOOOXXOXOXOOOXXOOOOOXOOXOXX
XOOXXXOOXXOOOOXOXXOOOXOOOOXOOXOXXOOXXOXOOOOOOOOOXOXOOOOOOOOXOOXOOOXOOOOXOOOOXOXOXXXXXOXOXOXOOOOXOXOOX
OXOOOXOXXXOOOOOOXXXOOXOOXXOOOOOOXOOOOOOOXOXOOOOOOXOOXXOOOOOXXOXOOOXOOXOXOOOOOOOOOOXOOXOOOOOOOOXOOOOOO
XOOOOOOOOXOXXOOOOOOOXXOXXOXOXOOXOXOOXOOOOXXXOXOOOOOXXOOXXXOXOXOOXOOOXOOOOOOXOXXXOOXXOXOOXOXOOOOOOOOOX
OOOOXXOOXXOOXOOOXOOOOXXOXOOOXOOOOXOOOOOOOOXOXOOOOOOOOOOXXXXXOXXOOOOOXXOOXXOOOXOXOOOOOOXOOOXOXOOXOXXOX
OXXOOXOXXOOOOXOOOOOOOXXOXXOOOOOOOOOOOXOOOXOXOOOOOOOOOOOXOOOOOOXOOOOOXOXXOXOXOOOXXOOOOOOOXXOOOXXOOOXXO
XXXOOXXOOOOXOOOOOOXOXOOOOOOOOOXOOOOOXXOOXOXXOOOOOXXOXXXOOOXXOOOXOOOXOOOOXOXOOOOXOXOOOXOXXOOXXXOOXOOOX
XOOOOXOOOXOXOXOXOOXXOXOOOOOXOOOXOOOOOOXOXOOOXOOOXOOXOOOOOOXXOOOOXXOOOOOOXOOOXOXOOOOOOOOOOOOOOOOOOXOOX
XOOOOOOOOOOOXXOOOOOXOOOOOXOOOXOXOXOXOOOOOXOOOXOOOOOOOXOOOOXOXOOOXOXOOXXOOOOOOOXOOXOOOOXOOOOOOOOOXOOOX
OOXOXXOOOXOOOOXOXOOXOOOXOOOXOOOOXOXOOOOXOOXOOXOXOOXOOOOOOOOOOOOXXXOXXOXOOXXOOOOOOOOXXOXOXOOXOXOXOXOOX
OOOXOOOOOOOOOOXOOOOOOOOOOOOOOOOOXOXOOOOXOOOOXOOOOXOOOXOXXOOOOOOXOOXOOOXOXXOOOXXOOXXOOOOOOOOXOOOOXOOOO
XOOOXOXXXXXOOXOOOOOOXOOOOOXOXOOXOXOOOOOOOOOOOOXXOOOXXOXXOOOOOOOXOOOXOXOOXXOOOOOOOOOOOOOOOOOOXOOXOOOOO
XOOOOXOXXOOOXOOOXOOXOOOXXXXXOOOOOXOOOOOOOOXOOXOOOXOOXXOOOOXXXXXOXOOOXXXOXOXOXOOOOOOXOOXOXXOOOOOXOOOXO
XOOOOXOXOOXXXXOOXOXXXXXOOOXXXOOOXOOOOXOOXOOXOOXOXOOXOXOOOOOXOOXOOOOOOOOXXXXOOOOOOOOOOOXOOOOXOOOOXOOOO
XXOOOXOOXOOOOOOOOOXOXOOXXOOXOXXOOXXOOOOOOXOOOXOOOXOOXOXXXOOOOOOXXOOXOOOOOXOOOOOOOOOOXOOXXXOXOXOOOXXOO
OXOOOOXOOOXXOOXOOOXOOOOOXOXXOOOOXOOXOOXOXOOOOXOOOOOOOOOOOXOXXOOOXOOOXOOOXXXOOOXOOOXOOOOXOOXOOXOOOOOOO
OXOXXXOXOXXOXOOOOOOOXOXOOOOOXOOOXOXXOXOOXXOXXOOOXXXOOOOOOOOXOOOOXXOOOOOOOOOOOXOOOOOOOOOXXOOOXOOXXXOOX
OOOOOOOOOXOOXOOOXOOOOXOOOOOXOOOXOOOOOOOXXOXXOOOXXXOOOXOOOOXOOOOOOXXXXXOXOXOOOXOOOXXXOXXOOXOOOOOOOOXOO
XOOOXXOOOOXOOOOOOOXOOXOOXXXXOXXOOOOOOXOOOOOOXOOOOOOXXXOOXXOXXOXXXOOXXOOOXXOXOXOXOOOOOXOOXXXOOOXOXOOOX
XOOOOXXOXOOXXOOOXOXOXOXXXXOXOXXXOXOOOOXOOOOXOOOOOXOOOXXOOOOOOOOOOOOOXOOOXOOXXOOOOOXXOOOOXXOXOOOOOOOOO
XXOOOOOOXOOOOXOXOXOOOXOOOOOXXOOOXOOOOOOOOOOXOXOOOOOOOXXOOOOOOOXOXOXOOXOOOXOOOXOOOOXOOXOOOOOOOOOXOOOXO
OOOXOOOOOOOOXXXOOOOOOOOOOOOXXOXXOXOXXXOOOOOOOOOXOOXOXXOXOOXOOOOOOXOXOXOXOOXOOOOOXOOOOOOOOOOXXOOOOOOOO
OXXOOOXOOOOOOOOOOOOOOOXOXOOXXOOXOOOOOOOXOOOXOOXXOOOOXOOOOXOOOOXOXOOOOXOOXOOXOOOOOOXOOOOOOOOOOXOOOOOOX
OOOOOOOOXOXOXOXOOXOOOOOOOOXXOOXOOOXOOXOOXOXOOOOOOXOOOXOOXXOOOOOOXXOOOXOXOXXOOXOXOXOXXOOXOOOXOOOOOOOXO
XOOXXOXOOOOOXOOOXOOOOXXXOXOXOOXOOXOOOXOXOXOOXOOXOOOXOOOOOOOOOXOXOXXXXOOOXOOOXOOXOOOOOXOXXOXOOOOOOOOOO
