OOXOXOOOXXXXXOOXOOOOOOOOOOOXXOXXXXXXXXOXXOOXOOOOOXOXOXOXOOOOOOOOXOOOOOOXOXOOXOOOOOOXOOOXOOOOOOOXOOOOO
OXOOOOOOOXOOXXXOXOOOXOOOOOXOOXOXOOXOOOOXOOOOOOXOOOOOOXOOXXXXOXOOXOOOOXXOOOOXXOXXOXOOXOOXXOXOXXOOOOOOX
OOOOXOOOOOOOOXOOXOOOXXOXXOOOOXOOXXOOOOXOOOOOOXOOOOOOOOOXOXXOXXOOOOOOOOOOOOOOOXOOOXOXOOOOXXOOOXOOXOOXX
OOOXOOXOOXOOOOOOXOOOOOOOOOOXOXOOOOOOOOXOOOOXOXOXOOOOOXOXOOOXOOOOOXXOOXOOXOOXXXOOXXOOOOXXXOOXOOOOXXOOO
XXXOOOXXXXOOOXXOOOXXOOOOOXOOOXOOXOOOXOOXXOOOXOXOXOXOOOXOXOOXOOOOOOOXOOOOOOOOOOXOOOXOOOXOOXOOOXOOXXXXX
OXXXOOOOOOXXOOXXOOOXXXXOXXXXXOOOOXOXXOOXOXOOOOOOOOOOOXOOOXOXOOOOOOOOXOOOOOOXOOOOOXOOOOXOOXXOOOOOOOOOO
OOOOXXXXOOOOXOXOOOOOXOOOOOOXOOXOOOXOOOOOXOOXOXOXOOOXOOOXOXOOOOXOOOOOOOOXOOOOOOOXOXOOOOOOOXXOOOOOOOXOO
OOOXXOXXOXOOXOOOOOOXOOOOOOXOXOOOOXXOXOXOOOXOXOOOOOOOOOXOOOOXXOOOOOOXXXOOOOOOOXXOOXOXOOXOOXXOXXOOXOXXX
OOOOXOOOXOOXOOXOXOOOOOXOOXOXOOOOOOOOOOOOOOOXXOOOXOOOOOXXXOXOOOOOOOOOXOOOXXXOXXOXXOXOOOXOOOOOOOXOXOOOX
OOOXXOOOOOOOOXOOOOXXXOXOOXOXXOOOOOXXOXOXOOOOOOXXXXXOOXOXXOOXOOOOOOXOOOOOOXOOOOXXOOOXXXOXOXXXXOOOXOXXO
OXXOOOOOOOOOOXOOOOOOOOOOOXOXOOOOOOOOOOXXXOOXOXOOXOXOOOOOOOOOOOOOXOOXXOOOOXOOOOOOOOXXOXXOOXOOOOOOOOOOO
OOOOOOXOOOOOOOOOXOOOXOOXXOOXOOOOOOOOXXOOXXOXOOOOXOXOXXOXOOOOOOOOXOOOOOOXXXXOXOOXOOOOOOOXOOOXOXXOXXXXO
XOOOOOOXXOOOOOOXOXOOOOOOOOOXOOOXXXXOOXXXOOXOOOXXOXOOOOOOOOOOOXOXOOOOXOXOOOOOXOOOOOOOXXOOOOOOOXOOOXOOO
OOXOXOOOOOOOOOOXXOOXOOOOOOXXOOOXOOOXXXXXOXXOXOXOOOOOOOXOOOOOOXOOXXOOXOOOOOOXXOOOOXXOOOOOOXOOXXOOXOXXO
OOOOOOOOOXXXXOOOOOOXOOOOOOXXXXOOXOOOOXXOXOOOXOXOXOOXXOOXOOOOXXOOOOOXXOOXOOOXOOOXXXXOXXOOOOXOXOXXOOOOO
OXOOXOOOXOXOOOXOXOXXXXOOOXOOOOOXXXOXOOOOXOOXXOXXXOOOOOOXXXOOXXXOXXOOXOOOOOXOOOOOOXOOOOXOOOOXOOXOXXOOO
OXXOXOOOOXOXOXXOXOOOOXXXOOOXOOOOXXOXXOOOXXOXOOXOOOOXOOXOOOXOXOXOOOXOOXOXOOXXOOOXXOOOOOOXXOOOOOOOOOXXO
OOXOOOXOOOOOOOXXOOOOXXOOOOOOOOXOOOOOXXOXOOOOOOXOOXOOOOXOOOOXOXOXOOOOXOOOOXOOOOXXOOOOOXOXOOOOXOOOOOOOO
OOXOXOOOOXXOXOXOXOXOOOOOOOOOOOOXXOOOOOXOOXOOOXOXOXOOXOOXOOOXXOOOOOOOOOXXOOXXXOOOXOOOOXOOOOXOOOOOXOOOX
OOOOOOXOOOOXOOXOOOOXXXOOOOOXOXOOOXOOOXXXOOOOXXOOOOOOOOXOOXOOXOOOXOOOOOXOOOOOOOOXXXOXOOXXOOOXOOOXOOOXO
OXOXOOOOOOOOOOOXOOXXOOOOOOOOOOXXOOOOXOOOOOOOOOOOOOOXXOXOOXXOOOOXXXOXOOOXOOOOOOOOXOOOOOOOXOOOOXXOOOXOO
OOXXXXXOOXOXXOOOXOOOOOOOOOOOOOXXXOOOXOXOOOOOOXOOOOOOOOOXXOXXOXXOOOOOOOOOXOOOOXOOOXXOXXOXXXXOOOOOOOOXO
XOOOXOXXOOXOOXOOXOOOOOXXOOOXXOOXXXXOXOOOOOXXOOOOOXOOXOOOXOOXOOOOOXOOOXOOOXOOOOOOXXOOOOOOOOOOOXOOXOXOX
OOOOOXOXOXOOOOXOOOOOOOOOOOOOOOOXXOOXOOOOOOXXOOOXOOOOOOOOOOOXOOOXOXXXOOXOXXOOXOXOOOOOXOOOXOOOOOXOOOOXO
OOOOXXOOXXOXOXOOOXOOOOOOOOOOOOOOXOOOOXOOOOOOOXOOOOOOOXOOXOOXOOOXOXXOOOOOOXOOXOOOXOOXXXXOXOXXOOOOXXOOX
OOOXOOOXOXXOXOXXXOOOOXOOOOXXOOXOOXXOOOOOOOOXOXXOOXOOOOXOXOXXOOOOOOOOOXXOOOXXXOOOOOXXXOXOOXOXXXXOOOOOX
OOXXOOXXOOOOOXOOOOXXXOXXXOOOXOXOOOXXOOOXOOOXOOOOOOOOOOOOXOXXOOOOOXOOXXOOOOOXOXOXXOXOXXXOXOOOOXOOOOOXO
OOOXXXOXXOOOOXOOOXOOXOOOOOOXXOXOOXOOXOOOXOOOXXXOXOOOOOXOOOOXOXOOOOXOOOOOXXOOOOXOOXOOXOXXOOOOOXOXOXXOO
OXXOOXXXOOOOOOOXOXOXXXOOOOOXOXXOXOOOOOOOOXOOXOOOOXOOOOOOXOXXOOOOOXOOOOOOOOXOOXOXXXOXOOXOOXOOOOXOXOOOX
OXOXXOOXOOOOXOXOXOXOOOOOOOXXOOOOXOOOOOXXOOOXXOOOOOOOXXOXOOXOOXOOOOOXOXOXXOOOOOOOOOXOOOXXOOOOOOOXOXOOX
OOOXOOOOOOOOXOXOOOOOOOOOOOOXOOOOOXOOOOOXXOXOOOOOOOXOOOOXXOXXXXOOOOOOXOOOXOOXOOOOOOOXOXXOOOOOXOOXOOXOO
XOOOOOXOXOXXOOXXOOXOOOOOOOXOOOXXOXXOXOOOOOOOOOOXOXOOOXOOXOOXOOOOOOOXXOXXOOOOOXOOOOXOOOXXOOOOOXOOXOXOO
OOXOOOXOOOOOOOXOOOOXXOOOOXOOXOXOOOOOOOOOOXOXOOOXOXOOXOXOOOOOXOXOXOOOXOOOXXOXOOOOOOOOOOOOXOXXXXOXOXXXO
OXOXXOOXXXXOOOOOOOOXXOOOOOOOOOXOOOOOOXOXXOOOXOOOOOOOOOOOOXXOOOOOOOOXOOOXOOOXOOOXOOXXXOOOOOXOXOOOOXXOO
OXOOXOOXXOOOOOOOXOXOOOXOXXXOOOOXXXOOOOXXOOXOXXOOOOOOXXXXOOOOXOOOOOOOXOOOOOXOOXXOOXXOOOXOOXOOOOXOXXOXO
OXOOOOOOOOOOOOOXOOOOOXOXOXOOOOOOOOXOOOOOXOXOXOXOOOOOXXOOOXOXOOOOOOXOOXOOOOOOXOOOXOOOOOXOXOOOOOXOOOOOO
XOXOOOOXOXOOOOOOOOOXOOOXOXOOOXXOOOOXOOOXOOOOXXOXOOOOOOOOOOXXOOOOOOOOOXOXOXOXOOOOXOXXOOOOOOXOOXOXOXOXO
XOOXXOXOOXOOOOOOXXOOXXOOOOOXOXOXOOXOOOOXOOOOXXOOOOXOOOXOOOOOOXXOXXXXOXOXOXXXOXXXOOOOXOOOXOOXOOOXOXOOX
OOOOXOXOXOOOOOOXOOXOOXOOOOOOXOOOOOOOOOOOOOOOXOXXOOXOOOOXOOXXXXOOXOOXOOOOXOOOOOOOOXOOOOOOOOOOOOOOOOOOX
OXXOOOXOOOXOOOXOXOOOOOXOOXOOOOOOOOOXOOOOOOXOOOOOOOOXXOXXOXXOOOOXOOXOXOXOXOXOOOOOOOOXOXXOOXXOOOOOOXOXO
OXXXOOXOOXXOOOOXXOOOOXOOOXXOOOOOOOOXOXOXXOXXXOOOOOOOOXXOOOOXXXOOXOOXOXXOXOOOOOOOOOXOOOOOXOXOXXOOOOOOX
OXXOXOXOXOOOXOOOXOOOOOXXOOXOOOOOXOOOOOOOXOXXOOOOXOXOOOOXOOOOOOOOOXOXOOOXXOOXOOOOOOOOXOOXXOXXXOOOXOOOX
OOXOXOXOXOOXOOOOOOXOOOXXOOOOOXXOOOXOXXXXOOOXOOOOOXOOOOOXOXOOOXOXOXOOOXOXOOOOOOOOOOOOOXOOOOOXOOXXXOXXO
OXOOOOOOXXOOXOOOOOOOXOOOOXOOOOXXOOOXOXXOXOOOOOOXXXOOOOOOOXOOOOOOOOOXOOOXXOOXOOOOOXOOOOOXXXOOXOOXOOOXO
OOOOOXXOOOXOOOOOXXOOXXXOXXOOOOOXOOXOOXOOOOOOOOOOOOOXOOOOOOOXOXOXOXOOXOOXOXXOOXOOOXOOOOXOOOOXXOOXXXOXX
XOXXXOOOOOXOXOOOXOOOXXOXXOOOXOOXOOOOOOXXOOOOOOOXOOOOOOOOOOOXOOXOXXXOOOOXXOXOXXXOOXOOOOOOOOXXOOOXOOOXO
OOOOXOXOOOOOOOOOOOOOOOXOOOXOXOOXOOOOOOOOXXOXOOXXOOOOOOOOOOXOXOOOXOOXXXOOOOOOXOOOOOOOOOOOOOOOOOXOXXOXO
OOXOOXOOOOOXOXOOOOXOOOOOOXOOOXOOXOOOOOOOOOXXOOXOOOXOOOOOOOOOOXOXXOOOXOOOOOXOOXOXOXOOXOXOOXOXXOOOXOOOO
OXOOOOOOXOOOXOXOOXOOOXXXOOOXOXOOXOOXOOOOXOOOOOOOOOXOXOOOOOXOOOOOOOXOOOXOOOOOOXOXOOOOOOXXOOOOOOXXOXOOO
OXOXOOOOXOOOXXOOXXOOXXXOOOOXOOXXOXOOOXOXOOOOOOOXXOOOOOOOXXOXXOOXOOOOOOOXOXXOOOOOOOOOOOOOOXOOXXOOXOXOO
XOXOXOOXOOOOOOXOOOXOOOOOOOOXOOXOXOOXOXOXOOOXOXXXOOOXOXOOXOXOOOOOOOXOOOOXXOXOXXOOOOXOOOXOOOXOOOXOOOOOO
OXOXOOOXOOOOXXOOXXXOOOOOOOXXOOOOOXOOXOOOOOXOOOOOXXOXOOOXXOOOOXXOOOOOXXXOOXXOOOOXOOXOOXOOOOXXXOXOXOOOO
XOOOXOOXXOXXOOOOXOOOOOOOOOXXOOOXOOOOOOOXOOXOOOXXOOOOXXOOOOOXOXOOOXOOOOXOOOOOXOOOOOOOXOOOOXOXOOXXOXOOO
OOOOOOXOOOXOOXOOOXOXOOOXXOOOOOOOXOXXXOOXOXOOOOXOOOXXXOXOOOOXOOOXOOXOXOOOOOOOOOOOOOOOXOOXOOXOOOOOOOOOO
XOOOOOOOOOXOOOOXOOOOXOOOOXOOXOOXOXOOOXOOXXXXOOXOXOOOXXXOOOXXOXOOOOOXOXOXOXOXOOOXOOOXOOOOOOXXOXOOOOXOO
OXXXXOXOOOOOOXOOOOOXXXOOOOXOOOOOXOOOXOOXXXOOOXOOOOOOXOOOXXOOXOOXOXXOOOOOXOOXOXOXOOOOXOXXXOOOOOOOXOOOX
XOOOXOOOXOOOOXOOOOXXXOOOOXOOOOXOOOOOOOXOOOOXOOOOXXOOXOOOXOXXOXOXOOOOXOXOOOOOOOOOOXOOOOOOOOOOXOXOXOOOO
OOOOOOOOOOOXOOOXOXXOOOXXXXXXOOOOOXXXOXOOOOXOXOXOOOOOOOOOXOXOXOOOXOOXOOOOOXOOOOOOOXOOOOOOXOOOOXXOXOOOX
OOOOOOOXXXOOXOXXOXOXXOOOXOOOOOXXOOXXOOOOXOOXOOOOOXOOXXOXXXOXOOOXOOOOXOXXOXOOXOXOOOOOOOOXOXOOOOOXOXOOO
OOOOXOOOOXXXOOOOOOXOOOOOOOOOOOOOXOXOXOOXOOOXOOXXOXXXXXXOOOXXXOOXOOXOOXOOOXOXXOXXOXOOOXXOOOOXXOOOXOOOX
OOOOOOOOXOXOXOOOOXOXOOOOXXXOXOOOOOOXOXOXXXXOXOOOXXOOOXOOOOOOXOOXXXOXXOXOOXXOOOXXOXOOOOOOOOOOXXOOOOXOO
OOXXXOXOOOXOXOOOOXXXOOXOOOXOOXOXOOOOXXOXXOOXOXOOOXOOOXXOOOOOXOOOOOXOXOOOOXXXOXOOOOOOXOOOOXXOOOOXOOOOX
OXOOXXOOOXOOOOXOXXXOOOXXXOXOOOOOOOOOOOOOOOOXOOXOOOOOXXXXXOXOOXXOOOOOOOOOOOOOOXOOXXOOOOOXXXOOOXOOXXOOX
OOXOOOOOOXOOOOXXOXOXOXOXOOOXOOXOXOOOOOOOOXXOXOOOOOOOOOXXOOXXXOOOOXOXXXOXXOOXOOOOOOXOOOXOXOXOOXXOOOXOX
OOXXOXXXXOOXXOOXOXOXXOXOOOOXOOOOOOOOOOOOOOOOXOXOOOOOOOOOOXXXOOOXOOXOOOOXOOOOOOOOOXOOOOOOOOXXOOXOOOXXO
XOXOOXOXOOXOOOOXOXOOXOOXOOOXOOOOOXOOOOOXOOXOOOXOXXOXOOOOXOOOOXXOOOXXXXOOOOXOXOOOOOOOOXOOOOOOXXOOXXOOX
XOOOOXOOOOOXOOOOXXXOOOXOXXXOOOOXOOOOOXOOOXOXOOXOOOOXXOXOOOOOOOXOOXOOOOOOXOOXOOOXOOOOOOOOOOXOOOXXOOOOX
OXOOOOOOOOOOOOXOOOXOOOXOOOXOOOOXOOXOXXXOOOOOOXXOOXOXOOXXOOOOOOOOXOOOOXOXOOXXXOXXOXOOXXOOOOOOOXOOOOXOO
OXXOXOXOXXOXOXOOXOXXXXOOXOXOOXXOOOXXXOXOOOXOXXOXOXOOOXOOOXOOOOOOOXOXOOXXOXOOXXOOOOXXXXXOOOXXOXOOOXOXO
OOXOOOXOXXOOXXOXOOOXOOOXXXOOXOXXXOOOOXXXXOOOOOOOOOXXOXXOOOXXOOOOOOXOOOXOXXOXOOOOOXOOOOOXXOOXOOOXOOOOX
XOXOOXOOXXXXXOOOOOOOOXOOOOOXXOOOOOOOOOOOOOOOOXXXOXOOOOOOXXXXOOOXXOXOOXOOOOOOOXOOOOXXXOXOOOOOOOOOXOOOO
OOOXXXXXOOOOOOOXOOOOOOOXXOOOOOOXOOXXXOOOOXOOOOXOXOOXOOOOOOOXOOOOOOOOOOXXOOOXXOOOXOOOOOOOXXOOOXOOOOOXX
OXOXOOOXXOXOOOXOOOXOOOOOOOOOOOOOOXOOXOXXOOOOOXOOXOXOOOOOOOOOOOOOOOOOXOXXXOOOXOXOXOXXOOOOOOOXOOXOOOOOX
OOOOXOXOOOXOOXOXXXOXOXOOOXOXOOOOOOOOOOOOXOOOOOXOXXOXOXXOOOOOXOOOXXXOOOOXXXXXXXOOXOOXOOOOXXOOOOOOOXOOX
XXOOOOOXOOOOOOOOOOOOXXOOOOXXOXXOXOXXXXOXOXXOOOOOXOOXOOOOOOOOOOXXXOOOOXOOOXOOOXOOOOOOOOXOXOOOOOXOOOOOO
OOXOXOOOOOOOXOOXXOXOOOOOXOXOOOOOOOOOOXXXOOXXOXXXOXXOOXXOXXOOXXXXXXOOOOOOOOOOOXOXXOOOOOOOOOOOOOXXOOOOX
OOOXOOXXOOOOOOOOXXXXOXXOOXOXOOXXXOOXOXOOOOOOOOOOOOXOOOOOXOXOOOOOXXOXOXOOOOOOOOXOOOOOXOOOOOOOOXOOXXXXO
OOOXXOOOXOOOOXOOOOOOXOXOXXXXOOOOOOXOXOOOXOOXXXXOOOXOOOXOOOXXOOOOOOXOOOXXXOOOOOOOXOOOOXOOXXOOXXXXOXXOO
OXOOOOOOOOOXXXOOOOXOOOOOOXOOOXXXOOOOOXOOXOXXXOOOXXOOOOOOXOOOOXOOXOOXXOXOXOOOXOXOXOXOOXXOOOXOXOXXXXXOO
XOOXOOOXOXOOOOXXXOXXOOXOOOOOXOOOOOOOXXOOOOOOOOOOOOXOOOXOOXOOOOOOOXOOXXOOOOOOOOXOOXOOOOOOOOOOOOXOOXOOO
OOOOXOOOOOOOXOOOOXXOOOOOOOOOOOXOOXXOOOOOXOOOOOOOOXOXOOOOXOOOXOXXOOXOXOXXXXOOXOOOXOOOOOXOOXOOXOOOOXOOO
XOOOOXXXXOOOOXXOXOOOOOOOOOXOOXOOOXXXOXOOOOOOOOXXXOOOOOOXOXXOOOOXXOOOOOXXOOOOOXOOXXXOOXOXOOOOOOOXOOXXX
OOXXOOOOOOOOXOXXOXOXOXOOOXOOXOOXOXOXXOOOOOXOOXOXOOXXOOOOXOXXOOOOXOOOXXOXXOXXXOXXOOXOOOXOOXOOOXOXXOXXO
OOOOXOOXOOOOOXOOOOOOOOOOOXXOOOOOOXOOOOXXXXOOOXXOXXOOOXOXOOOXOOOOOOOOXXXXXOXOXOXOOOXOXXOOXOOXOOOOOXOXO
OXOOXOOOOOOOXXOXXOXXOOXOOOOXOOOOOXXOXOOOOOOOOOOXOXXOOXOOOOOOXOXOOOXXOXOOOXOOXOOOOOOOXXXOXOOOOOOOXXOXX
XXXXOOXOOOXOXXOXOOOXOOXXXOOOOOOOOXOXOXOOOOOOXOOOOOXOXXOOXXOOOOOXOOOXOXOOXOOXXXXOXOOOOXOOOOOOOOOOXOOXO
OOXOOOOXOOXXOOXOXOOOOOOOOXOXXXXXOOOOXOOOXOOXOOXOXOXXOOOOOOOXOXXOOOOOXOXOXOOOOOOOOOXXOXOOXOXOXOXXOOOOX
OXOOOOOXXOOOXOOXXOOOOOXOXOOOOOOOXOOOXOOOOOOXOOOOOXXXXXOOOOOOXOOOOOXOXXOOXXXOOXXOOXXXOOOXXOOXOOXOOOOOO
OOOOXXOOOOOXOXXOOXXOOXOOOOOXOXOXOOOOOXXOOOXOOOOXOOXOOXOOOOOOOOXOXOOOOXOOOOOXXOXOOXXOOOOOOXOOXXOOOOOOO
OOXXXXOXOOOOOOXOOXOOOXOOOOOXOOOOOOOOXOOOXXOXOXOOXOOXOOOXOOOOXXOOOOOXXOOXOOOOXXXOOXOXOXOOOOOOOOOOXOXOX
XOOOOOOOOXOOXOOOXOXOOOOXOXOXOOOOOOOOXOOXXOOOOOOOOOOOOOXXXOOOOXOOOOXXOXXOOOOOOXOXOXOOOXOOOXXOOXXOOXOOO
OOOOOXXOOXXOOXOXOXOOXXXOOXOOOXOOOXOOXXXOXOXXXOXXXXXXOOXOOXXOOXXOOOOOOOOOOOOOXOXOOOXOOOOOOXOOOOOOOXXOX
OXXOOXXXOXOOXOXOOXOOXOXOOOXXOXOXXXOOOXOXOXOOOOOXXOXOXOXXOOOOOOOOOOXOOOOXOXXOOOOOOOXOOXXXOOXXOXXOOOOOO
OOOOOXOOOOOXOOOOXXOOXXOOXOOOXOOOXOOOOOOXOOXOOOOOOXOOOOOOOOOOOXOOOOOOXOOXXOXOXXOOXXOOOOXXXOXOOOOOOOXOO
OXOXOXOOXOOXOXOXXXOXXOOOOOOOOOOOOOOXOOOOOOOXOOOXXXOOOOXOXOXXXOXOOOOXOOOOXOXOXOXXOOOOOOXOXOOXOOOOOOOOX
OOOOOOXOOOOOOOOOOXOOOOOOOXOOOOXOXOXXOOXOXXOOOOXOOOOOXOOOOXXOOOOOOOOOOOOOXXOOOOXXXOOXOOXOOXOXOXXOOOXXX
XOOXOOOXOOOOOOXOOOOOXOOOOOOXOOXXOXOOOOXOOOOOOXOOOOOXOOXOOXXOXOOOOOOOXXOOOOOOXOXOXOOXOOXOOOOOOOOOOXOOO
OXOOOOOOOOXXXOXOOOXOOXOOOXXOXOXXOXOOOXOOOOOOOOOOXXOOXOXXOOOOOOOOOOXOOOXXOXXOOOXOXOOOOXOXXOOOXXXOXOOXO
OOXXOOOOOOOOXOOXOXOOXXXOXOOOXOOOOOOOOOXOOOOOOXXOOXXOOOOOOOOOOOOOOOXOOOOOOXOOOXOXOOOOXOXXOOXXOOOOOOOXO
OXOOOOOOOOOOOXOOOOXXOOOXOOOXOOOOOOOOOOXXOOXOXOOOXOOXOOOXOXOOXXOOOOOOOOOOOOXOXOOOOOOOXXOOOXOOOOOOOOOOO
OXXOXOOXXOXOOXOOOXOXOOOOOOOXOOOOXOXOOOXOXXXOOOOOOOOOOXOOOXXXOOOOOXOOOOOOOXOOOXOOOXXOOXOXOXOXOOOXOOOOO
