OOOXXXOOOOOXOOOXOOOXOOXOXOOXOXOOXOOOOOXOXXOXOOOOOOOXOOOXXOXOOOXOOOXOOOOOOOXOOOOOOOXOXOXOOOXOOOOOOOXOO
OOXOOOXOXXOOOOXOOOXOOOOXOOOOOXOOOOOOOOOOOOOXXOXOOOOOOOOOXOOOOXOXXXXOOOXOOOXOOOOXOXXOOXXOOOOOOOOOOOXOX
OOXXOOOXOXOXOOXOXOOOOXXOOXOOOXOXOOOXOOOXXOOOOOOOXOOOOOOOOOOOXXXOOOXOOOOXOXOOOOOOOXOXOOXOOOXOXOOOXOXOO
OOXXOOOXOOXOOOOOXOOXOXOOXOOOXOOOOOXXOXXOOOOXXOXXXXOOXOXOXOOOOOOXXOXOXOOOXOOOOOOOOOOOXOOOOOOOOXOOOXOOX
XOOOOXOOOOOOXOXOOOOXOOOXOOOXOOXOOOOXOOOXOOXOOXOXOOXOXXXXOOOOOXXOOOOOOXOOXXOOOXOOXXOOXOXOOXOOOXOOXOXXO
OOXOOOOOOOOOOOOXXOOOOOOOOOXOXXOOOXXOOOXXOOXOOOXXOOOOOXOOXOOXXOOXXXOOOXOOOOOOOOOXXOOOXOOOXXOOOOOOOXOXO
XXOOXOOOOOOXOOOOOOOXOXOOOOXXOOOXOXOXOOOXXOOOOOXOOXXOOOOOOOOOOXXOOOXOXOOOXOXOOOXXXXOOOOOOOOOOOOXXXOOOX
OXOXXOOOXOOOXOOOOOOOOOXOXOOOOXOOOXOOXOOOXOOOOOOOXOXOOXOOXOXOOOXOOOOOOXOXOXOOOOOOXOOXXXOOOOOXOOOOOXOXO
XOOOOOOOOOOXOXXOOXOXOOXOOXXXOXXOOOOOOOOXOXXOOOOXXOOOOXOOXOOOOOXOOXOXOOOOXXOXOXXOOXXOXOOOOXOXOOXXOXOOX
XXOXOOOXOOXOOOXOXOXXOXOOXOOOXOOOOXOXXOOXXOOOOOXXOOXOXXOOOOXOOOXXXOXXOOXXXOOOOOOXOOOOOOOOOOXOOOOXOOOOO
OOOXOOXOOOOXXXXOXOOOXOXOOOOOOOOXOXXOOOXXOOOOOOXOOOOOOOXXOOXOXXXOXOOXXXXXXXOXXOOXXOOOOOOOXXOOXOXXXOOOO
OXOOOXOOOOOXXOXOOOOXOXOXOXOOOXOOOOXXXXXOOXOOOOOOXOOOXOXOOOOOXOOXOXOXOXOOOOOOOOOOOXOXOOOOOOOXOOOOXOXXX
XXOOOOOOOOOOOOOOXOOOXOOXOOOOXOOOXOXOXOOXOXOOOXOXOOOOOXOOOOOOOXOXOOOOOOOXXXXOOOOXOOOOOOOOXOOOXOOXXOXOO
XXOXOOOOOXXXOOOOOOOOXOXOOOXOOOOOXXXOXOXOOOOOOOOOOOXOOOOXOXOXXOOOOOOOOOXOOXOOOOXXOXOOOOXXOOXXOOOXOOOXO
XOOOXOXOOXXOXOOXXOOOOXOOOXOOXOXOOOOXXOOOOOOOOOOOXOOOOOOOOXOOOXOOOXOOOXXOOOOXXOOOOOOOOOOXXOOXXOOXOOOXX
OXOOOXOXXOOXXOXOXOXOOOXOXOOOXOXXOOOOOOXOOOOOOOOOXXOOOXOOOOXOOOOXOXOOXOXXOXXOOOOOOXOOOXOOXOXOXOOOXOOOO
OOOOXXOXOOXOOXOOOOXOOOOOXXOXXOXOOOXXOOOOXXOXXOOOXXOOOXOOOOOOXOXOOXXXOXOOOOOXXXOXXOOOOOOOXXOXXOXOXOOOO
OXOXXOXOOOXXOOOOXOXOOOXOOOXOOXOOOXXOOOOXXOOOOXOXOXXOOOOOOOOOOXOXXXOXOXOOXOXOOOOXOXOOOOXOOXOOXOXOOXXOX
OXXOOOOXOOOOOXOOOOOOOOOOOXXOXOXOOXOXOOXOXXXOOOXOOOOOXOOXXOXOOOXOOOOXOOOOOOOXOOXOOOXXOXOXOXOOXOOOOOOOO
OXXOOOXXOXOOOOOOXOOXOOOOOOOOOOXOOOXOOOOOOOXOOOOOOOOOOOOOXOOOOOOOOXOOOXOOOOOOOXXXXXXXXXXOOOXOOOOOOXOXX
XXOOOOOOOOOOOOOOXOOOOOXXOOOOXXXOOOXOXOOOOOOOOXOOOOOOXOOOOOXOOXOOXOOOXXXOOXOOOOOXXOXOXXXOOXOOOOOOOXOOX
OOOOOOOOXOXXOOOOXOOOXOXOOOOOOOXOOOOOOOXXOOXOOXXOOOOOOXOXOXXOOOOOXOOOOOOOXOOOOOOXXXXOXXOXXXOXOOOOOOOXO
OOXOOOOXXXOXXXXXOXXXOOXXOXOOXXOOOOOOOOOXOOXXOOOXXOOOOOOXOXXOOOOOOXXOXOOXOOOOOOOOXXOXXXOXOOOXOOOOXXOOO
OOOOOXOOOOOOOOOXXOOOOOXXXOOXOOOOOXOOXOOOOOOXXOOOXOXOXOOXOOOOOXOOOOOOOXOOXOOOXOOOOOXOOXOOOXOOOOXOOXOXX
OXOOOXOXOOOOXOOOOOXOXOOOOXXXOOOOOOOXOOOOOXXOOOOXXOOOOOOXOOOXOOOOXOOOOOXXOXXOOXXXOXOXOXXXOXXXOOOOOXXOO
OOXXXXOOXOXOOOOXOOOXXOOOOXXOXOXOXXOXOOOOOOOOOOOXOOOXOOOOOOOOOXXXOXOOXOOOXOXOOOOOOOXXOOXXOOOXOOOOOOOXO
OOOOOOOXOOXOOOOXOOXXOXXOXXOOOOXOOXOOOOXOOXOOOOXXOOOOOOXXOOXOOOXXOOXXOOXXXOOOOOOOXOXOOOOOXXXOOOOOOOXOX
OOXOOXOOXOOXOOOOOOOOXOOOOOOXOXOOOXOOOOOXOOXOOOXOOOXOOOOOOOOXXOXXXOOOOOOXXOOXOOOOOOOOOOOOOOOOOOOXXOXOX
OOOOOOOOOXOOOOOXOOOOOXOOOOOOOOOOXOOOOXOOOOOXXOOOOOOXXXXOOXXOOOOOXOOOXOXXOOOXXOXOXXOXOOXXOXXXOOOOXOOOX
XOOOOXXOOOOOOOOXOOXOOOXXOOOXOOOOXXOOOOXXXXOXOOOOOOOOOXOOXXOOXOXOOOOOOOOXOOOXXOOOOOOOOOOOOXOXXOOOXOOOO
OOXOOOOOOOOXOOOXOOXOXOOOOOXXOOOXOOOOXXXOOXOOOOOXOXOOXXOOXXOOOOOOOOOOXXXXOOXOOOOXOOXXOOOXXOXOOOOOOOOXO
XOXXXOOOXOOXOOOOOXOOOOXOXOOOXOOXOXXXOOXXOOOXOXOOXOOOOOOOOOOOOOXOOOOXXOXOOOXOOOOXOOOOOXOOOOXOOOOXOOOOX
OOXOOXOOOOOOOOOOXOXOOOOOOXOOOOOOXOOOOOXOXOXOOOOOOXOOOOOOOXXOOOOXOOXXOOOOOOXOOOXOOXXOOOOOOOXOXOOOXXOXX
OOOOXOOXXOXOOOOOOXOOOXXOOXOOOXXOOOOOOOOOOXOOXOOOXOOOOOXOOOXOXOOOOOOXOOOOOXOXOOOOXOOXOXXOXOOXOOXOXXOOX
OOOOOOOXOOOXOXXOOXOXOOXOOOOOXOXOOOXOOOOOXXXOOXOOOOOOXOOXXOOOXOOOXXXXOXOOXXOOOXOOXOOOOXOXOOOOOOOOXXOXO
XOOOOOOXXOOXOXXOOOOOOOOOOOXOXOOXOOOOXXOOXOXOXXXOOOXOOXOXOOOOOOXOXOXXOOOOOOXOOOXOOOOOOXOXOOOXOXOOOOXOO
OOOXOOXOOOOOOOOOOXXOXOOOOXOXXXOXOOXOOXOOXXOOOOOXOOOOOOOOOOOOOOXOOOOXOXXXOXOOOXXOOXOOOOOOOOOOOXOXOOOXO
XOOXOXOXOXXOXOOOXOOOXOXOOXOOOOXOOOXXOOOOXOOXOOXOXOOOOOOXOOOOOXXOOXXOXOOOOXOOOXOOOXOOOXOOOOOOOXOXOOXOO
OOOXXOOOOXOXOOOOOOOXOOOOXXOOOOOOOOOOOOOOOOOXXOOOXOXXOOOOXXXOOOOXXOXOOOOOOOOOXOXOXOXOOXXXOXOOXOOXXOXOX
OOOOOOOXXOOOOXXXXOOOXOOXOOOXOOOOOOOXOOXOOOOOXOXXXOOOOOOOOOOOOOOOXXOXOOOOOOOOOXXOOOOXOOOXOXOOOOXOXOOOX
OOXOXXXOXOOXOOOXOXOOXOOOXOXXOXOOOOOOOOOOOOOOXOOOXOOOOOOXOOOOOOOXOOXOOOXXOOOXOOOXOOOOOOOOOXOOOXOXOXOOX
OOOOOOOXOOOXOOXOOOXOXOOOOOXOOOOOXXOOXOOOOXOOXOXXOOOOOOOXXOOOOOOXOXOOOXOXOOOOXOOOOXXOXOOXXOOOOXOXXOOOO
OOOOXOXOOXXOOOXOOOOOXXOXOXXOOXXOXXOOOOOOOOXOXOOOOOOXXOOOOOXOXOOOOOXOOOOOXOXOOOOXXOOXOOOOOOXXOXOOOXXOO
OXOOOXOOOXOOOOOOXOXOOOOOOXXOOOOOOOOOOOXOXOXOXOOXOOXOXOOOOOOOXOOXXOOOOXOXOOXXOOOXOXXOXOXOOOOXXOOOXOOOO
OXOOXOXOOOXXOOXOXOOXOOOOOXOXOXXOXOXOOOOOOOXOOOXOOOOXOOOOOXXXXOXOOOXOXOOOOXOXOOOXXXXOOOOOOXOOOOOOOOXXO
OOXXOOXOOOXOOXOOOOXOOOOOOXOOXOOOOOXOOOOOOXOOOOOOXOXXOOOXOOOXOOXXXOOOOOOXXOXOOOOXOOXOXOOXOOXOOOXOOOXXX
OXOOOOOXXXOXXOOOXOOOOOOXXOOOOOOOOOOOXXOOOOOOOXXOOOXOXOOXOOOXOXOOOOXOOOOOOOXOXOOOOOOXOOOXOXOXOOOOOOXOX
OXXXXOOXOOOOXOOOOOOOOOOXXXOXOOOOOOXXOOOXOXOOOOXXXXOOXOOOXXOXOOOOOXOOOOOXOOOXOOXOOXOOOOOOXOOOOOOOOOXXO
OXXOOOOOOXOOOOXOXXOOXOOXXOOOXOXXOOOOXXXOOXOOOOXOOXOOOOXOOXXXXOOXOXOXOXXXXXXXXXOOOOOOXOOOXXOOOXOOOXOOO
OOXOOOOOOOXOOOXOXOXXXXOXOOOXOOOOOOOXOXOOOOOOOOXXXXOXOOOOOXXOOXOXOOXOOXXOOOOOOXOOXOXOXOOOXOOOOOOOOOOOX
OOXOOOOOXOOOOOOOOOOOOXOOOXOOOOOOOOXXOOXOXOXOXOXXOOXOXOOOXOXXOOXOXXXXOOOOOOXOOOXXOXXOXOOXOOXOXXOOXOXOO
OOOOOOXXOOOOXOXXOXOXXOOOOOXOOOXXXXOOOXOOOOXXOXOOOOXXOOOOOOOOXXOOOXOOXXOXOOXOXXOOOXOOXXXOOXOOOOOOOXOOX
OOOXOOOOOXXOXXOOOOOOOOXOOXOOXXOOOOXOOOOOXOXXOXXOOOXOXXOXOXOOOOOXOOOOOOXOOOOXXOOOOOXOOXOXOOOOOOOOXOXOO
OOOOOXXOXXXOXOOOXXXOOXXOOOXOOOXOXXXOXOXOXXOOOOOOOXOOXOOOOOOXXOOOOOOXOOOXOOOOOXOOOOXOXOOOXOOOXOOOOOOOO
OXXOXXOOOOOOOOXOXXOOXOXOOOOOOOOXOOXXOOOOXXXOOXXOXOXOOOOOOOXOXXOXOOOOOOOOXOOXXOXOOXOOOOOXOXXXXOOOOOOXO
OXXXOOOOOOOXOXOOOOOXXXOOXOOOOOOOOOOOOXXOOOOOOOOOXOOOOOOOOOOOOOOOOXOXOOXXXXXXOOOXOOOOOOXXOOXOXXXXOXXOO
OOXXOOOXOXOOXOOOXXXOOOOXOOOOOOOXOOOOOOOOXXOOOOOOOOXOOOOOXOOXOOXOOOOXOXXOXOXOOOOOOXOOXOOOXOOOOOXOXOOOX
OXOOXOOOXXXOOOOOOOOOXOXOOXOXXOOXOOXOOOOOOXOOOXOXXOXOXOOOXOOXOXOOXOOOOOOOXXOOOOXOOXOOXXOXOOOOOOOXOOOXO
XXOOOOOXXOOOOXXOOOOOOXXXXOOOXOXXOXOXXOOOOXOXOOXOXXXOXOXOXOOOOOOOOOXOOOOOOOOOXXOOXOOOXXOXOOXOOOOOOXOOX
XXXXXOXOOXOOOOOOXOOXOOXOOOOXOOOOOOOOOOOXXXOXOXXOXOOXXOOOOOOOOOOOOOOOOOOXXOOOOXOOXXXOOOOXOOOXOOOOOXOOX
OXOOOOOOOXXOXXOOOOOOOOOOOOOOOOOOOXOOXXXXOOXOOXOXOOOOXXOOOOOOOOOXOOOOOOXOOOOOOOXOOOXOXOXOXXOOOOOXXXOOX
OOOOOXOXOXXOOOOXOOXOXOOOOXXOOOXXXOOXXOOXOOOOXXXOXOOOOOOXOXOOOOOXOOXOXOOOXXOOOOOOOOOXOOOOXOOOOOOOOOOXO
OOXXOOOOOXOOOXOXOOOOOXXOOOOOOXOXOOOOOXOXXXOXOOXOXXOOXXOOOXOOOOOOOXOOXXOOOXOOOOOOOOOXOOOOXOOXOOOOXOOOO
XOOXOOOXOXOOOOOOOXXXOXXOOOOOOOOXOOXOOOOOOOOXXOOXOOXXXXOOOOOXOOOXXXOXOOOXOOOOOXOOXXOOOOOOOOXOOOOXOXOXO
OOOXXOOXOOXOOOXOOXOOOOXOOOOOOXXOOXOOOOOOOOOXXOOOOOOOOOOOOOOOXOOOOOXOOOOOXOOOXOOXOXXOOOOOOOXOOOOOXOXXO
OXOXXOXOOOXXOOOOXOOOXOOOXOOXOOOXOXXXOXOOXXOOXOOOOOXXXXOOOOOOXOXOOOOXXXOOOOOXOXXOOXXXOOOXXXOOXOXOOOXOO
OXXXOOOXXOXXOOXOOOXXOOOXXXOOOXOXOOOXXOOXOOOXXOOOXOOOXOOXOXOOXOOXXOOXOXOXXXOXOOXXOOOOOOXOOOXXOXXXOXOOO
XXOOXOOXOOOOOXOOXOOOOOXOXXOXXOOXXOXOOOOXXOXOOOXOOOOOXOXOOOOOOOXXXOOOXOOOOOOOOXOXXXOXXXOXOOOOOOXOOXOOO
OXOXOOOXOOOOOXXOXXXXXOOXOOOOOXXOOOXOOOOOXOOOXOXOOOOXOOOXXOOOOOOOXXOOOOOOXOXOXXXOOOOXOXOOOXXXOOOXOOOOO
OXOXXOOOOXOOXOXXOOOOOOOOXXOOXOOXOOOXXOOOXXXXOOOXXOOOXOOXOOOXOOOOOOOOOOOOOXXXXOOOOOOOOXXXXXOOXXXOOOOXO
OOXOOXOXXOOXOOOXXXXOOOOXOOXXOXOOXOXXOOXOXOOOXOXOOOOOXXOOOOXXOXOOOXXOOOXXXOXXXXOOXOOOOOXXOOOXOOXOOOXOX
OOOOXOXXOOOOXOOXOOXOOOOXXOOOXOXXOXOXOOOXOOOOOXXOOOOOOXOOXOOXOOOOXXXXXXOXOOOOOOOXXXOOOOOOOXOOXXXOXXXOO
OXOOOOOXXXXXXOOOOOOXOXOOOOOOOOXOOOXOOOOXOOOXOXOOXOOXOOOXXXOOOXOXOOXOOOXXOXOOXOOXXOXXOXOOOXXOOOXXOOXOO
OOOOXXXOOOOXXOOOOOXOOOOOOOXXOOOOXOOOXOOXOXOOOOXXXOOXOOOOOOXOOOXXOXXXOXOOXXXOOXOOOXXOOOOXOOOOOOOXOXOOO
OOXXOXXOOOOOOXOXXOXOOOXXOOOXOOOOOXXXOOOOXOOXXOXOOOXOOOOOXOOOOXOOOXOOXXOOXXXOOOXXOXOXOOOOOXXOXOOXOOOXO
OOOXXOOXOOOXOOOOXOOOOOXOXOOXOOOOXXXXOOOOOOOOXOOXOOXOOOOOOOOOXXOXOOOOXOOOXXOXOOOOXXOXOXOOOOOOXOOOXOXOO
OOXOOOOOOXXOOOOOXOXXOOOOOOOXOXXOOOOOOOXXOXXOOOOXOXOXOOOOXOXOOOOOOXXOOOXOOOXOOOXXOOXOXOOXXOOOXOOOXXOXX
OXXOOOOOOOOXXXOOXXOOOOOOXXOXOOOOOOOOOOOOXOOXOOOOXXOXOXOOOXOOOOXOOXXOOOOOXOOOOOOOOXXOOXOOXOOOOOOOXOOOX
OOOOOOOOOOXOOOOOOOXXOXOOOOOXOOOOOXOOXXOXOOOOXOXOOXOOXOOOXOOOOOOOOOOOOOOOXOOXOOXXOOOOXXOOOXXOOOOXOOXOO
OOXOOXOOXXOOOOOOXXOXXOXOOOOXOOOXOXOOOOXXOXXXOXXXOOXXOOXOOOOXOXXXXOXXOOOOOXOXOOXXXOOXOXOOOOOXXXOXOXXOX
OXOXOXOOOXXOOXXXXXOOOXOOOXXOOOOXXOXOOXOOXOOOOOXOOXOOOOOOOXOOXOOOOOOOXOXOOXXOXOXOOOOOOXOOOOOXOOOOOOXXX
XOOXXXOXOXOOOOXOOXXOXOOOOXOOXOOOXOOOXOOOOXOOXOOOOOOXOXOXOOOXXOOOXOXOOXOXXOOOOXOOOOOOOXXXXOOOOOXXXXXXX
OOOOXOOXOOXOOOOOOOOXOOXXXOOOOOOXOOOOOXOOOOOOOOOOXOXOOOOXOOOXXXOOOOOOXOOOXOXOOXOOOOOXOOOOOOOOOOXOOOXOX
OOOXXOOOOOXOXOXOXOOOOXOOOXOOOOOOOXOOOOXOXOOOOOOOOXOOOOOOOOXOOOXOXXOOXXOXOOOOOXOXOOOOXOXOOOXOOOXOOOXOO
XOXOOOXOOOXOOOXOOOOOOOXXOOXXOOOOXOOOOOOOOOOOXXOXOXOOOOXOOOOOOOOXOOOXXOOOOOOOXOOOOOOOXXOOOOOOOXOOOOOOX
OOOOOOOXOOOOOXOOOOOOXOOXOOXXOXOOOOOXOXOOOOOOXOOOOXOOOOOXOXOOXOXOOOXOOOOOXOOOXOOOXOXXOOOOXOOOXOOOXOXOO
OOOOXOXXOXOXOOOXXOOXOOXOXOOOOXOOOXOOOOXOOOXOOOOXOXOXOOOOOOOOOOOOOOXOOOOOOXOXOOOOOXXXOOOOOXXOOOOOXOOOO
OOOOOOXOOOOXOXOOXOOOOXXXOOOOOXOOOXOOOOOOOXOOXOOXOXOXOOOXOOOXOOOXOOOOXOXXXOOOOOOXOXOXXOOOXXOOOOOOOXOXO
OXOOOOXOXOOOXOOOOXOOOOOXOOXOOXOOXXOOOOOOOOXXOOOXOOOOOOXOOXXOOOOXXOOOOOXOOOXOXOOOOXOXOXXXXXXXXOOOOOOOO
OOOXXOOOOXOOOXXOOOOXOXOOXOOOXOXXOOOOOOOOOXOOXOOOOOOOOOOOOOXXOOXOXXXOXXXXXOXOXOOXOOXXOOOOOOOXOOOOOOOOO
OOOXXXOXOXOOOOOOOOOOOXOXOOOOOOOOOOOOOOOOXXOOOOOOXXOOOXXOXXXOOOOOOXOOXOOOOXXXXOOXOOXOXOOOOOOXOXOXXXOXO
XOOXXOXOXXXOOOOXXOOOOXOOXXOOOOOOOXOOXOXOXOOOOXOOXOXOXOXOXOOOXXOOXOOXOXOOOOOOOOXOXOOOXOXXXOOOOXXXOXXOO
XOOXOOOOOOXXXOXXOOOOOXXXOXXXOOOOXOOXOOOXOXOXOXXXXXOOXOXOOOOOOOOOOXOOXOOOOOOXOOOOXXOOOOOOOOOXOOOOXOXOX
XXOXXOOOXOOXXOOXOOXOOXXOXOOXOOOOXOOOXXOOOOOXOXOOOOXOXOOXXXOXOOOOXXOOXXOOOOOOOXOXOOOXOXOXOXOOXOXXOOOOO
OXOOXOXOOOOOXOOOOXOXOXOOXOOOOOOOXOXOXOOXOOOOOOOXOXOXOOOOOXXOXOXOOXXOOOOOXOXXXOOOOXXOOXOOOXOOOOXXXOOOO
OOOXOOOXOOXOXOOOOXOXOOOXOOXOXXOXOOOOOOXOOOOOOOXOXXOXOOOOOOOOOXOOXXXXOXXOOOOOOOOXOOOXXOOOOOOOOOXOOXOOO
XOOOOOOOOOOXOOOXOOOXXOOOOOOOOXOXXOXOOOOOXOOOOOOOOOOOXXOOOXXXOXXOXOOOOOXXOOOOOXOOOOOOXOOOOXXOOOXOOOOOO
OOOOOOXXOOOOOOXXOXOOOOOOOOXXOOOOOXXOOOOOXOXOOXXOOXOOOOOOOOOOXOOXOOOOOXOXOOXOOXOOOOXXOOOXOOOXOXOOXXOOX
OOOOOOXOOXOOOOOOOOXOOOXOXXOOOOXOXOOOXXOOOOOOXXOOOOOXXOXXXXOXOOOOOOXOOOXXXOOOXOOXXOOOOXXOOOOXOOOOOOOXO
OXOOOOOOOOOXOOOXOXOXOXOOOXOOXOOOXXXXOOXXXXOXOOOXXOOOOOOOOOOOXOOOOXOOXOOXOXOXOOOOOXXXXOOOOOOXOOOOOOOXX
OOOOOXOXXOXXOOXOOOOOOOOOOXOOOOXXOOOOXOXXXOOOOOOOXXOOOOOOXOOOXOOOXXOOXOOOOOOOXOOOXOOOXOOXOXOOXOOXOOOOO
