XXOOOOOOXXXOOOXOOOOOOOXOOOXOOOOOOOXOOOOOOXOOOOXXOXXOOXOXOOOXXXOXOOOOXOOXOOOOXOOXOXOOOOXOOOXOOOOXOXOOX
OXOOOXXOOXOOOXOOXOOXOOXOXXOOXOOXOOOXOOOOOXOOOOXXOXOXOOXXXOOOOXOOXOXOOXOOOOOOXXXXXOOOOOOOOXOOXOXOXOXOO
OOXOXOXXXOOOOOOXXOOOOOOOOOOOOOOXXOXOOXXOXXOXOXOOOOOOOXOXOOXOOOOOOOOXOOOOXOOXOOXOOOOOXOOOXOXOOOXOOOXOO
OOXOXOOOOXOOOOXXOOXXOOOOXOOOOOOXXOOOOXOXOOOXXXXOOOOOOXOXOOOXOOXOXOOOOXOOXOXOXOXXOXXOXXOOOOXOOOOOXOOOO
XXXOXOOXOOXOOOOOOOOOOXOXXOXOOXXOOOOOXOOOXXOXOOXOXOOOOOOXOOXOXOOOOOOOOXOOOXXXOXXOOXXXXOOOXOXOXOOXOOOOX
OOOOOOOOOOOOOOXXOOOOOOXXOOOXOOOOXOOXOXOXOOOOXOOXOOOXXXOOOXOOOXOXOOOOOOOXXXOOOOOOOOOOOOXOXXXOOXOOXOOOO
OOOOOOXOXOOXXOXOOOXOXXOOOOOOOOOXXOOOOOOXXOOOOOXXOOOXOXOOXXXXOOOXOOOOOXOOOOXOOXXXXXOXOOOOXOXOXOOXXXOOX
OOOXXXOXOXOXOOOXXOXOXOOOOXXOOOOXOXXOOXOOOXOOXOXXOOXXOOOXOXOOOXOOOXOOOXXOOOOXOXOOOXOOOXOOOOOOXXOOOOOOO
OXXOOOXOOOOOOOXOOOOOXOXOOOOOXOXXOOOOXXOXOOOOOXXOOXXOXXXXXOOOOOOOXOXOOOOXOXOOXOOOOOOOOOXOXOOXOOOOOOOXO
XXOOOXOOOOOXOOOOOXOXOXOOXXOOOOOXOOOOXOOOOXXOXXXOXOXXXXOOOOOXXOOOOOOOOOOOXOOOOXOOOOOOXXOXXOOOXOOOOOXOO
OOOXXXOXOOOOOXOOXXOOOXXOXXOOOOOOOOXOOOXOOOOOXXOOOOOOOOXOOOOOXOOOXOOXOOOOOXXOOXOXOOOXXOOOOOXOXOXOOXOOX
OOXOOXXOXXOOXOXOOOOOOXOOOOXXXXOXOOXOOOOOXOOOXOXXOOOXOOXXXOOOXXOOOXOOOOOXOOXOOOOOOXOXOOOXOXOXXOOXOOOXO
OOXOOOOXOOXOOXOOOXOOOOOOXXOOOOOXXXXOOXXXXOOXOOOXOOOOXOOOOOXOXOOOOOOOXXOOOOOOOOOOXXOOOOOOOOOOOOOOOOOXO
XOXOOXOOOXOOOOOXOOOOOOOOOOXOOOOOXXOOOOOOXOOXOOXOOOOOXOOOOOOXOOOOOXOXOXOOOOOOXXOOOOOOOOOOOOOOOXOOXXOOO
XOXXOOOOOOOOOOOOOOOXOOOXOOOXOOOOOOOXXXOOOOOOXXOXOXOOXXXOOOOOOOOOOOOXOOOXOOOXOOXXOOOOXOOXOOXOXOOOOOOOO
XXOOXOOOOOOOOOXXXOOOXOXXOOOOOOXOXXOOOXXXXOXOOOXOXOXOOOXOOOOOXOXOXOOOOOOOOOOOOOOOXOXXOXOOOXOOOXOOXOOXX
OOXXOOXXOOOOOOXOOOOXOXOOOOOXOOOOXOOOOXOXOXOOXOOXXXXOOOOOOOOXXOOOOOXOXOXXOOXOXXOOOOOOOOXXXOOOOOOOOOOOO
OOOXOOOOXOOOOXOXOOXOOOOOXOXOXOOXOOXOOOOXXOXOOOOOOOOOXXOOOOOOOOXXOOOXXOOOOOOXOOOOOOOOXXXOOXOOOOOOXOXOO
OOOOOXXOOOOOXXOOOXOOOOOOXOOXOOOXOOOOOOOXXOOOXOOOOOOXOOXOOXXOOOOOXOOOXOXOXOXOXOOXXXXOOOOOOOOOXXOXOOXXX
OOOXOOOOXOXOOOOXOOXXOOOOOOOOOOOXOOOXOOOOOXXXOOOXXXXXOOXOXOOOOXOOXOOOOOXOOOOOOXOXOXOXXXOOOXXOOXOOOXOOX
OOOOOOXOOXXOOOXOOOOXOXOOOXOOXXXOOOOOOOOOXOOXOOOXXOXOOXOOOXOOOOOOXOOOOXOOOXXOOOOOXOOOOXXXOOOOOXOOOXOOX
OXOOOOOOXXXOXOOXOXOOOXXOOOOOOXXOXXOOOOXOXOOOOXOOOOOOOOOXXOXXOOOOOOOOXOOOXOOOOOOXOXOOOXOXOOOOOXOOOOXOO
OOOXXOOOOOOOXOOOXXOOXOOOOOOOOXOXXXOOOOOXOOXOXOXOXXXXOXOOOXOOOXOOOOXOOOOOXOXOXOOOXOOOOOOXOOOXOOXOOOOOO
OOOXOOXOOXXXOOXOXOXOXOXOOOXOOOOXOOXOOOOOOXOOOOOOXOOOOXOXOOOXXXOOOXXXOXXOXOXOOOOXXOOXOXOOOOOXOOOOOOOOO
OOOOOOOOOOXXXXOXOOOOXOOOOOXOOXOOXXXOOXXXOOXOOOXOOXOOOXOOOOXOOXXXOOOXOXOXOXXXOOXOOOOOOOOOOOOOOOOOXOOOO
OOOOOXXXOXOOOOOOOXOOXOOOOXOOOOOOXOOOOXOXXOOOOOOOOXOOOOXOXOOOXOOXOOOOXOOOOOXOOOOOXOOXOOOXOOXOXOOOOOOOO
OOOOOOOOXOOOOXXOXXOXOOXOOOOOOOXOOOOOOXOXOOXXXOXOOOOXXOOXOOOOXOOOOOOOXOOOOXOOOXOOOOOOOOOOXOOOOOOOOOOOO
XOOOOOOXOOXXOOOXOXOOXOXOOOOOOOOOOXOOOOOXXOXXOOOOOOOOOOOOXOOOOXOOOXOOOXOOOXOXOXXOOXOOOOXOOOOOOOOXXOOOO
OXXOOOOOXOOOOOOOXXOOOOOOOOOXOOOXOOOXOXXOXOOOOOOOOXOOOXOOOXXOOOXOOXXXOOOXXOXOXOXOOOXOOOOOXOOOXOXOXOOOO
XOOOOOOXXOXOOXOOXOOOOOOOOOOOOOXXOOOOOXXXOOXXOXXOXXXOOOOOOOXOOOOOOOOOOOXOXOOXXOOXOXOXOOOXOOOOOOXOXXXXO
OOOXOOOOOOOOOOOOXOOOOOOOOXOOXOOXXOXOOOOOXOXXOOXOOXOOOXOXOOOOOXOOXXOOOOXOOXOXOOOOXOOOOXXOXOOOXOXOOXOOO
XXXOXOOOOOXXOOXXOXOXOOXOOOXXOOOXOOOOOOOXOOOOXXXOOOXOOOOOXOOXOOOOXXOXOOOOOOOOOOOOOOXOOOOOXXOOXOXXOXOOX
OOXOOOOOOXOOOOOXXOOOOOXOOOOXOXOXOOXXXOOOOOOOXOOOOOXXOOXOXOXOOXOOOOXXOOOOOXOXOXXOOOOOXOOOXOOOXOOOOXOOO
OOXOXXOOOXXOXXOOOOOOOOXOOOXOOXOOOXOOOOOOXOOOOOXXOOOOOOOOOXOOOOOOOOOOOXXOXOXOXXOXOOXXOOOOXXXOOOOXOXOOO
OXOOOXOOOXOXOOOXOOOOOOOXXOXOOOXOOOOOXOOXOOXXXOOOOOOOOXXXOOXXXXOOXXOOOXXOOOOOOOXXOOOOOOOOOOOOOXOOOOXXX
XOOOOOOOOOXOOXOXOOXXXXOXOOOXOXXOXOOXOOOOOOOOOOXOXXXOXXOOOOOOOOOOOXXOXXOXOOXOOXOXOXXOOOOOOOOXOOOOOOOOO
XOOOOOXXOOOOOXOOXOOXXOOOOOOOOOOOXOOOOOOOXOOOOOOOOOXOXXOOOXOOOOOOXXOOOXOOOXOOXXOXOOOOOOOXOXOOXOOXOXXOX
OOXOXOXOOOOOXOOOOOXXOOOOOOOXOOOXOOXOXOOOOOOXXOOOOOOXXOOOXOOOXOOXOOOXXXXOXOOOOOOOOXOXXOOOOXXOOOXOXOOOO
OOOOXOXOXOOXOOOOOOXOOXOXXOXOOXOOXOOXOOOOOOOOOOXOOOOXXXOOOOXOOOOOXOOOOOXOXOOXXXOOOOOOXOOOOOXOXOXOOOOOX
XOOOOXOOOXOXOOOOXOOXXOOOXOOOOXOOOOOOOXOXOOXOOXOXXXOXOOXOXOOOOOXOOOOXOXOOOXOOOOOOOOOOOOOOOXOOOOOXOOOXO
OOOOOOOOOOOXXOOOOOOXOOOOOXOOOOOXXOOOOOOOOOOOOXOOXOXOXOOOOXOOOOOOOOOOOXOOXOOOOOXOXOOOOOXOOOOOOOOOXOXOO
OXOOOOOXXOOOOOOOXOOXOXOOOOXOXOXXXXOXOOXOOOXXOOOXXXOOXOOXOOOXXXXXOOOOOOOOOXOOOXOOOXOOXOOOOOXXXOXOOOXOO
XOXOOXOOXOXXXOXOXOXOXOOOOOXOXOXOXOOOOOOOOOXXXXXOOXXXXOXOOXOOOOOOXOXOXOXOOOOOOOOXOXOOOXXOOOOOOOOXOOOOO
OXOXXXOOOOOOOOOXXOXXOOOOOXOOOXXOXXXXXOOOOOOOOOXOXOOOOOOOXOOOXOOXOOOOXOXOOXOOXOXXXOOOOXXOOOOOOOOOXOOXO
OOOOOXOOXOOXOOXOXXOOOOXOXOOXOOOOOOXOOXXOOOXXOOOOOXXOOOOXOXOXXOOOOXOXOOOOXXXXOXXOOOOOXXXXOOOOOOOOOXXOO
OOOOOOOXOOOOOOOOXOOXOOOXOOOOXXOXOOXOXOXOOXXXXOOXXOXOOOXOOOOOXOXOXOXOOOOOOOOXOXOOOXOOOXOOOOOOXOXXXOOXX
OOOOOXOOOXOOOXOXXXOXOOOOOXOOXXOXOOOXOXOOOOOXOXOOXOOOXOOOXXOOOXXOXOOXOOOOOOXOXXOOOOOOOOOOOOOOOOOOOOOOO
OXOOOXXOOXXOOXOXXOOOOOOXOXXOOOOXXXXOOXOOOXOOOOOOOOXOXOOOXXOOOXXOXXOOOOOOOOOOXXXOOXOXOXOOXXOXOXOXXXXOX
OXOOOOOOXOXXOXOOOXOOOOXXOOXOXOOOOOXXXOOXXOOXOOOOXOOOOOOOXXXOOOOXOOXOOOOOXOOXXOXXOOOOOXOOXOOXOOXOOXOOO
OXOOXXOOOXOXOOOOOOOOOOXXOOOOOOOOOOXOOOOOOOOOXOOOXOXOOOOOXOXXOOXOXOOOOOXOOOOOOXXOOOXOXXOOOOOOOOXOOXOXO
OOOOXOOOOXOOOOOOOXOOOOOOOOOOXXOOXOOXOXOOOOOOOOOXOOOOXXOXOXOXOXOOOOOXOOOOXXXXOOOOXXOXOXXOOOOXOOXOOOOOO
XOOOOOXOXOXOOXXOXOOOOXXXOOXOOOOXOOXOOXOXOOOXXOOXOOOOOXXXOOOOOOOOOXOOXOOOOXOXXXOXXXOOOXOXOXOOOOOOXOOOO
OOOXOOOXOOOOXOOOOOOXXOOOXOXOXXOOXOOOXOOOOOOOXXOOXOOOOOOOOOOXOXOOXOXOOOXOOOOXXOOXOOOOOOOOXOXOOXOXXOOOX
OOOXOOOOOOOOXXXXOOOXOXOXXXXOOXOOOXOOOOOOOOXXOXOXXOXXOOXOOOXOXXOXOXOOXOOOOOOXOOOXXOOOOOOOOXOOOOXXOXOOO
OOXOOXXXXXOOOOXOXOXOXOOOOXOOXOOXOOOXOXXOOXOOOOXXXOOOXOOXXOOOOOOOOOOOOXOOOOXOXOOXOOOOOOOOOOOXXOOXXXOOO
OXOOOXOOXXOOXXOXXXOXXXOXXOXXXXOXXOXOXXOXOOOXOOXOXXXOXXOOOXOOOXOOXOOXOOOOXXOOXOOXXOOOXOOOOOOOXOOOOXOXO
OOOXOOOOXOOOOOOXOOXOXXOOXOXOOXXOOOOXXOOXXOOOOOOOXOOOXOOOOOXOOXOOOOXOOXOXOXXOXXOOOXOOXOOOOXOOXXOOOOOOO
OXXXOOXOOXOOXOOOOOOOOXOXOXOXXOXXOOOOOOXXOOXXXXOOOOOOOXOXOXOOOOXOXXOOXOXOXOOXOOOOXXOXOXXOXOOXXXOXXOOOO
XOOOOOXXOOOXXOXOOXOXOOOOOOXOOXXOOXOOOXOXOXOOXOOOXOOXOXOOXXXOOOOXOOXOOOOXXOOXOXOOOOOXOOOOOOOXOOOOXOOXO
XOXXOOXOXOOXOXOOOOOXXOOOOXOXXOOOXOOOOOOOOOXOOOOOOOOOXXOOOOXOOOOXOOOOXOXOXOOXOOOOOOOXOXOOOOXOOOXOOXOXX
OOOOXOOOOOOOOOOOXXXXOOOOOOXXOXXOOXOOXOOXXOOXOOOOOXXOXOOXXOOOOOOOXOXXOOOXOOOOXOOOOOOOOOOXXOOOOOOOOOOXO
OOXOXXOOOXXOOOOOOOOOOOXOOOOOXXOOOXOOOOOOOOOOOOOOOOXXXXXOOOOXOXXOOOOOOXOOXOOXXOOOXXOXOOOOOXOOOOOOOOXOX
OOOXOXOXOXOOOXOOOOXOOOOXOOOOOOOOOOOXOXOOOOOXOOOOXOXOOOOOOOOXXOOXOOXOOOXOOOOOXXOOXOOOXXXXOOOOOXXOXOOOO
OOOOOOOOXOOOOOOXOOOOOOOOOOXXOXOOOXXOXXXOOOOOOOXOOXXXOOOOOOXOOOXOXOOOXOOXOOOOXOXXOXOXXOOOOOOOOOOXOXOXO
XXXOXOOOXXXOXOOOOOOOOXXXOXXOOXOOOOOOXOOOOOXXOXOXOXOXXOOOOOXOOOXOOOXOOXOOOOOOXXXOXOOOOOXXXOOOOOXOOXXXO
OOXXXXOXOOOOOXOXXXXOOOOOOOOOOXOXOOOXOXOXOOOOOOOOOOOOXOOOOOOOOOOOOOXOOOXXOOOXOOOXOOOXOOOOXOOXOOXXOOOOO
XOOOOOOOOOOOOOOXOOOOOOXOOOXOOOOOOOXOOOOOOOOOOOOXOOOXOOOOXXOOOOOOOOOXOOXOXOOOOOOOOOOOOOOOOOXOOOOOOOXOO
OXOOXOOXOOOOOXXXXOXOXOOOXXOOOOOOOOXOOXXXOOOOOOXOOOXOXOXXOOOOOOOOOOOOXXXOXXXXOOOOOOOOOOOOOXXOOOOOOOXOO
OOOXOXOOOXOOOXOOXOOOOXOXXOOOOOOOXOXOOOOOOOOOXXOOOOXOOOXOOOOOOXXXOXOOOOXOOOOOOOXXXOOOXOOXXXOOOOOOOXXXO
OOXOOXOOOOOXXOOOOOOXXXOXOOOXXOXOOXOOOOOXOOOOXOXOOXXXOOOXOOOXOOOOOOOOXOOXOOXOOOOXOXOOOOXOOOXOXOOOOOOXX
OXOXXOOXOOOOOXOXXOOOXOOOOOXXOOOXOXOOOXXXOOXOXOXOXOOOXOOOOOOOXOXOOXXOXOOOOOXOXOOOOXOOXOXOOOOOOOXOXXXXO
OXXXOOXOOXOOXOXOXXOOOOOOXXOXXXOXXOOXXXOOXXOXOXOOOOOXOOOOOXOXOOOXXOOOOOOOXOOOOOXXOOXOOOXOXXXOOOOOOOOOO
OOOXXOOOOOXXOOOXOXOXOOOOXOOOOOXOOOOOOOOOXOOOOXOOOOOOOXOXXOOOOXOOOOOOOXOOOOXOOOOOOXOOOOXXOOOOOOOXOOOOO
OXOOOXOXOXOOOOXOOXXOXXOOOOOXOXXOOOXXOOXOXOOOOOOXOOOOXOXXXOOXOOXOOXOOOXOOXOOOOOOOOXOOOOOOXXXXXOOOOOOOO
OOOOOXOOOOXOOOOXOOOOOXOOXOXOOXXOOOOOOOXOOOXOXOOXOOOOXOOOXXOXXOOXOXOOOOOXOOXXOXXXOOOOOOOOXOOOOXOXOOXOO
OOXXOOXXOOOOOXOXOOOOOXOOOXXXOXXXOOOXOOOOOOXOOOOOOXXOXXOXOXOOXXOOXOXOOOXOOOOOOOOXXOOOOOOXXOOXOOOXOOXXO
OOOOXOOOOOOOOOOOOOOOOXXOOOXOOXOXOOXXOXOXXOOOXXOOXXXOXOOOOOOOXOXXOOOXOOOOOOXOOXOOOXXOOXXXOXOXOOOXOXOXO
XOOOOXXOXOXXOOOOOOOOXOXOOOOOOOXOOOXXOOOXXOXOOXOXOOOOOOOXOOOOOXOOOXXXOXOOOOOOOXOOXXXXOOOOXXOXOOXXOOOXO
OXXOOOXXOOOOXXOOOXOXXXXXOOXOOXOOXXOOOXOOOOOOOXOXOOOOOOOOOOOOOXOOXOOOOOOOXOOOXOOXXOOOOXOXOOOOXXOOOXOOO
XOOOOOOOOOOOOOOOOOXOOOOOOOOXOXOOXOOOOOXOXXOOXOOOOOOOOXOOOOXXXOOXOOXOOOOOOOOOOOOXOOOOOOXOOOXOXXOOOOOOO
XOOOOXOOOOOXOOOOXOXOXOXOOXOOOOOOOOXOOOOOXOOOXOOXOXOOOOOOXXOXOOOXXOOOXOXOXOOXOOXOXOXOOOOXXXXOOXXXOOXOX
XOXOXOXXOOOOOOOXOOOOOOOOOOOOXOOXOOXOOXOOXOXXXXOOOXOOOOXOOOXOOXXOOOXXXXOOOOXOOXXOOOOOXOOOXOXOOOOXOOXOO
OXOXXXXOXXXOXXOOOOOOOOOXOOXOXXOXXXOOOOOOXXOOOOXOOOOXOOOOOOOOOOOXOOXXOOOOOOXXXOXOOXOOOXOOOOXXOXOOOXOOO
OXOXOOOOOOOOXXOXOOOXXXXXOOOXOOXOXOOXOOOXXXOXOXXXOOOXOOOOOOXOXXXXOXOXXOXOOXOOOXOOOOXOOOOOXOOOOOXXOOOOO
OOOXOOOOOOOOXOXOXXOOOOOOOOXOOOOXOOXOOOOXOOOOOOXXXXOOOXOOOXOOOOOOOOOXOXOOOOOOOOXOXOOXOOOOOOOXXXOOOOOXO
OOOOXOOOOOOXOXOXOOOOXOOOOOOOXOOOOOXOXOXOOXOOOOXOOOOOOXOOOOOOOXOOXXOOOXXXOOXOOOOXOOOOOXOXXOXXOOOOXXXOO
OXOOOOXXOOOOOXOOOXOOOXOOXOOOOXXOOOOXOXXOXOXOOOOOOXOOOXOXOOOOOOXOOOOXOOXXXXOOOOOOOOOOOOOOXOOXOOOOXOOOO
OOOOOXOXOOOOOOXOOOOOOXXOOOOOOOOOOOOXOOOOOOOOOOOOXXXXOOOXXXXOOOXOOOXXOOOOOOOOOOOXOOOOOXOOOOXOOOOOOXOXO
XXOOXXOOXOXOOOOXOXXOOOXXXOOXOOOOOXXOOOXOOOOOOXOOOOOOOOOOXOOOOOOOXOOXOXXOXOOOXXOOXOXXOOOOOOOOOOOOXOXOO
OOOXOOXXXXOOXXOOOOOOXOOOOOOXOXOOOOXXOOOOOOOOOOXOOOXOOOOOOXOOOOOOOXOXXOOOOXXOXOOOOXXOOOOOOOXOOOXXXOXXO
XOXOOOOXOOXOOXXOOOOOOOOOXOOOOOOOOOXOOOXOOOXOOOOOOOOOOOOOOXOOXXOXOOXOOOOOXOOOOOOOXOOOOOXOOXOOXXOXXOOOO
OOXXXOXOOOXOXOOXOOOOOOOOXOXXXOXOOXOXOOXOOOOOOOXXXXXXOOOOOOOOOOOOOOOOXOOXXOOOOOOXOOOOOOOOOXXOOXOXXXOXO
OOOXOOOXXXOXOOOOXOXOXOXOOOOOOOXXOOOXOXXOOOOOOOXOXXOOXOXOXXOOXXXOOOOOOOXOOOXOOXOOOXOOOOOXXOOOOOOOOXXXX
OOXOOOOOXOXXXXOOOOOOXOOOOOXOOXOOXOOOOOXOXOXXOXOOOXXOOXOOOOOOOXXXOXXXXOOOOOOOOOOXOOOOOOXXOOOOOOOOOOOXO
XXOXOOOXOOOOOOOXOOOOXOXOOOOOOOOOXOOOOOXOOOXOXOXOXOOOOXOXOOXXOXOOOXOOXOXXOOXOOXXOXOOXXXOOXOOXOOOOOOOXO
XOOOOOOXOOOOXOOOXOXXOXOOXXOOOOOOOOOOOOOOOOXOOXXOOOXXXOOOXOXOXXOXOOOOOOXOOOXOXOOOOOXXXOOXXOOXXOOOOOOOX
OOXOOXXOOOOOXOOOOOOOOOOOOOOXOOOXXXOOOOXOOOOOOOXOXOOOOOOOOOOOOOOOOOXOOXXOOOOOOOOXOOOOXOOXOOOOXOXOOXOOO
OXXXOOOOOXXXOXOOOOOOOXOOOOXOXXOXOOOOOXOOOOOOOOXXOOOOOXOOOOOXOXXOXOOOXOOOXXXOOXOXOXOOXOOOOOOXOXXOOOOOO
OXOXOOOOOOOOOOOXXOOOXOOXXXOXOOXOXOOXOXOOOXOOOXOOOOOOXOOOOOXOOOOOOOXXOOXOOOXOOXXOOOXOOOOXOOOOXOOXOOOOO
OOOOOOXOOXOOOXXOOXOOOOOOOOOOOOOXXXOXOXXOOOOXXXXOOOOOOXOXOOXOOOOOXXOXOOXXOXOXXOOXOOXOOXOOXXOOOOOOOXOOO
OOOOXOXOXOXOXOXXOOXOOOOOOOXOOXOOOXOOOOOXOOOOOXOXOXOOOOOOOOOOXOXXOOOXXOXOOOOOOXOOOOOOXOOXXXXOOOXXOOOOX
