OXXOOXOOOXOOOOOOOXOOOOOOOXOOOOOOOOOOOOXOOOOXOOXXXOOOOOOXXOXOOOOOOOXOOXXOOXOXOOOXOOOOOXOOOOOOXOXOOXOOO
OOOOOOOXOOOOOXOOOOXOXXXOOXOOOXOXOOOOOOXOXOOXOXOXXOOOOOOOOOXOOOOXOOOOOOOOOXOOOOOOOOOXOOOXOOOXOOOOOOOXO
OOOOOOOOOOOOOXXOXXOXOOXOOOOOOOOOXOOOOOOOOXOOXXXXOXOOOOOOXOOOOOXXOOXOXOXOXXOXOOOOOOOOXXXOOOXXXXXOOOXOX
OXOOOOOOOXOXXOXOXOOXXOOOOOOXOOXOOOXOOXOXOOOOOOOOOOXOXOXXXOXOXOOXOOOXOOOOOXOXOOXOOOXOOOOOOOOOOOOOOOOOX
OOOOXOXXOOOOOOOOOXOOOOOXXOOOOOOOXOOXOXOOXOOXOXOXOOOXXOOOOOXOOOXOOOXOXOOXXXOXOOOOOOOXOXOOOOOOOOOOOXXOX
OOOOOXOOXXOXOOOXOOOOOOOOXOXOOOOXOXXOOOOOOXXOOOXOOOOOXOOOOXOOOOXOOXOOOOXOOOXOXOXOOOOOOOOOOOOOOXOOOOXXX
OXOOOOOOOOOXXXOXXXOOOXOOOXOOOOXXOOOOOXOOOOXOOXOOOOOOXOOXOOOOOOOOXOOOXOXOOOOXXOOOOXXXOOOOXOOOOOOOOOXOO
OOOOXXOOOOOOXOOXOXOOOOOXOOOOOXXOOXOXOOOOOXOXOOOOOOOOOOXOXXOOOOOOXOOOOOXXOOOXXXOOOXOOXXOXXOOOOXOXOXOOX
OOXOOXOOXOXXOOOOOOXOXOOOOOOOOOXOOOOOOOXOOOXOOOOXOOOOOOOOOOXXOXOXOOOOXOOOOOOOOOOOXXOXOOOOOOXOOOXOOOXXO
OOXOOOOXXXOXOXOXOOOOOOOOOOOOOOOOOXOOOOOXOXOOXOXXOXOXOOOXOXXOXOXXOOOXOXOXOOOXOOOXXXOOOOOOXXXOXXXOOXOOO
OOOOOOXOOOOXXOXXXOOOOOOOOOOXOOOOXOXOOOOOXOOOOOOXXOOXOOOXXOXOXOOOOXOOOOOOXOXOXOOOOXXOOOOOOOOXOOOXOOOXO
XXOOOOXOXXXOXOOOOOOOXOXOXOXOOOOOOXOOOXOOXOOOXXOOXOXOOOOOOOXOOXOOOXXOOOOOOXXXXOOOOOOOXXXOXOOOOOOOXOOXX
OXOOXXOOOOOXXOXOOOXOOOOOOXXOOOOXXOOXOOXOOOXOOXOOOOOXXOXXOOXOOOOOXOOXOXOOOXOXOOOOOOOOXOXOOXOOXXXOXXOOX
OOOXXOOOOOOXOOXOOXXOOOOOOOOOXXXOXOOOOOOOOXOXOXXOOOOXOOOOOOOOXOOXXOOOOOOOOOXXOOOOOOXOOOOOXOOOXOOOOOOOO
OOOOXOOOOXOOOXOXOOOOOOOOXXOXOOOXOXOOXXOOOOOXOOOOXXOXOOXXOOOOOOOOOOOOXXOOOOOOOOXOOOOOOOOOOOOXOOOOOXOOO
OOOXXXXOOOOOXOXOOXXXXXOXXOXOOOXXOOOOXOOOXOOOOOOOOOXOXOXOOXXOOXOOOOXOXOOXXXOXXXXOXXXOOOOOXXOOOXOOXOOXO
OOOOXXOOOXXOOOXOOOOXOOXXXOOXXOOXXOOOOOOOXOOXOOOOOOOXOXXOXOOOOXXOOOOOOOOOOOOXXOXXOXOOXOOOOOOXXOXOOOOOO
OOOOOOOOOOXOOXOXOOOOXOOOOXXOOOOXOOOOOXOOXOOXOXOOXOXXOOXOOOOOOOXOOOOXOOOXOXOOOOOOXOOOOXOXOOOOOOOXXOOOO
OXOOOXXOOXOOOOOOXOXXOOOOOOOOOOOOOOOOOOXXOXOXOOOOOOOOOOXXXOOOXOOOOOOOOOOXOOOXOXOXOXOOXOOOXOOXXXOOOOXOX
XOOXOXOOXOOOXOOXOXOOXOXXXOOXOOOOOOOXOOXOXOOXXOOOOOOXOOXOOXOXOOXXOXXOOOOXOOOXOXOXXOXOXXOOOOOXXOXOXXOOO
OXOOXOXOOOOOOOOOXXOOXOXOOXOXXOOOXXOXXOOXOOOOXXOOOOOOOXXOXOOOXOOOOOOOOOOOXXOOXOOOOOOOXOOOOOOOOXOOOXOOX
XOOXOXOXOOOOXOXOXXOOOOXOOOOOOXOOXOOOOOXOOOOOXOXOXOXOOOOOOOXXOOOOXOOOOOOOOOXXOXOOOXOOXOOOOOOXXXXOOXOOX
XOOOOXOOOOOOOXOOOXOXXOXOOOXXOXOOOXXXOOXOOOOXOOXXOOOOOOOOOOOOXOOOOXXXOOXOOOXOXXOOOOXXOOOXOXOOOOXOXOXXX
OXOOXOOOXXOOXOXOXOXXOXOOOOOXOOOXXXXOXXOOXXOOXOXOXXXOOXXXOOOOXXOXOOOOXOOOXOOXXOOOOOOOOOOOXOOXOXOXXXXOX
OOXOXOOOOXOOOOOOOXOOOOOOOOOXOOOOOOOOXOXXOXOOXOOOOOOOOXOOOOOOXXXXXOOOOXOXOXXOOXXOOOOOXOOOOOOXXOOXXOOXX
OOOOOXXOOOOXOOOXOOOXXOOOOOOXOXOOXXXXOOOOXOOOXXOOXXOOXOXXXOOOOOOOOOOOXXOOOXOOOOOOOXXXOXOXXXXOXXXOOOOOO
OOXXOOOOXXOXXOOOOXOOOOOOOOXXOOOXXOOXOOOXOOOOOXOOXOOOXOXOXOXOOOXOOXXOOXXOOOOOXOOOXOOOOOXOOOOXOOOXOOOOX
XXOOXOXXOXOOOOOOOXOXOOXOOOXOOOOOOXOOOOOOXOOOOOOXOOOXOXXXXOOXXXOOXOOOOOOXOOXOXXXOOOOOOOXXOXXOOXOOXOOXO
XXOOOOOOOXOOOOXXOXOXOOOOOOOXXOOXOOOXOOOOOOXOXOOOOXOXOXOXXXOOXXOOOOOOXOOOXXXOOXXOOOXOOOOOOOOXXOXXOOOXX
OXOXXOOXOOOXOOXOOXOOOOXOOOXOOXOOOOOXOOOOOOXOOOOXOOOOXXXOOOOXOOOXXXOOOOOOOXXOOOOOXOOOOOOXXOXOXOOOOXOOO
OOOOXOOOXXOOXXOOOOOOOXXOOOXOOOXXOOOXOOXOOXOOOOOOOOOXXOOOOOOXOXOOXOOOOOXOOXOOOOOOXOOOOOOOOOOXXOOOOOOXO
XOOOOXOOOOOOOXOOOOXOOOXXOXOOOOOOOOOOOXOOOXOOOXXOOOXOOXXOXOXOXXOOXOXOXOOOXOOOOOXXOOOOOOXXOXOOOOOOXXOOO
OOOOOOXOXXOOOOXOOOOXXOXXOOOOOOXOXOOXOOXOOOOXXOOXXXOXOOXOOOOXOOOOOOOOOXOOOXOOXOOOOOOXOOOXOOXOOOOOXOOOO
OOXXOOXOOOOOXOOXXOOXOOOOOXOOXXOOOOOXXOOOOXXXOOOOOOOOXOOXOOOOXOOXXOXXOOXXXOOXOOOOOOOXOXOOOOOOOXOXOXOOO
OOOOOOXXXXOOOOOXOXOOOXXXOOOXOOOOOOOXXXXXOOOXOXXXOXXXOOXOOOXOXOOOOXOOOOXOOXOOOOOOXOOOOOOXXOOXOOOOOXOOX
OXXOXOOXXXXOXOOOXOOOOXOOOOOOOOOXOOOOOXOOXXXOXXOXOOOXOXOOOOXOOXOOOOOXXOOOOOOOOOOXOOOOXOOXOOOOOXOXOOXOO
XXOXOXXOOOOOXOOXXOOOOOOXXOXOXXOOOXOXXXXOOOXXOXOOXOOXOOOOOOOOOXOXXXOOXOXOOOOOXOOXXOXOOOXXOXOOOXOOXXXOX
OOOXOOOOXOOOXOOOOOOOXXOOOOOXXXXOOOXOXOOXOOOOXOXOOXOOOOXOOXOOXXOOOOOOXXOOOOOOXOOOOOXOOOOOOOXXOOOOOXXOO
OOOOOOOOOXOXXOOXOOOOOXXOXXOXOOXOOOOOOXOOOOOOOOOXOOOOOOOOOXOOXOOXOXOOOXOXOOOOOXXOXOXOOXXOOOXOOXOOOOOOX
OOOOOOOXOOXOXXOXOOXOOOXOXOOOXXOOOOOXOOOOXXXOOOOOOOXOOOOOXOXXXOOOOOOOOXOOXXOOOXOOOOOXOOOOXXOOOXOXOXOOO
XOXOOOOOOOOOOOOXXOXOOXXXXOXOOXOXOXOOXOXOOXXOOOOOOXOOOXOOXOOOOOXXOXOXOXOOOOOOOXXOOOOXXOOXOOOOXOOXXOXXX
XXOXOXXXOOXOOOOOXXXXOOOXXXOXXOOXXOXXOOXOOOOOOOOOOOOOXOXXOXXXOXOOOOOOOXOOXOOOOOOOOOXOOOOOOOOOXOOOOOOOO
XOOOXOXOOOOOXXOOXOOOXOXOXOOOXOXOXOXOXXOOXXOOOOOXOOOOOXOXXXOOXOXOXOOOXOOXOOXOOOXOOOXXOOOOOOXOOOOXOOXOO
OXOOOOOOOOOOXXXOXOOOXOOOOOXXXOOOOXOOOOOOOOOOOXXOXXOXOOOXOOOOOXOOOOXOOOOOOOOXOOXXXOOOXOXOXOXOXXOOXOOXO
XXOOOOOOXOOOOOXXOOOXOXOOOXXOOOOOOOXXOXOOXOXXXOOOXOOXOOOOXOOOOOXXXOOOOXXOOOOOOOXOOOOOXXXXOOOXOXXXXOOXO
OXOOOOXOOOOOOOOXOOXXOXOXXOOXOXOXOXOOOOXOOXXOOXXOOOXOXOOOOOOOOXXOOXOOOOXOOXXOOOXOOOOOOOOOOXXOOXXOOOOOX
OOOOOXOOOOOOOXOXXOOXXOOXOOXOOOOOOXOOOOOOXOOXXOOOXOXOOOOOXOOXOOOXOOOOOXXXOXOOOXXOOOOOXOOOOOOOXOOOOXXOO
XOOXOOOOXXOXOOOXOOXOOXOOOOOOOOOOOOXOXOOXOXXOOXOOOOOOOXOXOXOOOXOOOXOOXOOOOOOOOXXOOOXXOOOXOOOOXOXOOXOOO
OOXOXOOXXOOOOXOXOOXXOOOXXOOOXOXOOXOOOOXOXOOOOOXXXOOOOOXXOOOXOOOXOXOOXOOOOOOXOOOOOOXOOOOXXXOXXOXOOOXOX
OOOOOOXXOOOXOXXOOXOOXOOOOXOXXXOOOOOOOOOXOOOOOOOOXOXOOXOOOOOOOOXXXXOXOOOOOOOOXOXOOOOOOOOOXXOOOOXOOOOOO
OOXOOXOOOXOOXXOOOOXOOXOXOOOXOOOXOOOOOXOXOOXXOXOOOOOOOOOOOXOXOOOOOOOOOXOXXOOOXOXOXOOOOOOXOOOOOXXOOOOXO
OXXOOXOOOXOOOXXXOOXXOOOOOOXOXOOOOOOOXXOOOXOOOXOXOOXOXOOOXOOOOXOOOOOXOOXOOXOOOXXOXOOOXOOOXOXOOXXOOXXXO
OOOOOXOOOOOXXXOOOOOXXOOXOOOXOOOOOOXXOOOOOOXOOOXOOOOOOOOOOXOOXOOOOOXOXOOOXXOOOOXXOOXOXXOOXOOOXOOOXOOOO
OOOOOOOOOOXXOXOXOOXXOXOOOXOXOXOOOOXOOOXOOXOOOOXXOOOOXOOXOOXOOOOOXOOOOOOOOOOOOXXXOOXOOXOOOOXOXOXOXOOXO
OOOOOXOOOXOXOOOOOOOOOOXXXXXXOXXOOOXOOXXOOOOXOOOXXOXOXOXOOOOOOOOOXOOOXOOXOOXOXOXOOOXOOOOOOOOOOOOOOOOXO
XXXOXOOXOXOOOOOOOOXOOOXXOOXXOXXOOOOOOOOOXXOOXOOXOXOOOOOOOOOXXOOOOOOOXOOOOOOXOOOXOOOXXXOOXOXOOOXXXXOOO
OOXOXOOOOOOOOOOOOXOOOOOOOOOOOOXXXOOOOOOOXOOOOOOOXXXOOXOXOOXXXXOOOOOXOXOOOOOXOOOXOXXXOOXXOOOOXOOXXOOOX
XXOOXOOXOOXOOXOOXOXXOOOXOXOOXXOOXXXXOXOXOOOOOOOXXOOOOOXOOOOXOOOOOOOXOXOOOXXOXOOOOXOOOOOXOXOOXOXXOOOOO
OXOXOOOXXOOXOOOXXOOOXXXOOXXXOOOOOOOXOOOOOOOOOXOOOOOXXXXOOOOOXOOXXOXXOOOOOOXOXOOXOOOOOOXXOXOXXOOOOXXOO
XOOOOOOXXXXOXOOOXOXOXXOOXOXOXOXOXXOXOXOXXXXXXOXXOOOOOOOOXOXXOOOOXXOOOOOOXXXOOXOOOXOXOOOOOXOXXOOXOOOOO
OOOOXOXOXOXXXXOXXOOXOXOOOOOOXOXXOXXOOOOOOOXOOOOOOOOOOOXOXXOOXOXXOOOOOOXOOOOOOOXXOXOXOOOXOOOOOXOOOOOOO
XOXOXOXXXOOOOOOOOOOXXOOOXOXOOOOXXXOXOOXOOOOOOOOXOOOOOXOOOXOOOOOOOOXOOXOXOOOOXOOOXXOOOOXXOOXOOOOOOOOOX
OOOOOXOXXOOOXOOOXOXXOOOOXOOOOOXOXOOOOOOOOOOOOOOXOXOXXXOOXOXOOXOOOOOOOOOOXOXOOOOXXXOXOOXXXOOOXOOOOOOOO
XOOXXOOOXXOOOOXOOOXXXXXXXOOOOOXOXXOXOOOOOOOOXXXOOXOXOOXXOOXOXOXOXXOOOXOOXXXOXOOOOOOOXOOXOOOXOOXXOXOOO
XOOOOOOOOOOOOXOOOOOOOOOOOXOOOOOOXOOOOOOOXOOOOXOOXOXXXOOOOOOOOOXOOOOOOXXOOOOOXOOOOOXOOOXOOOOXOOXOOOXOO
OOOOOXOXOOOXXOOXOOXOOOOOXOXOOOOOOOOOOXOOOXOXOXXOOOOOOOOXOOOOXOOOOOXXXXXXOOOOOOOOOOOOXOOXOOXXXXOOOOXOX
XOXOXOOOOOOOOXOOOOOXOXOOXOXOXOOOOXOOXOOOXOOOOOOXXOXOOOXXXOOOOOOXXOOOOXOXXOOOOOOOOOXXOOXOXOOXOOXXXOXOO
OXOOOOOXOXOXOOXXOOOXOOOOOOOOXOXXOXXOOXXXOOOOXOOOOOOXOOOXXOOOOOOXOOXOOOOOOXXOXOOOOOOOXXOXXOOOXOOOOOXOX
XOOOXOXXXOOXXOOXOOOXOOOOXOOOOOOOOOXXOOOXOOXXOOOXXXXOOOXOOOOOOOXXXOOXOOOOOOOOXOXOXOOXXXOXOOOXOOXOOOOOX
OXOOOXOOOOOOOXOOXOOOXXOOOOOOOXOOXXOOOOXXOXOOOXOXOXOOOOXXXOOXOOOOOOOXOOXOXOOXOOXXOXXXOOOOOOXXOOXOXXOOX
XOOOOOOOOOOOXXOOOXOXOOOXOOXOOXXOOXXOOOOOXOOOOOOOOOOOXOOOXOOOOXOOOOXOOOOOOOXXOOOOOOOXXXOOOXOXOOOOOOOOX
OOOXOXXXOOOOOXOOOXOXXOOOOXOXOOOXOOOXOXOXXOOXOOOOOOOXXOOOOOOXOOXOOXOOOOXOOOOOXXOOOXOXOOOOOOOOOOOOOXXOX
OOOXXXXOOOOOXXXOOOOOOOXOOOOOOOOOXOOOOOOOOOXOOOOXXXXXOXOOOXXOOOOOXOOOXXOOOOOXOXXOXXOOOOOOXOOXXXXOOOXXO
OOOXOOOOXOOOOXOOXOXXOOOXOXXOOOOOXOOOOXOOXXXXOOOOOOOOOOXOXOOOOXOXXXXOOXOOOOOOXXOOOOOOXOOXOXOOXOOOOOXXO
XOOOOOOOXOOOOOOOXOXOXOXOOOOXOXOXXOOOOXOXOOOOXOOOOOXOXOOOOOOXOOXXOXOOOOOOOOOOOXOOXOOXXOOOOOOXXOOXOXXOX
XOXOOOXOOOXOOOOXOXOOOOXXOOOOOOOOOOXOXXOXOOOXOOOOOXOXOOOOOOOXXXXOOXXOOOOXOOOOXOXXOOOOXOOOOXOOOOOXOOOOX
OOXOXOXOOXOXOOXXOXXXOOOOOXOOOOOOOOXOXOXOXXOOOOOOOOOOXOXOOXOOOOOXOOXOOOXXXXOOOOOOOOXOOOXOXOOOOXXXXOOOX
OOOXOXXOOOOOXOOOXOOOOOOXXOOOXOOOOOOOOOOXOXOOOOXOXOXXOOXOOXXOOOOOOXXOOOOXOOOOOOOOOOOOOXOXOOOOOXOOXOOOO
XOOOOOXXXXXOOOOOXOOXXXOOOOOOXOOXOOOXOOXXXOOOXOXOOOOOOOXOOOOOXXOOOOOOXOOXOXOOOXOOOXOXOXXOXXOOOOOXXOOOO
OOOXOOXXOOOXOOOOXOOOXOOOOOOOOOXOOOOOXXOOOOOOOOXOOOXOOOOOOOXOOOOXOXOOXXOOXOXOOXOOOOOXOOOXXOXOXOOOXOOOO
OOOOOXOXXOXOOOOOOOXXOXOXOXOOOOOXOXXOOXXOOOOOOXXXOXOOXOXOXXOOOOXOXOOXOXOOXOOXOXXOOXXOOXXXOOOOOXOXOXXOX
OOXXOOXXXOXOOOXXOXXOXOOOXOOXOXOOOXOOOOOOOOOOOOOOOXOXOOXOOXOOOOOOOOXOOOOXOOOOOOOXOOXOXOXXOOXOXOOXOOOXO
OOOOOXXOOOOOOOOOOOOOOXOOOOOOXOOOOOOXOXOOXOXOOOXOOXXOOOXOOOXOOXOOOOOOOOOOOXOOOOOXOOXOOXOOOOOXOOOOOOOOO
OXXOOXOOXOOOOXOOXXOOOOOOOOOOXOOOXOOOXOOOOOOOXOOOXOOXOOOOOXXXOXXXOOOOOOOOOOOXOXOOOOOOXXOOOOXXXXOOOOOOO
XOOOXOOOOOOOOOOOOOOOOOXOOXOOOOXXXOXOOOXXOXOXXOXOXXOOOOOOOXOOXOXOXOOOXOOOXXOOXOOOOOOOXOOXOXXOXOOOOXXOO
OOOOOOOOOOOOOOOXXOOOXXOXOOXOOOXOXXOXXOXOXOXXOOOOOXOOOXOOOOOXOXOOOOOXOOOOOOOXOXOXOOOOOOOOOOXOOOXOOOOXO
OOOXXXOOOOXOOOXOOXXXOOOOOOOOOOOOOOXXOOXOOOOOOOOXOOOOOOOOOOOOOOOOOOOXOXXOXXOOOXOXOOOOXOOOOOXOXXXOOOXOX
XOOOXOXOXXOOXOOOOXOOXOOOOOOOXXOOOOOOXOXOXOOXOOOXXOXOOOOOOOOOOOXOOOOOOOXXXOOOOOOOOOOXOXOOXOOOOOOOOOOXO
XXXOXXOOOOXXOXXOXXOOXOXXOOOOXXOOOOOOOOOOOOOOOOOOXOOOOOOOXOXOOOOOOXOXOOXXOOOXOXOOOOOOXOOOXOOOOOOOXOXOO
OOOXOOOOXOOXXOOOXOOOOXXXOOOOOOOXOOOOOXOOOOOXXXOOOOOOOOOOOOOOOOOOOOOOOOOOXOOXOOXOOXOOXOOOXOXXOXOOOOXXO
XXOOOOOXXXOOOOOXOOOXOOOXOXOOOOOOOOOXXXOOOOOOOOXOOOXXOOOOOOXXOOOOOXXOXOOXOOXXOOOOOOXOXOXOOOOOXOOOOXOOX
OXXOXXOOXOOOOXXXOOOOXOOXXOXOXXOOOXOOOXOXOOOOOOOOOOXOXOOOOXOOOOOOXOOXOXOOOXOOXXXOOOOOOXOOOOOOOOOOOOOOO
OXOXOXXOOXOOOOOOOXOOOXXXOXXOOOOOOOOOOOXOOOOOOOOOXOXXOXOXOOOOOOOOXOOXXXOXOXOOXXOOOXXXOOXOOXOXOOOOXOXOO
OOOOXOOOOXXOOOXOXOOOOOXOOOXOOXOXOOXOOOOXOOOOOOXOOOXXXOOOOOXOOOOXOOOOOOOOOOOXOOXOXOXXOOOOXXOXOOOOXOOOO
OOOOOXOOOOOOOOOXXOOOXOXOOOOXOOOOOOXOXXXOXXOXXXOXOOOOOOXOOOOOOOOXXXXXOOOOOOOXOOOOOOOOOOOOOOXOOOOOOXOOX
OXOXOXOOOOXXOXOOOOOOOOXXOOOOOOOOXXXOOOOXOOOOOXXXXXOOXOOOOXOOXXOOOOXOOXOXOOOOOOXOXXOOXOOOOXOOOXXOXXOXO
OXXOXOXOOOOOOOXOXOXOOOOXOOOOOOXOXOXXOXOXOOOOOOOOOXOOXXOOXXOXOOXXOOOOOXXXOOOXOOOOOOOOOXOOOOOOXXOOOOXXX
OOXOXOXOOOOOOOXOOXOOOOXOOXOXOOOXOOXOOOOXOOXOOXXXOOOOOOOXOXOOOOOOOOOOOXOXOOXOXOOOXOOOOXOOXOOOOOOXXXOOX
OOOOOXOOOXOOOOXOOOXXOXXOOOOOOOXOOOXXOOOOOOXOXOOXOOXXOXOOOOOXXOOOOOXXOOXXOOOOOOOOOOOOOXOOXXOXOOOXOXOOX
XXOOOXOXOXOOXXXXOXXOXXOOXOOOOOOOXOXOOOOOOOXXXOXOXOOXOOOOOXOXOOXOXOOXOOOXXOOOXOXOOOXOXOOXOXOOOOXOOOOXO
XOOOXOXXOXOOOOOOOOXOOOOOOOOOOOOXOXOOOOOOOOXOXOOOOOOXOOOOOXOOOXOOXOOOOOOOXOXOOOOOOOOOOOXXOOXOOOOXXXOOO
