OXOXOOXOOOOOOXOOOOOXOXXXXOOXXXOOOXOOOXOOXOXOOXXXXOOOOXOOOXOOOXXOOOXXOXXOOOOXXOOOOOOXXOOOXOOOOOOOOOXXX
XOOOOOOOXOOOOXOXOOXOOOOOXOOOOOXOOOXOOXOOOOXXXOXOOXXXXOOXXOOOOOXXOOOOOOOXXXOOOOOXOXOXOXOXOOOOOXOOOXXOO
OOOXXOOXXOXXOXOXOOOOXOOOOOXOXOOXXXOOOOOOXOXOOOOOOXXXXOXOOOOOOXOOOXOOOXOOOOOXOOOXXOOOXXXOOXXOOXOOOOOOO
OOXXOOOOOXOOOOOOOOOOOOXXXOOOOOOOOXOOXOXOOXOOOOOXOOOOOXOOOXXXOOOOOXOOOXXOOOXOOXOOXXXOOOOOOXOOOOOOOOXOO
XOOOXXOOOOOOOOOOOOOOXXOOXOOOXOXXOOOOOXXOOOOOXOOOOXOXOOOOXOOXOOXOXOOOXOOOOOOXOOOOOOOOXOOOOOXOOOOOOXOOO
XOOOOOXOXXOOOOOXXOOOOOOOOXXOOOOXXOOOXXOXOOOOOXOOXXOOOOOXXOOOXOXOXXOOOXXOXOXXXOOXOOXOXOOOOOXOXOOOOOXOX
OXOXOOOXXXOOXXOXOOOOOOOOXXXXOOOOXXOXOXOOOXXOOOXOOOOOOXOOOOOXXXOXOXOXOOOOXXOXOOOOOOOOXOXXOXOXOXOXXOOOX
OOXOXOXOXOOXOOXOOOXOXOOXXOOXOOXOOOXOOOXOOXOOOOOOOOXOXOOOOOOOXOXXXXXXOXOXOOOOXOOOXOXOOXOOOOXOOOOOOOOXX
OOXOOOOOXXOOOOOXOOOOXXXOOOOOOXXOOOOOXOXXXOOOOXOXXOOXOXOOXOXOOOOOXOOOXOOOOOOXOXOOOOXOOXOXOXOXXXOXOOXXO
OOOXOOOOOOOXOXXOOXXOOOOOOOOOOXOOXXOOXXXXOOXOOOOOOXOXOOOOOOOXOOXOOXOXXOXOOOOXOOOXOOXOOXOOOOOXOOXXOXOXO
OOOOOXXOOXOOXOXOOOOOOOOOXOOOXOOOXOXOOXOXOOOOOXOOOOOOOOOOXOXXOOXOOXOOOXXOOOXOXXOXOXXOXOOOOOOOOOOXOOOOO
OOOOOXOOXXOOOOOOOOOXOOOOOOOOOOOXOOXOOXOOOOOOOXOOOOOOXOXOOOXXOXXXOXOOOXOOOOXOOOOXOXXOOOOXOXXOXXOOOOOOO
XOOXOXOOOOOXOOOOOOOOXXOOXOXOXOOXOXXXXXOOXOOXOOOOOOOOOXOOXOOXOOOOOOOOOXOOXOOXOOOOOOOXXXXOOOOXOOOXOOXOX
OOOOOOXOOXXOOOOOXOOOOOOOOXOOXXXOXXOXXOOXXOOOOOOXOOXXOXXOXOXOOOOOXXOOOOOOOXOOOOOOXOXXOOOXXXOXOOOOXOOXO
OOXOOOXOXXOOOOOOOOOOXOXXOOXOOOOOOOXOOOXOXOOOOOOXOOOXXOOOOOXOOOOXOOOXXXXOOOXOOOOXOOXOOOOOXOOXOOXOXOOXO
OOXXOOOOOXOOOOXOOOOOXOOOOOXXOOOXOOXOOOOOOXOXXOXXOOOOXXOOOOOXXXOOOOOOXOXXXOOOXXXOXXOXXOXXXOOOOXOOOOOOO
XOOXXOXOOOXOOOOOOOXXXOXOOXOXXOOXOXOXOOOOXOXXXOOXOXOOOXXOOOOOOXOOOOXOXXXOOOOXOXOXXOOOOOOOOOOOXXXXOOOOX
OOXOOOOOOOXOOOXOOOOXOXOOXOOXOOOXOOXOOXXOOOOOXXOOOOOOOOOXOOOOOXOOOXOXXOOXOOOOOOOOOOOOOOOOOXOOOXOXXXOOO
OXOOOXOXOXXOOXXOXXOOOOXOOXOOOXOXOOOOOXXOXOXXOOXOOOXOOXOOOOOOXOXXXOXOOOOXOXOXOOOOOOXOOOOOOOXOOXXOOXOOO
XOOOOOXOOXOXOOXOXOOOOXOXXOXXOXOOXOXOOOOOOOOOOXXOOOXOXOOOOXOXOOOOXOXOXXXXXOXOXOOOOXOOXOOOOOOOXXOOOOOOX
XOOXOXOOXOOOOXXXOOOOOOOOOXXXXOOXXOOOOOOOOXOOOOXOXOOXOOOOOOXOOOXOOOOOXXXOOOOXOOOXXOOXOXOOOXXOXOOOXOOXO
XOOOOOOXOXOOXXXOOOXOXOOOOOOOOOOOOOOOOXXOOOXOOOOOOXOOOOOOOOOOOOXOOOXXOOOXOXOXOXOOOOOOOXXOOOOXOXOOOXOOX
OXOOXOXXOXOOXOOOOOXOOOOOOOOXOOOOOXOOOOOOOOOOOXOOOXXXOOOOOOXOOXOXXOXXOOOXOXXOXXOOXXOOOXOXOOXOOOOOOXXOO
XXXXOOXXOXXOOOXXOXOXOOOXOOOXXOXOOOOXOOXOOXXOOXOOXOOXOXXOXXOOOXOOOXXXXXOXOOOXXOOXOOOOOXXOOOOXOOXOOOOOO
OOOOXOOOXOXOOOXXOOXOOOXOOOXOOOOXXOOOXOOOOOXOOOOOXOOOXOOOXOOXOOXOOOXXOOOOOXXOOXOOOOOOOXOOOXOOXXOOXOXOO
OOOXOOXXXOOOOXOOXOOOOOXOXOXXOOOOXXXOOXXOXOOOOOOOOOXOOOXOOOXOOOOOOOOXOOOOOOOOOXOOXOOOOOXXOOXOOOOOOOOOX
XOOOOXXOXOOOOOOXXOXOOXOOXOOOOOOOOOXXOOXOXOOOOOXOXOOXOOOXOOXOOOXXOOXOOOXOOXOOXOOOXXXOXOOXOXOXXOOOOOOXO
XXOXOXXOOXOOOOXOOOOOXOOOOOOXOOOOOOXXXXOOXOOXOOOOOOOOXXOOOXOOXOOXOOOOOOOXOXOXOXOOOOXOOXOOXOOXOOXOXOOOX
OOXOOXOXXOXOOOOOOOOXXXXOXOOOOOXOOOXOOXOXOOOXOXOXXOOOOOXOOXOXOOOOXOXOXOOOOOXXXOOXOOOOOXOOOXXOOOXXOXXXO
OOOOOOOOXOOOOXOXOOOOOOOOOOOOOOOOXOOXOOOOOOXXXOXOOXOOOOOOOXXOXXOXXXOOOXOOOOXOOOOOOOOOXOOOOOOOOXOXOXOOO
OOOXOOOOOOOOOOOOXXOOOXXXOOOOOOOXOXOOOOOOOOOOOXOOXXOOXXOOOOXOXOXOOOXOOXOOOOOOOXOOOOOOOOXOOOXOXOOOXXOOO
XXXOOXOOOOOOOXOOOXOOOXXXOOOOXOXOOOXXXOOOOOOOOXOOXXOOXOXXOOXOXOOXXOOXXOOXXOOXXXXOOOOOXOOOOXXXOOXOXOXOO
OOOOXOOOOOOOOXXXOOOOOOOOOXOOOOXOXXOOOOOOOOOOXXXXXOOXOOXOOOXOOOXOOOOXOXOXXOOXOXOOXXOOOOOOOOXOOXXXOXOOO
OXOOXOXOOOOOOOOXOOOXOOXXOOOXXOOOXOOOXOOOOXXOOOOOOOXOOOOXOOXOOXOOOOOOOOOOXOOOXOOXXOOOOXOXOXOOOOOXOOOOO
OOOXOOOOXOXOOOOOXOOOOOOOXOOOOXXOOOOOOOXOOOXOXOOOOXOOXOXOXOOOOOOOOOOOOOXOXOXOOOOOOOOOOOOOOOOXOXXOOOOXO
OOOOOXOXOOXXOXOOXOOOXOOOXOOXOOXOOOXXOXOOXOOOXOOXOXOOXXXXOOOOXXOOXOOOXOXXOXOOOOOOOXXOOOOOOOOOOOOOOOOOO
OXOXXOOXOOOXOOOXOOOXOXOOXOOOOXXXXOXOOOOOXXXOOOOXOOOOOXOOXXOOOOOOXOOXOOOXXOOXXXXOOOOOOXOXXOOOXOOOOOXXX
XXOOOOXOXOOXXOOXXXOXOOOXOXOXOXOOOOOOOOOOXXXOOOXOOOXXOOOXXOOXXXOOXOOXOOXOOOXOOOOOOOXOOOOOOOOOXXXOOXOXO
XOOXXXOOOOXOOOOXOOOOOOOOOOOOOXOOOOOXOOOOOOXOXXOOOXOOOXXOOOXXOOXOOOXOOOOXOOOOOOOOOOOOOOOOOOOXOOOXOOOOX
XOXXOOOOOOOXOOOOOOOXOOXXOXOXOOOOXOOOOOOOOOXOOOXOOOOOXXOXOOOOXOXOOOOXOOXOOXOOOOOXOOXOOOOOOOOXOXOOOOOOX
OOXOOOOOXXOOOXOOOXXOOOXOOOOXOXXOOXOOXOOXOOXXOOXOOOXOOOOOOOOOOOOXXOOXOXXOOOXOOOOOOOOOOXOOOXOXOOOOXXOOX
OOOOXOOOXOOOXXOXOOXOOOXOOXOOXOOOXOOXOXOOOOOXXOXOOOOOOOOXXXOXXOXXOOOOOOXOXOXOOXOXOOXOOOOXOOOXXOXOOXXOO
OOXOXOXOOXOOOOOOXOXXXXOXOOOOXOXOOOXOOOXOOOXXOXOXXOOOOOOOXOOOOOOOOOOOXXOOOOOOXXOOOOOOXXOOOOOOOXXXOXOOX
OOOOXXOOOOOOOOXOXOOOOOOXOOXOXOOOXOOXOOOXOOXOOXOOXOOOOOXXOOOOOOXXOOXOOOOOXOXOOOOOXXXXOOOOOXOXOOOOOOOOO
OOOOOOXXOXXXXOOOOXXOXXXXOOOOOOOOOOXOOXXXOOOOXXOOOOOOOOOOXXXOOOXOXOXXXOOOOOXXXOXOXOOOOOOOOOOOOOOOOXOOX
XOXXXOOOXOOOOXOXOOXOXOXOOXOOOOOXOOXXXXOOOOOXOXOXXXOOOOXOOOOXXXOOXOOOOXOOOOXXXXOOOOXXOOXXOOOOXOOOOXXOO
OOOOOOOOOXOOOOXOXOOOOOOXOOOOOXOXOOXXOOOOXXOXXXOOOOOXOOOOOXOXOXOOXOOOXOOOOXOOOOOOOOOOOOOOXOOXOXOOXOXOO
OOOOXOXOOOOOOXOOXOXXOOXOOOXOXOXOXOOOOOXOOOOOOOOXOOOOOOOXOXOOOOXXXXXOOXXXXOOOOXXOXOOXXOOOXOOOOXXXOOOOO
OXOOOOOXOOXXOOOOOOOXXXXOOXOXOXOOXOXXXOXXXXOXOOOOOOOOOOOOXXOOOOOXOOOOXOOOOOOOXOXXOOOOXOOOOOXOOOOXXXOXO
OOOXOXOXOXOOOOXOOOOOOXXOXOOOOXOXOOXOOOOOXOOOOOOXOOOOOOXOOXOXXOXOOOOOXOOOOOOOOOOOOOXOXXOOXOXOOOOOOOOOX
XOOOXOOXXXOOOOOOOOOXOOOXXXXOOOOOOOOXXOOOOOOXOOOXOOOOXXOOOOXOXXOOXOOXOOXOOOOOXXXOOXOOOXXOOOOOOOXOOXOOO
OOOOOXOOOXOXOXOOOOOOOOXOOXOXOXXXOXOOOOOOOXOXXXOOOOOOXOOXOXOXOOOOOXOOOXXOXOOOXOOOOOOXXXOOOOXXOOOXOXXOO
OOOOOOXOOXOOOXXOOOOXOOOOOOOOXOXOOXXXOOOOOOXOOOXOOOOOOXOXOXOOOOOXOXOOXXOXOOXOOXOXXOXOOOOOOXOOOXOOOOOXO
OXOOXOXOXOXOXOXOOXOXXXOOOXOOXOOOOOXOXXOOOOOXOOOOOXOOXOOOOXXOOOOOXOXOOOOOXOXOXOOOOOOOOOOXOXOOOXOOXOOOO
OOXXOOOOOXOXOOOXOOXOOOOOOOOOOXOOOOOOXOOOOOOXOXOOOOOOOOOXOOXXXXOOOOOOOXXXOXXXOXOOOXOXXOXXOXOXXOXOOOOXO
OOXOXXOOXXOOXOOXOOOOOXXOOOOOXXOOXOXXOOOOOOXXOOXOOXXOXOOXXXOXOXXOOOOOOOXXXOXXOOOOXOXOOOOOXOOOOOXOOXOXX
OOOOXOOXOXOXOOOOOOOOXXOOXOOOXOXOXOOOXOOXOOOOXOXOOOOOOOXXOXOOXOOXOOOOOXOOOOXOXOOOOOOXXOXXXOOOXXOXOOXOO
OOOOOXOXOXXOOXXXOOXOOXOXOOOXOOXOOOOOOOOOOOOXOXXXXOXOOOXXOOOOOOOOOOOOXOOOOOXXOXOOOXXXXOOXOXXOOOOOOOXXO
XOOXOXOOXOOOXOOXXOOOOXXOOXOOOXOXOXOOOOOOXXOOXOOOOOXOXXOOOOOXXOOOOOXOOXXOXOOOOOOXOOOOXOOOXOOOXOOXOOOOO
XXOOOXXOXOOOOOOOXXOOOOOXOXOOOXOOOOOOOXOXOOOOXOOOOOOOXOXXOXOOOOXOOXXXOOOOXOOXOOOXXOOOOXXOOOOOOXXXOOOXO
XOOOXOXOXOOOOOXOXXXOXXOOOOOOOOOOOXXXOOOOOXOOXXOXOXXOOOOOOXXXOOOOOOOOOOOOXXOOXXXOXXXOOOOXOOXOOOXOOXOOX
OOXOXXXOOOOOOXXOOOOXOOOXXOOOXOOOOOXOOOOOXXOXXOOXOOOXOOOOOOOXXXOOXOOXOOOOXOOXXOXOOOOOOOOOOOXOOOOOXOXOX
OOXOXOOOOXOOOOOOXXOOOXXOOOOOXXOOOXXOOOXOOXOOOXOOOXOOXOXXOOOOOOOOOOOXOOOOXXOXOOOOOOOOOOOOOOOXXOOOXXXOX
XOOOOXOOOXOXOOOOXOOXOOOOXXOOXXOXXOOOOOOXXOOOOOXOOXOXOXXOOOOOOXXOXOOOOOOOOXOOXOOXOOOOOXOOXOXOOXOOOOXXO
OOOOOOOXOOOOXXOOOOXXOXOOXXXOOXXOOOXXOOOXOOXXOOXOOOXOOOOOOXOXOOOXOOOOOXOOOXOOOOXOOOOOOOOOOOXOOOOOOXOXX
XOXXXOOXOOOOOOOOXOOOXOXOOOXOOOOXXOOXOOXOOOOOOXOOOOOOXOOOXOOOOXXOOXOXXOOOOOOOXOOOOOXOOOOXOXOOXOXXOXXOO
OOOOXXOOOOOXXOOOOOOOOOOXOOOXXOXOXOOOOXOOOOXOOOOOXOOXOOOOXXOOXOXOOOXXXOOOOOOOXXOOOOXOOOOOXOOXOOXXOXOXO
OOOOOOXXOXXXXOOOOXOOOOOOXOXOOXXOOOXOOXOOOOOOOXOXOOOOOXOXOOXXOOOOOOOOOOOOOXOXOOOOXOXXOOOOOOXXOOOOOOXOO
XXXOXOOXOOOOXOOOXOOOOXOOOOOOXXXXOXOXOXOOOOXOOOOOOXXOOOOOXXXXOOOXOOOXOOOOOOXXOXOXOOOOXOOXXOOOXOOOXOOOX
OOOOOOXOXXOOOXOOOOXOOOOOXXXOOOOOOXOOXXOXOOOOOOOOOOXOOXOOOXOOXOXXOXOOXOXXOOXOXXOOOXOOOXOOOOXOOOXOOOOOO
XXOOXOXXOXOXOOOOOOOOOOOOXXOOOOXXXOOOXOXOOXXXOXOOOXOXOXXXOOOOOXOOOOOXOOOOOOOOOOOXXOOOOXXOXXOOOOOOOOOOO
OXXXXOXOOOOOXOXOXXOXXOOXOOOXXOOOOOOOOOOOOOOOOOOXOXXXXXOXXOOXOOOXXOXXOOOOOOOOXXXXXOOXOOOOOOXXOOOXOOXOO
XXXXOOOOOOOOOOXOOXXOOXOXOOOOOOOOXOOOOXXXXOXOXOXXOOXXXOXOOOXOOOOOOXXXOOOXXXOXOOOOXXXOOOXOXXOXOXOOXXOXO
XOOOOOOOXOOXOXOXOOOOOOXOXOXOOOOOOXXOOXOOXOOXOOOOOXXOXOOOOXOOOOOOXOOXOOOOOOOXXXXXOOOXOOOOOXOOXXOOXOOOO
XOOOOXOOOOOOOOOXXXOOOOXOOOOXXOXOOOOOOXOOOOXOOXOOOOXOOXOOOXOOOOOOOXOXOOXXXXOOOOXOOXXOXOOOOOOOOXOOXOXOO
OOOOOOOXOXXOOOOOXOOXXOOXOOXOXOXOOOOXXOOOOXXOOOOOOOOXXXXXOXOOOXXXOOOOXOOXXXOOOOXXXOOXOOOOXOOOOXOOOOOXO
OOOOOOXOOOOOXOOOOXOOOOOOXOOOXOXOOOXOOOOOOXOOOXXOXOOXOOXOOOOOXOOOOXOOXOOOOOXXXOOOXXOXOOXXXXOXOOOXOOOXO
XOOOOXOXXXOOOXOOOOXOOXXOOOOOOOXOOOOOOXXXOOOOOOOOOOOOXOOXOOOXOXOOXOOOOXOOXOOOXOOOOOOOOXOOOOXXOOOOXOOOX
OOXXXXXXOOOXOOOOOOOXOOOXOXOXOOOOOXXOOOOOOOOOXOXXXOOOOXXOXOOXOOXXOOXXOOOOXOOOOXOOOOOOOOOOOOOOOOXOXOOXO
OOXOOOOOOXXOOOOOOOXOXOXOOOOOOOXXOOOOOOOXOOOOXOOXOOXOOOOOOXXOXXOXXOOXOOOOXOOXXOXOOXOXOOXOOOOXOXOXXXXOX
XXOOXXOXOXOOOOOXOXOOOOXXOXOXOOOOOOOOOOOOXOOOOOOOXOXOXXXOOOXOOOOOOOOOOOXXOXOOOOXXXOOXOOXOOOOOXOOOXOOOO
OXOXXOXOXXOOOOXXOOOOOOOOOOXOOOXOOXOOOOOXOOOOXXXOOOXXOXOOOOOOXOOXOXXOOOOXOOXXOXXXOOOXOXOOOOOOOXXOOOOOX
OOOOOOXOOOOOXOOOOXOXXXOOOOOXOXOXOOOOOOOOXOOOXXXOOOOXOOOOOXOOOOOOOXXOOOOOOOXOOXOOOOOOOOOOXOXOXXXXXXOOX
XXOOOOOXOOOOOOXOOOOXOXXXOOOOOOXOXXOOOXOOOOXOOOXOOOOXXOOOXXOOOOXXXXXXXXOOOOOOXOXXOOXXOOOOOOOOXOXOOOXOO
XOOOOOXXOOOOOOOXOOOOOXOOOOXXXOXXOOOXXOOOOXOOXOOOOOOOOOXOOXOXXXOXOXOOXXOOXXOOOOXOOOOXOOOOOOXXXXOOOXOOO
OOOOXXOXXXOOOOOXOOXOXOOOOXOOOOOOXOXOOXOOOOOOXXOXOOOXXOXXOOOOOOOOXOOXOOXOXOXXOOOOXXOXXOXOOOOOOOXOXOOOO
XOOOXOXOOOOOOXXXOXOOOXOXOXOXOOOOOOOOOOXOOOXOXOOOOXXXXOXXOOOOOOXXOOOOOXXOXXXOXOOOOOOOXOOXOOOOXOXXOOOOO
XOXXXOOOOOOOOOOOOOOXOOOOOOOOOOOXXOOOOOXXXXXXOOOXXOOOXOOOOXOOOXXOOOOXXOOOOOOXOOOXOOOOOXOXXOOXOOXXOXXXO
OOOXOOXOOXOOXOOXOOXOXOOOOOXOOOOOOOOOXOOXOOOOXOOXOOOOOOXOOOXOOXOOXOOOOOOXOOOOOXOOOXXOXOOOXOOOOOOOOOOOO
OOOOXOOOOOXXOOOOOXOXXXXOXOOXOXOXOOXOXXXOOOXOOXOOXXOOOOOOOOOXXXXOOOOOXXXOXOOOOXXOXOOOOOOOOOXOOOXOOOOXO
XOXOXOOOOOOOOOOOOOOOOOOOOXOOOOXOOOOOOOXOOOXOOXOOXOOXXOXOOOOOOOXOOOOOOXOXOOOOOOOOOOOOOOXOOOOOOOOOOXXOX
OOOOOOOOXOOOOXXXXOOXOOOXXXOOOOOOXOOOOOOOOOXXOOOOOOOOXOXOOOOOXOOOOOXXOOOXOXOOXOOXOOXXOXOOOXOOXXOOOOOOX
OOOOOXXOOOOOOOXOXOXOXXOOXOOXOOOOXOOXOOOOOOXOOOOOOOOXOOOXOXXOOOOOOXOXOOXOXOXOXXXXOOXOOXOXOOOXOOOOXXXOX
OOXOOOXOOXXOXOOOOOXOOOXXXOXOOOXXOOXOOOOOXOOOOOXXXXOOOOOXOXXOXXOXOXOOXOOXOOXXOOXOOOOXXXOXXOOOOOOXXOXOO
OXOOOOXOOOXOXXOXOOOOOOOOOOOOOXXOOXXOXXOOOOXOXOOOOOOOOOOOXOOXXOOXXOOOOOOXOXXXXOXXXOOOXXOOXXXOOOOOOOXXO
OOOOOOXOOOOOOXXOOOOOOOOXOOOOXXOOOOOOOOXXOXXXOXOOXXOOXOXXOOXOOOOOXOOXOOOOOOOOOOOOOOOOXOXOOOXOOOOXOOOXX
OOOXOOOOOOOOOOXXOOOXOXXXXOOOOOOOOOOXXOOOXOOOOXXOOOOXOXOXXOOOXOXOXOOXXOOXOOOOOXOOOOXXOXXOOOOXXXOOOOOOX
OOXOXXXOXXXOXOXOOOOOOOOXXOOOOOOOOOOOOOXOXXOXXXOOOOXOXOOXXOXOOOXXOOXOOXXXOOXOOXXOOOOOXOXXOOOOXOOOOXOOO
XXOXXXOXOOOXOXXXOOXOXOOOXOXOOOOOOOOOXOOXOOXOXOXXOOXOOOOOOOOOOOOOOOOOOOXXOOOXOOOOOOOOOOOOOOOOOOOXOXOXO
OOOOOOXOOOOOXOOOOXXOOXOOOXOOOOXXOOOOOOXOOOOOOXXOOOOXOOOXOOXOOOXOOOOXXOOOOOOXOOXOOOOOOXOXOOOXXOOOXXOOO
XXOOOOOOOOXOOXOOXOOOOXXOOOOOXOOXOOXOOOXOOOOOOOOOOOOOOOOOOOOOOXXXOXXXOOOOXOOXOXXXOOOOOOXXXOOOOOOXOOXOX
