OXOOOOOOOXOOOXOXOOOOXOOOXOOOXOXOOOXOOOOXOOXOXXOXXOOXOXXXOXOOOOOXXOXXOOOOOXOOXOXXXOOOXOOOOOXXOXOOOXOOO
OXXOOOXOXOOOOOOOXOOOOOOOOXOXOXOOXXXOOOXXOOXOXOXXOOXOOOOOOOOXXOOXOXOOXXOOOOOXOOOOOOOOXOOOOOXOOXOXOOOOX
XOOXOOOXOOOOOXOOOOOXOXOXOOOOXOOOXOOXOOOOOOXXOOXXOOOXOOOOXOXOOOXOOOOOXOXOXOOOOXOOXOXOXXOOXOOXXXXOOXOOX
OXXOOXOXOOOXOOOOOXXXXXOOXOXXOOXOXOOOOOOXOOOOXOXOOOXXXXXOXOXOOOOOOOOOXOXXOXOXOOOXOOXOXOOXOXXOOOOOXOOOX
OOXOOOOXOOXOXXOOOOOOOOXXXOXXOOOXOOXXOOOOOOOXOXOOOOOXOOXXOOOOXOOOOOOOOOOXOXOOOOOOOXOOOXOOOOXOOXOOOOOOX
OXOXOOOOOOOOXOOXOOOOOXXOOXOOOXOOOXOOOOOXOOXXOOOXXOOOXOXOOOOXXOXOXOXXOOOOOOXXOXOOXOOOOOOOXOXXOOOOOOOOX
OOOXOXOOOXOOOOOOOXOXXOOOXXXOOXOOOOOOOOOOOOOOOOOOOOXOOOOOOXOXOOXOXXOOOXOXOOOOOOXXOXOOOOOXOXXOOXOOXOOOO
OXXOXXOOXOOXOOOOXOOOOOOOXOOXOOXOOXXOXOOXOXOOOXOOOXOXOOOOOOXOOOOOOOOOXXXXXOOOXOXXXOXOOXXOOOOOXXXOOXOXO
OXOOOXOOOOOXXOOOOOOOOXOXOXOOOXXXOOOOOOXOOOOOOXOOOXXOXXOXXOOOOOXXXOXOOOXXXOXXOOOXXXXOOXOXOOOOOXOOXXXXO
OOOOOOOOOOOOXXXOOOOOXOOOXOOXOOOOOOOOXOOOXOOOOXOOXOOXOOOOOXOXOOOOXOOOOOOXOXOOOOOXOOOOOXXOOXXOXXXOOOXOO
OOOXOXOOOOOOOXOOOOOOOOXXOOXOXOOXOOXOXOXXOXOOOXOXOXOOOOOOXOOOXOXOOXOOOOOXXOOXOOOOOOOOXOOXXOXXOOOOOOXOO
XOOOOXOOXOOOOOOOOXOXOOOOOOOOOOOOOXXOOXOOOOOOOXOOXOOXXXXOOOOOOOXOOXOOOOOOOOOXOXXOOXOOXXXXOXXOXOOOXOXOO
OOOOOOOOOOXXOOOOXOOOOXOOOOOOOOXOOOOXOXXXXOXXOOOOXOOOXXOOOOXXXOOOOOXOXOOXXOXOOOXOOXXXXOXXOOOOXOOOOXOOO
OXOOOOXOOOOOXOOOXOOOOOOOOOXXOOOXOOOOXXOOOXOOOOOXOOOOOOOXOOOXOOOOOXOXOXOOXXXXOOXOXOXXXOOXOOXOXOOOOOOXX
XXOOOOOOXXOOOXOOOXOOXXOOOOOOOOOOOOOOOOOXOXXXOOOOOXXOOOOOOOXOXOOOOOOXOOOXOOXOXOOXOOOOXOOXXXOXXOOOXOOXX
OOOOXOOXOOOOXOXXXOXOOOOXXOXOOXOXOOOXOOOOXOOOOOXOXOXOXOOOOXOOXXXXOOXOOOOOXOXOOOOOXXXXOOOOOOOOXOOOOXOXO
XOOOXOXOOOXOOOXOXOOOXXOOXOXOOXOOOOOOXOOOOXOOXOOOOXOXXOOXXOOOOOOOOOOOOXOOOXXXOOOOOOOXXXOXOXOXOXXXOOOOO
XOOXXOOXOXXOOOXOXOOOOOXXOOOXXXOOXOXOXOOXXOOXOOOOOOXOXXXXOXOXXXOXOOOOOXOOOOOOOOOXOOXXXXOXXOOOOOOOOXOOX
OOOOOOXXXXOOOOXOOXOOXXOOXOOOOOOXOXOOXOOOOOOXXXXOXOXOOXOXXOXXOOOOOOOXXOOXOOOOOXXOXOOXOOXOXXXXXOOOXXXXO
OOOOOOOXOXOOXOOOOXOXOOXXOOOOXXOXOOXOXXOOOOOOOOXOXOOOOXOOXXOOOOOOXOXXXOOXOXXOOOXOXOOOOOXXXOXXOOXOOOOOX
XXOOOOXOOOXOOXOOXOOXOOOOXXOOXOOOXOXOOOOOXOOXOOOOOOOOOOXXOOOOOOOOOOOOXOOOOOOXXXOOOOOOOXOOOXOOXXXOOOOXO
OXOOXXXOOOOXOOOOOOOOOXXXOXOOOXOOOXXOOOXXOOXOOXXOOOXOOOOXXOOOXOOOXOOXOOOXXXOOOOOXXXXOOXOXOOOOXOOXXOXOX
XOOOOOOOOOOXOOOOOXXXOXXOOOOOOOOXOOOOOOXOXXXXXOOOOOOXXXOOOOOOOXOXXXOXXXOOXOXOOOOOOXXOOOOOOXOOOOXOOXXOO
OOOOXOXXOOOOOXXXXXXOOOOOOXXOXOOOOOXOOOOOOOXOXOXOXXXOXXOOXOXOOOOXXOOOOOOXOOOOOXOXXOXOOOXOOOOOXOXOXOOXO
XOOOOOOOXXOXOOXOXOOOOXXOOXOXOOOXXOOOOXOOXXXOOXOOOOOXOOOOOOXXXXXXOOXOXOOOXOXXOOXOOOXOXOOOOOOXOOXXOOOOO
OOOOOXOXOOOOXXXOOOXXOOOXXXOOOOOXXOOXXOOXOXOOOOOOOOOOOXOOOOXOOXXOXOOOOOOXXXOOOOOXOOOOOXOOOXXOOOXOOOXXX
XXXOOOXOOOOXOXXOXOOXOOXOOOXXXOOOOOOOOXOOOOXOOOOXOOXOOOOOOXOOOXXXOXOOOXOOOXOXOOXXOOOOOOOXOOOOOOOXXOOOX
XXOOOOOOOOOOOOOXXOOOXOOXOOOOOOOOOOOOOXXOOOXXOOXOXOXXOOOOXXOOOXOXXOOXXOOOOXOOOOOOOOOOOOOOOOOOXOOOOOXOO
OXOOOOOOXOOXOOOOOXOOOOXOXOOXOOOOOXOOXOOXOOXOOXOOOXOOOOOOXOOXXOXOXXOOXOOXOXOXOXXOOOOXOOOXXOOOOOOOOXOOO
OXOOOOOOOOOOOOXOOOXOOOXOOOOOXXOOOOOOXXOXOXOOXOOOOXOOXOOOOOOOOOOOXOOOOOXXOXOXOXOXXOOOXOOXOXOXOOXXOXOOO
OOOOOOOOOXXXXOXOOOOOOXOOOOOOOOOXXOXXOOOXXXOOOOOOOOOOOXOOOOOOOXOOXOOXOOOOOOXOOOOOXOXOXOOOOOOOOOOXOOXXO
OOXOOOOXOOOOOXXOOOOXOOOOOOOOOXXXXOOOOOOXOOOXOOOOXOOXXOOOOOOXOOOOOOOOXOOXOOOOOXXOOOOXXOXXOOXXXOOOXOOOO
OXOOOXOOOOXXOOXOOXXOXOOOOOXOOOXOOOOOOOXOOXXOXOOOXOXOOOXOOOOOOOOOOOOOXOOOOOXXOOOOOOOOOOXOOOOXOOOOXOOXX
OOOOOXOOOOOOXOXXXXOXOOOOXXOOXXXXXOOOOXOOOOOXOOXOOOXOOOOOOXXOXOOOOXXOOOOXXOOXOOOOXOOOOXXXXOOXOOOOOOOXX
OOXOOXXXOOOXOXOOXOOXOOXOXXXOOXOOOOOOXOXOOOXOOOXOOOXXOOOXXOOOOOOOOOOXOOOXOOXOOXOXOOOOXXOXOOXOOOXOOOOOO
OOXXXOOOXOXXXXOXOXXOOOOXXOOOXOOOOXXOOXXOOOXOXOOOXXOOOXOXOOXOXOXOXOOOXXOOOOOXOOOOOOOOOOOOXOOXXOOOOOXOX
XXXOOOOOOXXOOXOOOXOOOXXOOOOOOXXOOOOOOOOOOOXXXOOXXXOOXOOOOXOXOOOOXOOOOOOOOOOXXOOXOOOOOOOXXXOOOXOXOOOOO
XOOOOOOOOOXOOOOOOOXXOOOOOOOOOOOXOOOOXOOOOXXXOOOXOOXOOOXOXXXOXXOXOXOOOOXOOXOXOOOOOOXOXXOOOOOOXOOOXOOOO
XOOOOOOOOOOXOOOOOOXOOOOXOOOOOXOXOOOXOXOOOXOOXOOOOXOOOOOOXOXOOOOOOOXXOXOXOXOOXOXOOOXOOOXOXXOOOOOOXOXXX
OXOOOOOXXOOOOXXOOOXOOOXOOXOOOOOOOXOOOOOOOXXXXXXOXOOOOOXOOOOXOOOXOXXOOOOOOXXOOOXXOXOOOXXOOOOOOXOOOXXXO
XOXOXXOOOXOXOOXXOOXXOXOXOOOXOXOXOOOXXOOOOOXOOOXOOOXXXOOOXOXXOOOOOOXOXXOOXXXXXOOOOOOOXXXOXOOOOOOXOXOXO
OOOOOOOOOOOOXXOOXOOOOOOOOOXOOXOOOXOOOOXXOOOOOOXXOOOOOOOOOXOOOOOOXOOXOXOOXOXOXOOOOXOOOOOOOOOOXXOOOOOXO
OXOXOOOOOOXXOXOXOXOOOOOXOOOOXOOOXOOOOOOOXOXOXXXXOOOOOXOOOOOOXOXOOOOXXXOXXOOOXXOOOOXOOOOOOXOOXOOOXOXXO
OOXOOOOOXOOXOXOXXOXOXOOOOOOOOXOOXOXOXOXOXOXXOXXXOXOXXXOOOOOOOXOOOOOOOOOOXOOOOOOXOXOOOOOOOOOXOOXOOXOOO
OOOOOOXOOOOOOOOOOOXXOOOXOXXOOOOXOXOXOXXOOOOXXOOOOOOOOOOXXOOOOXOOOOXXOOOXOOOXXOOXOOOOOXXOOOOOOOOXOOXOO
OOOOOOOXOOOOXXOOXOOOOOXXOOOOOXOOOOOOOOOXOOXOXXOOOOOOOOOOOXXOOOOXOOOXOOOOXOOOOXOOOOOOOOOOXOOOOOOXOOXOX
OOXOXOOOXOOOXOOOOOOXOOOOXOOOOXOOXOOOOOOOXOXOXOOXXOXOOOOXXOOOOOXOOXOOOOOOOXOXOXOOXXOOOXXOOOOXOOOOOXOOO
OXOOOOOOOOOOXOXXOOOXOOOXOOOOOOOXXOXXOOOXOXOOXXOXOOOXOOXOXOXOOOOOOOOXXXOXOOOXOXXOXOXXOXXXXOXXOOOXOOOXX
OOXOXOOXOOOOOXOOXOOOOOOOOOOOOXOOXXOOOOOXOOOOXXXOOOOOOOOOOOOOOOOXOOXOXXOOOOXOXXXOOOOOOOOXOXOXOOOOOOOOO
XXXXXOOOXOXOXOOOOOXXOOOOOOOOOOXOOOOXXXOXOXOOOOOOOOXOXOXOXOOXOOOXOOOOXXOXOOOOOOOOOXOOOOOXXOOOXOXOOOXOO
XOOOOOOXXOOOOOOOXXOOOXOOOOOOXXXOOOXOOXOXOXOOXOOXOOOXOXXOOOOOOOOOOOOOOOOOOXOOOXXOOOXOXOXOXOOXOOOOOOOOO
OOOOOOOXOOOOOOOOXOXOXXOOXOOOXOOXXOOXOOOOOOOOOOOOOOOOXXXOOOOXOOOOXOOXXOOXOOXXOOXOXOOXOOXXOXXOOXOXOXOXX
XOOOXOOOOXOOOXXOOXOOOXXOOOOXOXOOOOOOOXOOXOXOXOOOOXOXOOOXOOXOXOOXOOOOOOOOXOOOOXOOOOOXOOOXOXOOOOOXOOXOX
XOOOOOXOOOOOXOXOXXOOXOOOOOXXXXXOOOOOOOOOOXXXXOXOOOXOOOOOXOOOXOXOOOOOOOOOOXXOOXOOXOOXOOOOOOOOOOOOXOOXO
OOOOXXOXXXOOXXXOOXOXOOOXOOXOOXOXOOOOOOOOOOXXOXOOOOOOOXOXOXXOOXXOOOXOOOOOXOOXOOOOOXOXOOXOOOXOXXOOOXOOO
XOOOOOOOOOOXXOOXXXOXXXOXOXOXXXXOXOOXOOOOOOOXOOOXXXOOOXOOOXXOXOOOOOOOOOOXXOXXOXOXOXXOXOOOOOOOXOOXOOXOX
XOOXOOOOXXOXXOOOXOOOXXOOOOOOXOOXXOOXOXOOXOOOOOOOOOXXXXOXXOOOOOXOXXOOXOOXXOOOOOOXOOOOOOOXOOOOOXOXOXXXO
OXXXOOOXOOOOOXXOXOXOOOOXOOOOOOXOOXXOOOOOOOOOOOOOXOXOOOXXOOXOOOOXXXOOOOOOXXOOOOOOOOOOOOOXOOOXOXOOOXOOO
OOOOXOOXOOXOOOOOOOXOOOOOOOOOXOOOXOXOOOOOXOXOOOOOOXXOOOOXOOOOOXOOOXOOOXOXOOOOXOXOOXXOOOOOXOOXOXOOOOOXO
OXOXOOOOOOOOOOOOOOXOOOXOOOOXOOXXXOOOOXOOOOOXOOXOXOOOOOXOXOOOOOOOOOOOXOOOOOOOXOXXXOOOOXXOOOOOXOXXOOXXO
XOOOOOXOOOOOOOOOOOOOOOOXOOOOOOXOOOXOOOXXOOOOXXOOXOXOOOOOOOOOOOOXOOOXOOOOXOOOOXOXOOOOXXOXOXOXOOOOXOOOX
XOOOOOOOOXOXOXOOXOOOOOXXXXXOOXOOOOOOXOOOOOOOOOOOOOOOOOOXXOXOXOOOXOOOOXXOOXOXOOOOXXOOXOXOXXOXOOOOOOOOO
OOOXOOXXOXOOXXOOXXOXOOOXXOXOXOOXOXXXOOOOOOOOXOXOOOXXXXOOOOOXOXOOOOOXOXOOOXXOXXOXOXXXOXOXOOOXOXOOOOXOO
OOXOOOOOOXXOXOOOOOOOOXOOOXOOXOOXXOXOOOOOOOOXOOOOOXOOXOXXOOXOOOOXOOOXOOOOOOOXOXOOOOOXOOOOOOXXOOOOOXOOO
OOOOOOOOOOOOXXXOOOOXOXOOOOXXOOOXXOOXOOXOOOOOOOXOOOOOOOOOXOOOOOOXOOOXOOOXOOOXOXOOOOOOOXXOOOOOOXOXXOOOO
OOXOOOOOOOOOOOOXXXOOOOXOOOOXOXOXOOOOOXOOOOOOXXOOOXOXXXXOXXOOOOOOOXXOXXXOXOOXOOOOOOXXXOOXOOOXOXOOOOOOO
OOXOOXOXOOOOXOXXOOOOOOOOXOOOOXOOOOOOOOOOXOXOOOOOOXOOOOXXOOXXXOOXXOOOOOOOOOOOOOXXOOOXXXOOOXXXOXOXOOOXO
OXXOXOOOXXOXOOOXOXOXOOOXOOXOOOOOOOOOOOOOXOXXOOXXOOOXXXOOOOOOOXXOOOXXXOOOOOOOXOOOOOOOXOOOXXXOOOXXOXOXO
OOOOOOOXOXOOOOOOOOXOOOOOXOOOOOOOOOXOOOXXXXOOXXOXOOOOOXOXOXOXXXXXXOOOXXOOXOXOOOOOXOOOOOOOXOOXOXXOXXXXO
OOOOOOXXOOXOOOOXOOOOOOOOOOOOOOOXXOXXXOOOOXXOOOOXOOOXOOOOXXXOOOOOXOOOOOOOOXOOOOOXOOOOOXOOXOOOOOOOXOOOX
XOOXXOOOOOOXOOOOXXXOXOXXOOXOOOOOOOXXOOOOXOOXOXOOXOOOOOXOOXOOOOXOXOXOOOXOOOXOXOXOOXXXOOOXOXOXOOXOOXOOX
OOOXOOOOXXOOOXOXXOOXOXOOOOOXOXOOOOXOOOOOOXOOOOXOOXOOOOXXOOOOOXOXOOOOOOXOOOXXXXXXOOOOXOOOOOXOOOOXOOOXO
OOXXXOOXXOXOOOOOOOXXOOXXOOOOOOXOOXXOOXXOOXOXXXOOXXOOXOXOOOOOXXOOOXXOXOOOOXOXOOOOOXOOOXOOOOOOOXXOXXOOO
XXOXXXXXOOOOOXXXXOOOOOXXXXXOOOXXOOXXOOXXXOOOOOOOOXOOOOOOOOOOOXOOOOXOOOXXXOXOOOOOOXOOOOOOXXOOOOXOXXOXX
OOOOOOOOOOOXOXXXOOOXOOOXXOOOOXXOOOOOOOOXOXOXOOXOXOOOOXOOOXOOOOOOOXXOOOXOXOOXOXOXOOOXXOOOOXOOOOXXOOXOO
XOOOOOOXOOOOOOXOOXXOOOXOOXOXXXOOXOXXXXOOOXOXXOXXXOOOOOOXXOOOXOOOXOXOOOOOOOOXOOOOOOOOOXOOXXOOOOXOOXOXO
OXOOXOOOOOXOOXOOOOOOXXXOOOOXOOOOOOXOOOOOOOXOOOOOXXOXOOOOOXXXOOXXOOOOOOOXOOOXOOOOOXOOOOOOXXOOOOOOOOOXX
OOOOXXXOOXXOXOXXOOOOXOOXOOOOOXOOOOXXOOXOXXOXOOOOOOXOOOOOXOXOOOXOXXOXOOOOXOOOOOOOOOOXOOOXXOOOOXOOXOXOO
OOOXXOOXOXXOOXOOOOOOXOOOXOXOOOOOOOOOOOOOOOOXXOOOOOOXOXOXXOXOOXOOOOOXOOOXOXXOXOXXOXXOXXOOXOOOOOXXOOOOX
XOXXOXOXOXOOOXXXOOXXXOOOOOOOXOOOOOOOOXXOXXXOXXOOXOOOXOXOXOOXOOOXOOXOOOXOXOOXXOXXOOOOOOOOXXOOXXOOOOXOO
OOXOXXOOOOOXOOOOOXOOXOOOOOXXOOXOXOOOOXOOXXOOOOXOXXXOOOXXOOOXXOOOXOXXOOXOXXOOOOOOOOOOOXOOOOOOOOXOOOOOX
XXOXOOOXOOXOOXOXOOOOXOOOOOOOOOOOOOXOOOOOOXXOXXOOXXXXXXOOOXOXOOOOXOOOOOXOXOOOOXOXXOOOOOOOXXOOXXOOOOOOX
OXOXOOXXOXXOOOXOOOOXXOOOOOOOOOOXOXOXOOOOOOXOOOXOOXOOXOOXXOOOOXOOXOOOXOXXOXOOOOOXOOOOXOOOXXOOXOOOOOXOX
OOOOOXOXOXXOOXXOOOOOOXXOOXOOOOOOXXOOXXOOXOOOOOXOOOOOXXOOOOOOOXOXOOOOOXOOOOOXOXOOOOOXXXOOOOOOOOOOOOOOO
OXOOOOOOXOOXOOOOOXOOOOOOOOXXOXOOOOOOOOOXOOOOOOOOOOOOOOOOXOOXOOOOOOOOOOOOOXXXXXOXOXOOXOOOXXOOXOXOOXXXX
OOXOOOXOOOOOOOOOXXOXOOOXXOXXXOXXOOXOOOOOOOXOOXXOXOOXOOOOOOOOOOOOOXOOXOXOOXOOXOOOOOOOOOOXXXXOOOOOXXXXO
OOOXXOOOOXOOXXOOXOXXOOOOOOOOOOXOOXOXOOOXOOOXOXXOOOXXOOOOOOXOOOOOXOXXOOOOXOXXXOOOXOOXOOOOOOOOOOOOOOOOO
OOOOOXOOXOOOXXXXXXOOXOOOOOOXXOOOOOXOXXOOOOXOOXOOOOOOOXOOXOOXXOXOOOOOOOXOOXOXOOXOOOOXOOOOOOOOOXOXOOOOO
OOXOOOOOOOXOXOXOOOOOOOOXOOOOXOOOXOOOXXXXOOOOOXOOXOOOOXOOOXXXXOOOOOXOXOOOOOOXOOOOXOOOOOXOOOXOOOXOOOOOX
XOOXXOOXOXOXOOOOOOOOOXOOOOOOXOOOOOOXOOOOXOOXXOOXOOOOXXOOOOXOXXOXOOOOOXXXXXXOOXXOXOOOOOXXOOOXOXOXOOOOO
OOOOXOXOXOOXOOOOOOOOXOXOOOOOOXOOXXOOOOOOOOOOXOOXOOOOXOOOXXOOOXOOXXXXOOOOOXOOXXOXOOXOOOXXXOOOOOOOXOOXO
XOOOXOXOOOXOOOXOOOOXOOOOXXOOOXOOOOOXOOXOXOOOXOOOOOOOOOOXOOOXXOOOOOOXOOOXXOXOOOXOXOOXOOOOOOOOOOXOOOOOX
OOOOOXOXOOOXXOOOOXOXOOOOXOXXOOXXXOOXOXOOXXOOOXOOXOOOOOOOXXOOXOOOOXOOOOXOOOOXOOXOOOOOXXXOOOOXOOOOOOXOO
XOXOOXOOOOXOOOOOOOOXXOOXXOOXOOOOOOXOOXOOXOOOXOOXXOOOXOXXXOOOOOOOOOOOOOXOXOOOXXOOOOOXOOXOXXXXOXXOOOXOO
OOXXXOXXOOOOOOOXOXOOOOXXXOOXOXXOOOOOOOXOOXOXOOOXOXOXXOOXOOXXXOXOOXXOXXOXXXXOOOOOOOOXOOXOOOOOXOXOOXXXO
OOOOOOOOOOXOOOOOOXXOOOOOOOOXXOXXXOOOOXXOOOOOOOXXOOOOXOOOOOOOOXOXXOOOXOOOXOOXOOOOOXXOXOOOOXOOOOOOOOOXX
OOOOOOOOOXOOXXOOXOOOOXOOOOXXXXOXOOOOOXXOXOOOOXXOOOXOOOXOXOOXOOOOOXOOOOOOXOXOOOOOXXOOOOXOOOXOOOOOXOOOX
XOXOOOOOXOOXOOOXOOOOOOXXOOOXXOXXXXOOXOOOOOXXOOOOOOOXOOOXOXOOOOOOOXOOOOOOOOOOOXXXXXXOOOOXOOOXOXOOXOOXO
OOOOOOOOXXOXOOXXOOOOOOXXOOOOXOOOOOXOXXOOOOOXXXOOOOOOOXXOOXOXOOOXOOXXXOOOXOXOOOXOOOOXOOOOOOXXOOOOOXXOX
OXXXOOOOOXOXXOOOXOOOXOXOOOOXOOOXOOOOXOOOOOOOOXOXOOOOOXOXXOOOOXOOOOXXOOXXOOOOOXXOOOOXOOOOOOOXOXOOXOOOO
OXOOOOOOOXXOOOOXOXOOOXOXOOOOOOOOXOXOOXOXOOXOXOOOOOOXXXOOXXXOXXOOOOOXOOOOXXOXOOOOOOOOXOOOXXXOOOOOOOOOO
