OOXOOXOXOOOOOXXOXOXOOOXXOOOOOXXOOOOOOXXXOOXXOOOOOOXXOOOOXOXOOOXOOOXOXOOOOOOOOOOXOXOXXOXOXOOOXXOOOOXXX
OOOXOOXOOOOOOXOOXOOOOOXXXOOXOOXOOXXOOOXOXOXOOOOOXOOOOXOXXOXOXOOOOOXXXOOXXXOOXOOOOOXOXOXOXXXOXXOOOOOOO
OOXXOXOOOOOOOOOXXOOOOXXOOOOXOXOOOOOXOXOXXOOOXOOOOOOXOOOOOOOXXXOOOOOXOXOOOOOOOOOXOOOOOOXXOOXOOOOOOOOXO
XOOOXOOXOXXXOOXOOXXXOXOOOXOOOOOOOOOOOOOOXXOOOOOXXOXXXOXXXOOOXXOOOXOOOXOXXXXOOOOXOOOOOOXOOOOOOOOXXOXOO
XOXOOXOOXOOXOOOOOOXXOXOOOXOXXXOXOOOOOXOOXXXOOXOOOOXOOOOOOOOOOXXOOXOOXOXOOOXOOOXOXXOXOXOXXXXXOXOXOOOXX
OOOOXOOOOOOXOOXOOOOOOOOOOOOXOOXOXOXOOOXOXOOOOOOXOOXXOOOOOOOOXOOXOOXOXOOXOOOXOOXOOXOOOXXOOOXOOXOOXOOOO
OOOXOOOOOXOOXXOOOOXOOXOXOOOXXXOOXOXOOXXOOOOXOOOOOXOXXXOXOOOOOOXOXOXOXXOXOOXOXXOOOXXOXOOOOXXOOOXOOOXOX
OOOXOOXOOOOXXOOXOXOOOOOOOOOOOOOOOOXXOOXOOXXOOXOOOXOOOOXOOXOOOXXXOOOXXXXOOXXOOXOOXOOXOOOXOOXOOOXOOOOOO
OOXXOXOOXXOOOOOXOOOXXXXXOXOXOOXXXOXOXOOOOOOOOXXOXOXOOOXOOOOOOOOXOXXXOXOXOOXXOOOOXOOOOOXOXOOOOXXOOXOXO
OOXOOXOXXOOOXXOOOOOOXOOOXOOOOXOXXXOXXXOXOOOOOOOXOOXOOOXXOOOXOOXXOXXOOOOXOOOOXOOOOOOOOOXXOOOXOXXOXXXOO
OOOOOXOOXOOXXOOXOOXOOXOXOOOXXOXOOOXOOOXXOOXXOOXOXXOOOXOOOOOOOOXOXOOOXOXXOOOOOXOXOOXOOOOOXOXOOXOXOOOOX
OOOOXXOOOOOXOOOXOXXXXOOOOOXXXXOOXOXOOOOXOOOOOOOXXXOOXXXOOOOOOOXOOOOOXXOOOXOOOOOOOOXXOOOOOOXOOXOOOOXOO
OXXOXXXOOXOOXOOOXOOOOOXOOOOOOOOXOOOOOOOOOXOOOXOOXOXOOXXOOOOXXOOOOOXOXOXOOXOOOXXXOOOOOOOXOOXXOOOOXXOXO
OOOOOOXOOXOOOXOOOOOOOXOXOXXOXXOOOOXOXOOOOOXOXOOOOOXXOOOXOOOXOOOOOOXOOOXOOOXOXXXXXOOXOXOOOOOOOOXOXOOOO
XOOOOXOOOXOXOXOOOOOOOOOXXOOXOOOOOOXOOOOOOOOOOOOXOOXOXOOXOXOOOOXOOOXXXOOXOOOOOOOXOXOXOOOXOOOOOOOOXOOOO
XOOOOXOXOOOXOOOOOOOOXOOOOOOOOOXXOOOXOXOXXXOOXXOXOXOOOOOOOOOOOXOXXXOOOOOXXOOOXXXXXOXOOOOOOOXOXOXOXOOXO
OXOOXXOOXOOOXXOOOOXOOOOOOOOXXOXOXOOOXOOXXOOOXOOOOOOOXOOOOXOXXOOOXOOXOOXXXOXOOOOOXOXOOOXOOOOOOOOXOOOOO
OOOOXOOXOOOOOOOOOXXOOOXXXOXOOOOOOXOOXOXOOOXOOXXOOXXXXOOOXOOOOOXOXOOXXXOOOOXOOOOOOOOXXOXOOOXXOOOXOOOOX
XOXOOOOOXXXOOOOXOOXXOXXOXXOXOXOOOXXOOXOOOOXOOOOXOOXOOOXOOOOOOOOOOOOXOXOOOXXOOXOOOOOOOOOOOXOOXOXOXXOXO
XOOOOOOXOXOOXOOXXOOOOXXOOOOXOOOOXOOOXXOOOOXOOOOXOOOXOXOOXOOOOOOOOOOOOXOOOOXXOOOXOXOXXXXOOOOOOOXOOOOOO
OXXOOOOOOXOXOOXXXOOXOOOOXOOOXOOXXOOXXOOOOOXOOOXXOXOOOOOOOXOOOOOOXOXOXOOOOOXXOOXXOXOOOOXOXXOXXOXOOOOOX
XOOXOOXOOOOOOXOXOOOOOOOXOXOXOOOOOOOOOOOOOOOXOOOOOOOXOOOXOOOOOOOOOOOOOOOOOXOXOOXOXOOOOOXOOOXOXXXXOOOOX
OOOOOXOOOOOXOOOXXOOOOXXXOOOOOOOOOXOOOOOOOOXOXOXXXOXOXOXOOOXOOOOOOOOOOOXOOOXOOOXOOOOOOOOOOXXOOXOOXOOOX
OOOXXOOOOXOOOOXOOOXOXOXOOOOXOOOOXOOOOOXOOXXOOXOXOOXOXOOXOOOOOOOOOOOOOOOOOOOXOXOOOOOXXXOXOOOXOOXXOOXOO
OXOOXOOOOXXOOXOOOOOXOXOOXOXOOOXXXOXOOOOOOOXOOOOXOOOOXOOOXOXOXOOOOXXOXOOOOOXOXXOOXXOOOOXOOXXXOOXOOOOXO
OXOOOXXOXOXOXOOOOOXOOOOXXOOOOXXXXOXOOXXOXXOOXXXOOOOXOXXOXOOXOOXXOXOOOOOXXOOOOOXXOOXOOOXOOOOOXOOXXOOOO
OXXOXXOOOXXOOXXOXOOOOXOOOOOOOOXXOOOOOOXOOOXOOXXOOXOOXOOXOXOOOOOOOXOOOOOOXOOXOOOOOOOOOOOOXXOOXOOOOOOOO
OOXOOXXXOXXXOXXOOXXOXXXOOOXOOOOOOXOOOXOOOOXOOOXXOOOOOXOOOOXOOXOOXOXXOXOOOOOXXXXOXOOOXOXOOXOOOOXOXOOOO
OOOOOOXOOOOXXOOXOOOOXOXOOOOOOXOOOOXOXXOOXOOOXXOXOOOOOOOOOOOOOOOXOOOXOOXOOOOOXOOXXXOOOOOOXXOOOXOOOXXOO
OOOOXOOOOOOOOXOOOOXOOXOOOXOOOXXOXOXXXOOOOOOOXOOOOOOXOOOOXOOXOOOXOOOXOXOOOXOOOOXXXOOOXOOXOOOOOXXOOOOOO
OOXXXOOOXXOXOOOOOXOOXOXOOXOOOOXXOOOXOOOOOOOXOOOOOOOOOXOOXOXXOOOOOOOOXOXXXOOOOXOOOOOXOOOOOOOOOOOXXOOOO
OOOOXOOOOOXXOOOOXOXOOOXXOXXOXOOXXOOXOOOXOOOXOOOOOOXOOOOOXOOXXOOOOOOOOOOXOXOOOXOXOXXOXOOOXXOXOOXXOOXXX
OOOXOOOXOOOOXOXXOOOOOOOXOOOXOXOOXOOOOOXOOOOOXOOOXXXXOXOOOOOXXXOOOOXOOXOOOOOXOOXOOOXOOXXOXOOXOXXOOOOXO
XOOOOXOOXXXOOOOOOXOOOOXOXOOOOOOOOXOXOOOXOOXOOOXOOOOOOOOOXOOXXXXOOXXXOXXOXXOOOXOXXOOOOOXOXOOOXOOOOOOOO
OXOOXOOOOXXXOOOOXXXXOOOOXOXOXOOXOOOOOOXOOOOXOOXOOOOXOXOOOXOXOXXXXOXOOOXOOOXXOOOOOOOOOOOOOXXXOXOOOOXOO
OOOOOOXOOOXXXOOOOXXOXOOXOOOOOOXOOOXOOOOOXOOOOXOOOOXXOOOXXOOOXOOOOXOOOOOXOOXOOOOOOXOOOOOOXOOOOXOOOOOOO
OOOXOXOOOOOOOXOXOXOOOOXOXOOOXOXXOOOOOOOXOXOOOOOXOXOOOXOXOOOOOOOOXXOOXOOOOXOOOOOXOXOOOOOOOOXOOOOXXOOOO
OOOOOOXXOOOOXXOOOOXOXOOOOXXOOOOOOOOOOXOOOOOOOXOOOOOOOOXOOOOOOOOOXOXXOXOOXXOOOXOOOOOXXOOOXOOOXOXOXOOOO
OXXXOOXOOOOOOOOXOXOOOXXXOOXOOOXOOOOXOOXOXOOOXOXOOXXOOOXOOOOOXOOOOOXOOXOXOOOOXOXXXOXOOOOOOOOOOOOXOOOOX
XXOOOOOOOOOOOOXOOXOOOOOOXXXOOOXOOOOOXOXOOOOOOXOXOOOXOOOOOOOXOOOOOXOOOXXOOOXOOOXXOOOOOXOOXXOOOOOOOOOXO
OXOOOXOOOOXOXOXOOXOOOXOXXOOOOOXOOXOXXOOXXXOOOXOOOOOOOOXXOXXOXOOOOOOXOOXOXOOOOOOXOXOOOXOOOOOXOOOOOOOOX
OXXXOOOOOOOXXOOXOOOXOOOOOOOXOXOOXOXOXOOOOOOOOOOOXOOOOOOXOXOOOOOXXOOOOOOOXOOXOOOOOOOOOXXXXOXOOXXOXOOXO
XOOOOOOOOOOXXOOXXOOXOOXOXOOOOOOOOOXOOXOOOOXOOOOOOOXOXOOXOOXOOOOOXXOXOXXOOOOXXOOOXOOOOOXOOXXOOXOOXOOOO
OXXOOOXXOOXXOOXOXXOOXXOOOXOOXOOOOXOOXOOOXXOXXXOOXXOOOOOOXXXOOXOOXOXOOXOOOOOOOOOOXXXXOXOXOXOXOOOOOOOXO
OXOOXOOXXXOOOOOXOOXXOOXOOOOOOOOOXXOOOOOXOOOOOOXOOOOXOOOOOOOXOXXOOXOOOOXXOOOXOOOOOOOOXOXOOXOXXXXXXOOOO
OOOXOOOXOOOXXOOOOOXOOOOOOOXOOXOOOXOOOOOOOOXOXOXXOOOOOOOOOXOOOOOOOOOOXOOXXOOOOOOOXOOXXOOXXOOOXXXXOOOOO
OOOXOOOXXOXXXOXOOOOOOOOOOOOOXOOOOXXXOXXOXXOOXOOOOXXOOXOOXOOOXOOOOOXOOOXOOOOOXXXOOXXOOXXOXOXXOXOXOOOOO
OOOOOOOOXXOOXOOXOOOOOXOOOOXOOXOOOOOOOXOOOXXOOXXXOXOXOXOOXXXOXXXOOOOOOXOOOOOOOOOXXOOXXOXOOXOOXOXOOXOOO
OOXOXOXXOOXOXXOXOOOOOOXXOOOOOOOXOOOOXOOOOOOOXOXOOXXOOXOXOOOOOXXOXOOOOOXOXOOOXOOOXXOXXXOOXXOXXOOOOOXOO
XOOOOXXOOOXOOOOOOXOOOOOXXOOOXOOOOOXOOXXOOXOOOOOXOOOOOOOOXOOOXOXOOOXOOOXOXOOOOOOXOOOOOXOOOXOOOXXXOXOXO
OOXXOOOXXXXOOOOOXOOXOXXXXOOOXOXOOXXOXOOOOOOOOOOOOOOOXOOOOOXXOOOOOXOOOXXXOOXOOOOXOOXOOOOXXXOOXXOOXXOXO
OXOOOOOOOXOXOOOOOOOXXOOOXXOOOOOOOXOXOXOOXXOOOXOXOOOOOOOOXXXXOOOOOOXOXOXOXOOOXOOOOXOXOOOOOOOOXXOOOXXXO
OOOOOXXOOOOXOOXOOXOXOXOOOOOXOOOOXOXXOOOOOXOXOOOOOOOOOOOOXXXOXOOOOOXOOXOOOOOOXOOOOXOOXOOXOOOXOOXOOXXOO
XOOOOOOOXOOXOXOXOOOOXOOOOOOOOOOXOOOXOXXOXOOOOXOXOOXOOXXXXOOOOXXOOOXXXXXXOOOOXOXOXOXOOOOOXOOOOXOXXXOOO
OOXXOXOOOOOXXOOOXOOOOOOXXOXOXOOXXOOOXOOOOOOOOOXOXOXOXXXOXOOXOXXOOXOOOXOXOXXOOOOXOOOXXOOOOXOOXOOOOOXXX
OXXOOOXOOOXOOXOOOOOXXOXOXOXOXXOXOOOXOXOXOXOOOXXOOOXOXOXXOOXXXOOOOXXXOOXXOOOOOXOXOOOOOOOOOOXXXOOXOOOXO
XOXOOOOOOOOOXOOOOOXOXOOOXXOOOOOOOOOOOXOOXOOOOOOOXOOXXOOXXXXOOXOOOXXXOOOOOOOOXOOOXXOOXXOOXOOOOOOXOXOXX
OOXXOOXXOOOOOOOOOOOOXXOOXOOOOOOOOOOXOXXOXXOOXOOOOOOXXXXOOOOOOOOXOOOXOXOOOOOOOOOOOOOOOXXXOOOOOOOXOOOXX
OOOXXXOXOOOOOXOOOOOOXOOOOXOOOOXOXXXXOXOXOOOOOOOXOOXXOOOXOOOXXXOXOOOXOOOOOXOXOXXOOOOOOXOXXXOOXOOOOXOXO
OXOOXOXOXOOOOOOOOXOXOOOXOXOXOOOOXOOXOOOOXOOOOOOOXXOOXXOXXOOOOOXOOOOOOOOXXOOOOOOOOOOOOOOXOOXOOOXOOXXOO
OOOOOXOOXXOOOXOOOOOOOOXOOXOOXOOOOOOOXOOOOOOXOOOOXXOXOXXOOOOXOOOOOOOOOOOOXXOOOXOOOOXXOXXXOOOOOXOOOOOOO
XOXOXOXOOOXOOOXOXOOOOXOOXOXOOXOOOXOXOOOOXOOOOOOOOOOXOOOOXOOXXOXXOOOOOOXXOOOXOXXOOOXOOOOOXOXOXOOOOOXOO
OXOOOOXOOOXOOOXOOOOOXOOOOOXXXOOXXXOOXXXOXOOXOOOOXXXXOXOOXXOOOOOOOOXOOOXXXOXXOOXXXXOOOOOOOOOOOXOOXOOOO
OOOOOOOXOXOXOOXXOOOOXOOXOOOOOOOOOXOOOOOXXOXXOOOXXOXOXOXXOOOOOOOOOXOXOOOOOOXXXOOXOOXOOOXXOOXOXXXOXXOOX
OOOXXXOOOOOXOOOOOXOXOOXOXOOXXOOOOXOOOOOOXOOOOOOXXOOOOXOXOXXXOOOOXXXOOXOOOOXOOXXOXOOOOXOOOOOOOOXXOXOOO
XXXOXXOOOOOOOXOOOXXOOOXOOXOOXXOOOOXOOOOXXOOOOOXOOOOOOOXOOXOOOOOOOOXOOXOOOXOOXXXOOOOOXOOOOOOOXXOOOOOXO
XOOOOOXOOXOOOOXOOXOOOXOXOXOXOOOOOXOOOOXOOOXOXOOOOXOOOXXXOOOXOOOOOXOOOXOXOOOOOOOXOOOOOXXOOOOXXOOOOOOOO
XOXOOOXOXOOOOOXXOXXXOXOOXOOOXOOXOOOOOOOOOOOOOXOXOOXXOOXOOOOOOOOOOOOOOOOXOOOOOOOOXOXOOOOOOOOOXOXOXOXOX
OOOOOOOXOXXXXOOXOXOOOOOXOOOOOXOOOOXOXOOOOOOOXOOOOOOOXOOOOOOOOOXOOXOOXOOOOOOOOOOOOOOOOXOOOOOOOOOOXOOOO
OXXOXOOXOOOOOOXXOOXOXOOOXOOXOXXOOXXOXOOOOOXXOOXOOOOXOXOOOXXOOOXOXOXOOXXXOOXOOOOXOXOXOXOOOOOOOOOOOOOXX
OOOOOXOOOOOOXOOXOXXXOOOOXOOOXXXOOOXOOXXXOOOOXXOOOXOOXXOOOOOOXOOOOOOXOOXOOXOOXXOOOOOOXXOXOOOOXOOOOXXXO
OXOOXOOOXOXOOXXOXXOXOXOOOXOOXOXOXOOOXXOXOXXOOXXOXXOOXOOOOOOOOOXXOOOOXOOOOXOXXXOOOOOOOXOXOXOOOOOXOOOOO
XOXOOOOOOXOXOXOXOXOOOXOOOXXOOOOOXOOOOOXOXOXOOOOOOOOXOXOOOXOOOOXOXXOOOOOOXOOXOXOXOOOOOOOOXOOXOOOXOXXOO
XOOOOOOOOOOOOXOOXXOOOOOXOXXXOXOOOXOOOXOXOOOXXOOOOOOOXOOOOOOXXOOXXOOOOOXOOOOXOOOOOOXOOOXOOOOOXXXOOOOOO
OXXXOOOOXXOXOOOXXXOOOOXOOXOOXXOXXOOOXXXOOOOOXOXOXXOXXXXXOXOOOOOXXOOXOOOXXOOOXOOOOOOXOOOOOOOOXOXOOOOOO
XOOOXOXXXOOOXOOOOOXOOXOXOXXXOXXOOOOXOXOXXOOOOXXOOXOOOOOOOOOOOOXOOOOOOOXXOOOXXXOXOOXOOOOXOXOOXOOOXOXOO
OXOXOOOXXOOOXXOOOXOOXXOOOXOOXOOOOOOOOOOOOOXOOOOOOXOXOOXOOXOXOOOOOXXXOOOXOXOXOOOOOOXOOXOOOOXXOOOOOOXOO
OOOOOOOOOOOOXXOXXOOOOOXOXOOXOOOXOOOXXXXOXOOOOXXOOOOOOXOXXOXXOOXXOOXXOOXOOOOXXOOOOOOOOXOXOXOOXOXOOXXOO
XXOOOOXOOOOOXOOOOXOXXXOOOXOOXXOXOOOXXOOXXXXOXOOXXOOOOOOOOOXOOOXOOOOOOXOOOOOXOOXXOXOOOOXXXOOXXOOOOXXOX
OOOOOOOOXXXXXXXOOOXXXOOOXXOOOXOOOXOOXOXOXXOXXOXOOXOOOOXOOXOOXXXOXXXOXOOXXXOOXOXOOOOXOXOOXOOOOOOOOXOXO
OOXXOOXXOXOOOOXOOOOOXOOOOOOXXOOOXOXXOOOOOXOOXXOOOXXOOXOOXOOOOOOOOOXXOOOOOOOOOOOOXOOOOOOOOOOOXOOXOOOOO
OXXOXOOXXXXOOOXOOOOOOOOOOXOXOOXXXXXOOOOOOOXXXOXOOXXOXOXXXOOXXOOOOXXOOXOOXOXOOXOXOXOXXOXOOOXXOXXXOOOOO
OXOXOXOOXOOXOXOOOOOXXOOOXXOOOOOOOOXOOOOOOOOXXXXOOOXXXOOOOOOOOOOOOXOOXOOOXXXXOOOOOXOXOOOXOOOOOOOXXOXOO
OOOXXOOXOXOOOOXOOOXXOOOOOOOOOXOXXOOOXXOXXOOOOOXOOOOOOOOXOOOOOOOOOXOOOOOXOXXOOXXXOXOXXOOOOOXXOXXXXOOOX
XOXOXOOOOOOOXOXOXOOOOOOXOOOXXXOOXOOXOOXOXOXOXOOOOXXXOOXOXOOXOXXOOXOOOOXOOOOOOOXXOOOOXOXXXOXXOOOOXOOOO
XOXOOOOXXOOXOXOOXXOOXOOOXOOOOXXXXXOOOOOOXXOOOXOOOXOOOOXOOOOOOXOXOOOOXOXOOOOXOOOOXXOOOXXOOOXOXXOOXOOXO
OOXXOOOOOXXOOXOOOXXOXOOOOOOOOOOOOOXOXOXOXXXOXOXOXOXOXXOOXOXXOOOOOOOOXXOOOOXOXOXOOXXXXOXOOXOOOOOOOXOXO
OXXOOXOXOXXXOXOOOOXOXOOOOOOOOOOOOOXOXOOOOOOOOXOOOOOXOXOOOOOOXOOXOXOOOOXOXXXXOOXXOOXXOOOXXOOOXOXOXOOXO
OOOXOOXOOOOXXOOXOXOOOOOOOOXOOOXOOOXOOXOOOOOOOOXOOOXOOOOOOXOXXXOXOXOOXXOOOOOOOXOOOOOXOOOXOOOOOOXOOOOOX
XOOXOOOXOOOOOOXOXXXOXOOXXXOOXOOOOOOOOOOOXOOOOOOXXOOOOOOOOXOOOXOXOOOOXXXOXOOOOOXOOXOOXOOOOOOOOOOOOOOOX
OOOOXXOOOOOOOXXOOOXOXOOOOOOOOOOOOOOXXOXOOXOOXOXOOOOXOOOXOOOOOXOXOOOXOXOOOXOOOOOXXOOOOOOOOOXXXOOOOOXOO
OXOOOOXOOOOOXXOOOOOOOXOXXXOOOOXOXOXOOOOOOXXXOOXOOOOXXXOXOXOOXXOOOOOXXOOOXOOOOXOXOXXXOOOXXOOOOXOOOOOOO
OOOXXOOOOOXOOOOOOOOOXOXOXOXOOOOOOOXOXXOOOOOXOOOOOXOXOXXXXXXXXXOXOOXOXOXOOOOXOOXOOOXXOXXXXXOOOXXOXOOXX
XOOOXOOOOOOXOXXXOOXXOOOXOOOOOOXOOOXOOXOOOOOOXOOOOOXXXOOOOXOOOXOXOXOOOOXOXOXXOXOXOOOOXOOOXOOOOOOOOXXOO
OOOXOOOXOOXOOXOOXOOOOOXXOOOOXOXOOXOOOOXXOOOOXOXOXXOOOXOOXOXOOOOXOOOOOOOXOOOOOOOXOOXOXOOOOXXXOOOOOOXXO
XOXXOXOOOOOOOOXOOOXXOXOXXOOOOOXOOOOXXOOXXOOOOOOOOOOXOXOOXXXXOOXOOOOOXXOOOXXXXOOOOOXOOOOXOXXOOXOXOOOOX
XOOXXOOOOOXOOOOXXOOXXXOOOOOXOXOOOOXOXOOOOXOOOXOOOOOOOOOXOOXXXOXXOOOOOOXXOOOOOXOOOOOOOXOOXOXOOOOXOOOOO
OOOOOOOOXOOOOXXXXXOOXOOOOOXOXOXOOXXOXXOOXOOOXXXOOOOOXOOOOOOOOXOXOXXOOOXOOOXOOOOOXOXOXXOOXOOOOOOOXXOXO
XOOXXXOOXOOOOXOOOOOOOXOOOXOOOXXOOOOOOXOXOOOXXOXXOOOOOOOOOOOXXXOOXOXXXOOOOOXOOXXOOOOOOOOOOOOOOXXOOXOXO
OXOOOOXOXOOOOOXOXOOOOOOXOOXOXXOOXOOOOOOOOOXXOXOOOOOXOOXOOOXOXXOOOOOXXXOOOXOXXOOOXOOOOOOOXOOOXOXXXOXXO
XOOOOOOXOXOOOOOOOXOOOOOOXOXOOOXOOOOOOOXOOXOXOXXOOOOOOXOXXOOOOOOOOOOOOOXOOOOOOOXOOOOOOOOOXXOOOOOXOXOOX
