XXXOOOXOXOXOOOOOOOOOOOOOOOOOOOOXXOOOXOOOOOOOOOOXOXXXOXXOXOOOXXOXOOXOOXOXOOOXOOOOOXXXOOXOOOOOXOXOOOXOO
OXXXXOXOOXOXOOXOOXOOXXOOOOOOXOXXOOOXOOOOXOXOOOOOOOXOXOOXXOOXOOXXOOXXOOXOOXXOOOOOXOOOOXOOOOOOOOOOXOOOO
OOXXOOOXOOOXOOOOXXXXOXXOOOOOOOXXXOOXXOXXOOXOOOOOOOXOOOOOXOOOOOOXOOOOXOOOOOOOOOOOOOOOOOXOXXOOOOOOOXOOO
OOXXXOOOOOOOOOOXOOOOXOOOOXOXOOXXOOOOOOOOOOOOOOOOOXOOOOOOXOOOOOOXOOOOOOOOOOOOOOOOOXXXXOXOXXXOOOOOOOOXX
OOOXXXXOOXOOOOXXOXOOXXXXOOXXXOXOOOOXOOXOOOXOXXXXOOOOXOOXXOOOOXOOOOXOXOOOOOXOOOOOOXOOOOOOOXOOOOOOOOOOO
XOOXOOOOOXOOXOXOXOOOOOOOOOOOOOXOOOOOOXOOOXOOXOOOXOXOOXOOOXOXXOOOOOXXOOOXOXXOXOOOXOXOOOXOOOOXXXXOOOOXX
XOOOOOOXXOOOOOOOOOOOXOOOOOOOXOOOOOXOXOXOOOOOXOOOOOOOXXXXXXOXXXOOOXOOOOOXXOOOXOOOOOOOXOOOOXOOXOOXXXXXO
OOXOOXOXOOOXOOOXOOOOXXOXOOOOOOOOOXOOXOOOOOOOOOXXOOOOOOXOOXXOXOOXOOOOOOOOXOOOOXXOOXXXXXXOOOXOOOOXXXOOO
OOOXOXXXXXXOOOOOXOXXXOXOOXXOOOOOOOXXOOXXOOOOOXOOOOOXXOOOOXXOXOOXOOOXXOOOOOXOOOOOXOXOXOOOXOOOOOOXOOOOX
OOOOOOOOOXOOOXOOOOXOOOOOXXXXXOOXOOOXOOXOXXOOOXOOOOXOOXOXOOOXOOOXXOOXOOXOXXOOOOOOOOOOXXOOXXXXXXOOOOXOX
OOOOOXOXOOOXXOXXOOOOOOOOOOXOOOOOOXOOOOXOOOOXOOOOOOXOOOOXXOOOOOOXOOOXXOOOXOOOOXOOXXOOOXOOOOOXOOOXOOOOX
XOXOOXOXXOXOOXOOOXOOXOXOOXXOOOOXOXOOOOOOOOOOOXXXOOOXOOXXOOOOXOOOOXOOXOOXOOOOOOXOOOOOXOXOOXOXXXOOOOOOO
XOOXXOOOOXOOXOOOOOOOOOOXOOOXOOXOOXOXOOOOOOOXXOXXOOXXOOOOOXOOOOXOOOOOOXOOXXOOOOOXOXOOOXOOOXOOOXOXXOOXO
OXOOXOOXOOXOXOOOOOOOOOOOXOXOXOXXXOXOOXXOOOXOOOXOOXXOOXOXOXOOXXOXOOOOXOXOOXXOXOXOOOOOOOXOOOOOOOOOOOOOO
OOXXXOOOOOOXXXXOOXXOXXOOXOOOOOOOOOXOOOXOOOXOXOOOOOOXOOOXOOOOOOOOOOOOOOOOXOOOOOOOOOOOXXOOOXOOOOXOXOOXO
OOOOOOOOOOOXOXXOOXOOXOOXOXXOXOOXXOOOOOOXOXOXXOOOOXOOOOOOOOOOOOOOXOOOOOOOOOXOOXOOOOXOXXOOOOOOXOXXOOOOO
OXXOOOXXXXOOOXOXOOOOXOOXOOXXOOXOOOXOOOXOXXOOOOOOOXXXOXOOOOOOXOXOXXOOOOOOXOXOXOOOOOXOOOOXOXOOXOOOOOOOO
OOOOOOOOXOOOXOOOOXOOOOOXOXOOXXXOOXOOOXXOOOXOXOXXOOOOOOOOXOOOXXOOOOXOOOOXOOOOXOOOXOOOXOOXOOOOOOOOOOOOO
XOOXOXXOOOXOOOOOOOXOXOOOOOOOOOXXXXOXXXOOXXXOXOXOOXOOOOOOOOXOOOOOOOOXXXOXXXOOXOXOXOOOOOXXOOOOOOXXOXOXO
XOOOOOOXXOXXXOXOOOXOOXOXOOOXOOXOXXXXOOOOOOOOOOOXOOOXOOXXOOOXOOOOOOXOXXOXXOOXOOOXOXOXOXOOOOOXOOOXOOOXO
OOXXOXOOOOOXOOOOOOOOOXXOOOOOOOOXOOOXOOOOXXOXXOXXOOOXXOOOXOOXOOOOOOOOOOOXOXOOOOXOOOOOOXOOOOXOXOOXXXOOO
OOOOXXXOXXOOOXXXOOXOOOOOXOOOOOXOXXOOXXXOXOXOOOXOOXOXXXXOOOOOOOXOOOOXOOOXOXXOOOOOXOOOXOOOOXXOXOXXOXXOO
OOOOXXOOOXOOOOOOXOOOOXOXOOOXOOOXXOXXOOOOXOOXOOXOOXOOXXOXOOOOOOXXOXXOOOOXOOOXOOXOOXOOOXOXOOOXOXOXOOOOX
OXOOOOOOOOOOXOOOOOOXOXOOOOOXOXXXXOXOOOXXOOOOOOXOOOOOOOOOXOOOXXOOOXOXOXXXXOOOOXXOOXXOOOXOOXXXOXOOOOOOO
OOOOOOOOOOOOXXOXOOOOOXXOOXOOOOXOOOXXOXXXXXXOOOOOOOOOOXOOOXOOOXOOOXOOOOXOXOXXXOOOOOXOOOOOOOOOOXXOXOXXO
OOXOOOXOXXOOOOOOOXOXOOOOOXOOXXXOXOXOXOOOXXOXXXXXOXOXXXXOOOXOOOOOOOXOOOOOOXXOOXOOOOOXOOOXOOOOOOXOOXOOX
OOOOOOOOOOOOOOOXOXOXOOOOOOXXOOOOXXXOOOOOOOOOOXOXOOOXXOOXXOOOOOOXOOOXXOXXOOXOOOOOOOOOOOXXOOOOXOOOOOOXO
OOOXOOOOOXOOOOOOOOOOXOOOOOOOOXOOXOXOOOOXOXOXXOOOXOOOOOOOOOXOOOOOOXXXOOXOXXOOOOOOOXXOOOXXXOOOXOOOOXOOO
OOOXXOXXOOOOOXOOOOOOXOOXOOOOOOOOOOXOOOXOXXOOOXOOOOXXOXXOOOOOOOXOOOOOXXXOXXXXXOOOOOXOOOOOOOOXOOOOOOXOO
XOOOOXOOXOOOOOOXOOOOOXOOXOOOXOXOOOXOOOXXXOXXXXOOXOOOOOXOXOOXXOOXXOOOXXOXOXXOOXXOOOOXOXOOXOOOOXXOXOOOO
OOOOOOOOOXOOOOOXOXOXOXOOOXOOOXOXOOOXOOOOOOOOXOOOOOOOOXOXOXXOOOOXOOOXOOOOOXXXOXOOXXXOOXOOOOOXOXOOOOXOO
OXOOOXOXOXOOXOXXOOXOOOOOXOOOXXXXOOOOOXOOXOOOOOOOOXOOOOOOOXXOXOOOOOXXOOXOXOOOOOXOXOXOXOXOOOXOXOOOOOOOO
XOOOOOOOOOOXOOXXOOXOOXOOOXOOXOOOOXOXXOOOOOXOOOOXOOXOOOOXOOXXOOOOXOOXOXOXOXOXOXOXOOOXOOOOOOOXXOXOOOOXO
OOXOXOXOXOXOXOOOXOOOOXXXOXOOXOXOXOOOXXOXOOXXXOOOOOOXXOOOOXOOOOOOXOOOOOOXOOXOXOXOOXOOOOXOOXXOOOOOXOOOX
OOOOOXXOOXOXOOOOOOOOOOXOXXXOOOOOXXOOOXOOOOOOOOOXOOOOOOOOXOOOOOXOXXXOOOOOOOOOOXXOOXOOXOOOXOOXXXXXOXOOO
OXOXOOOOOOOOOOXOOXXXOOOOXOOOOOOOXXOOOOXOOXOXOXXOXOOXOOXOOOXXOOOOOOXOOOXOOOOOOOOOXXXOOOXOOOXXOOXXOOOOO
XOOOOOOOXOOXOOXOXOXXOOXOOOOXOXOXXOOOOOXXXOXXXOOOOXOXOOOXXOOOOOOXOOOOOXOOOOXOXOOOOOOOOOOOOXOOOOOOOXOOO
XOOOOOOOOOOXOOXXXOOXOXOXOOOOOOOOOOOOOXOOXOOOOOOXOOOOOXOOXOXXOOOOOXOXOXXOXOOOXXOOXOOXXXOXXXOOOXOXOOOXX
OOOXXXOXOXOOXOOOOXXOXXOXOOOOOOOOOOOOOOOOOXXOXOOOXOOOOXOXOOXOOXXOXOXXOXOOOXOOOXOXXOXXOOXOOOOXOOOOOOOXX
OOOXOXXOOOOXXOOOOOXOXOOOOOXXOOOOOXOOXXOOOOOOXOOOOXOOXXOXOOXXXOOOOOXXOXOOOOXOOOXOOOOOOOOOOXOOOOOXOOOOO
OXXOOOOXOXXOOOOOOOOOOOXXOOOXOXOOOXOOOXOOOOXOXXXOOOXOOXOOOXOXOXOOOOXXOOOOXXOOOXOOOOOXOOOOOXOOOOOOOOXOO
OOOOOOXOOOOOOXXOXOOOOOOXXOOXOOOOXOOXOOXOOOOOXXOXOOXXXOOXXXOOOOOOOXOOOOXXXOOXOXOOOOOOOOOOOOXXOOXXOXOOO
OOOXXOOXOOOOOOXOOOOOOOOXOOXXOOXOOOXOOXXOOXOOOOXOOOOXOOOOOOOOXOOOOOXOOXOOOXOXOOOXOOOOXXOOXXOOOOOOOOOOX
OOOOOOOOOOOOOXOOOOXXOOOOXOXXOOOOXXOOOOXOOOOOOOXXOOOXXOOOXOXOXOOXOOOOOOXOOOOOOOOXOOOXOOXOOXOXOOXOOOOXX
OXOOOOOXXOXXOOOOXOXOOOOOOOOXXOOOOXOOXOXXOXOOXXXOOXOOOOXOOOXXXXXXXXXOXOOOOOOOXOXOOOXXXOXOOXOXOOXOOOOXO
OXOOOXXOOOOXOOOOOXXOXOXOXOXXOXXXXXXXOOOOXOOOXXOOOXOXOOOXOOOOOOOXOOOOOOXOXOOOOXOOOXOOXOOOOOOOXOXOOOOXO
OOOXXOOOOOXOOOOOOOOOXOOOXOXXOOOOOXOOOXOOOXOOXXOXOOOOXOOXOOXOOOOOOOXXOOXXOOXXXOXOOXOOXOXXOOOOOXOXOOOOO
OOOOOXOOOOOOXOOOOOOOXOXOOXXOXOOXXOOOOOOXOOOOOOOXXXOOOOXOXOOOOOOXOOOOOXXOOOOOOOOOOOOOOOOXOXOOOOXOOOOOO
XOOOOOXOOXOOXXXXXOOOOOOOOOXOOOOOXXXXXOOOXOOOXXXOXXOOOOOOOOOOXOOOOOXXXOOOXXXOOOOOOOXOXOXXOOOOXOOXXOXOX
OOOOXOOOOOXXOOOOXXOOOOOOOOOXOOOOXOOOOXOXOOOXOOOOOXXOOOXXOOXOOXOOOXOOXOOOOOOOOOOOOOOOOOXOOOOXXXXOOOOOX
OOOOOOXOOOXOOOXOOOXXXOOOOXXOOXOOOOOOOOXOOXOOOOXXOXOOXOXOXOOOOOXXOXOOOOOOXOXOXOOOOOOOXOOOXOOXXOOOXOXOO
OOOOOXOOXXOXOXXOOXOOOOOOOXOOOOOOOOOOOOXXXXOOOOOXXOOXOOXXOOOOOOOOOXXOOOOOOOOOOOOOOOOOOOXOOXOOOXOOOXXXX
OOOOXOOXOOOOOOXOOOOOXOOOXOOOOOOXXOOOOXOXOOOOOXOOOXOOOOOXXOOOXOOOOXOXXXXOOOOOXXOOOOOOXOXOXOOOXOOOOOOOO
OOXXXXOXOOXOOOOOOOOOOOXXOOOXXXOOOXOXOXOOOOOOOOXOOOOOOOOOXOOOOOXOOOOXOOOOOOXOXOOOOXOOOXOOOOXOOOOXXOXOO
OXOXOXXOOOXOXOOOXOOXXOXOOXXOOOOOXXOXOXOXOOOXOXXXXXXOOOXOOXXOOXOOOOXOXOOOOOXOXOXXXOOOOXXXOXOOOOXXOOXOO
OOXOOOXOOOOOXOOOOXOOOXOOOOOXOOOXOOOXOOOXOOOOOOOOOOOOOXXOOOXOOXOOOXOOXOOOXOOXOOXOOXOOOOXOXXOXOOXOOXXOX
XOXOOOOOXOOOOOXOOXXOOXOXOXOXXOOOOOOXOXOXOOOOOXXOOOOOOOXXOOXXOOXOOOOXXOOOOOXXOOXXOXOXOOOOOXOOOXOXXXXXX
XXOXXOXOOXXXOOXXOOOOOOOOOOOOOXOOXOXOOXOOOOOOXXXXXXOOOOOOXOXOOXOOOXXXOXOXOOOOOOOOXOOOOXXOOOOOOOOXOXOXO
OXOOOXOOOOOXOOOOOXXOXXOOOOOXOOOXXOOXOXOXXXXOXOXOOOXXOOOOOOOOOOOOOOOXOOOOOXXOXXXXOOXOOXXXXXOOXOXOOXOXO
OOXOOOXOOOOXOOOOXOOOOOOXOXOOXXOOOOOOOOXOOXOOOXOXOXOOOOOXOOOXXOXOOOOXXOXXXOXOXXOXOOXOXXOXOXXXOOXOXXOOO
XXOOOOXOOOXOOXXOOXXOXOXXXXOOXXXOOOXXOXOOXXXXOOOOXXXOXXOOOOXOOOOOXOOOOOOOOOOOOXOOXOXOOOOOXXXOOOOOOXXOX
OOOOOXOOOXOXOXXXXOOOOXOOOOXOOOOOXOOOXOOOOXOXXOOOOOOOXOOOOXXXOOOOOOXOXOXOOXOXOOOXOXXXOOOOXOXOXOOOOOOOX
OOOXOOXOOOXOXOOOOXOOOOXOOOXOXXOXOOXOOOOOOOOOOXOOOXXOXOXOOOOOOOOOOOXOOXOXOOOOXOOOXXOOOOOOXOOOOOOXOOOXO
XXXOOOOXOOOOXXOOXOOOXXOOOOOOOOOXOOOOOOXOOXOXOOOOXOOOOXXOOXOOOOXXOOXOXXXXOXXOXOOOXXOOXOOOOOXOOXXXXXOXO
OOOOOOXOXOOOOOOOOXXOOXOOOOOXOOOOXXOXOOOOOOOOOOOOOOXXOOOXOOOOOXOOOOXXOOXOOOOXOXOOXOOXOXXOOXOOOOOXOOOOO
XXXXOOOOOOOXOOXOOXOXOOOOOXOOOOOXOOOOOOOOXOOXOOXXXOXXOXXOXOOXOOOOXOXXOOOOOXOOOOOOXOOOOOOXOOOOXXXXOOOOO
OOOXOOOOOOOXXOOOXXXOOOOOOOXOOXOXXOOOXOOOOOOOOOOOOOOXOOOOOOOOOXXOOOOXOOXOOOXOXOXOOOOOOOXXOOXOOXOXOXXOO
XOOXXXOOOXOOXXOOXOXXOXOXOOOOOOOOXOOOOOOOOOOOXXOOOOOOOOOXXXOOXOXXOOXOOOOOOXXXXOOXOXXOOOOOOXOOOOOXOOOXO
OXXXXXOXXXXOOOOXOOXOOOOOOXXOXOOXOOOOOOOOOXOOOOOOXXXOXOXXOXOXOXOOOOOXOXXOXOXOOOOXOOOXOXOOOOOOXOOXOOXXO
OOXOOOOOXOXXOOOOXOOOOOXOOOOXOXOXOOOOOOOXXXOXXXOOOXOOXOOOOOOOXOOOXOOOXOXXOXOOXOOOXOOOOOOOOXOOOOOOXOOXO
XOOOOOOOXXOOOOXOOXXOOXOOOXOXOOOOOOOOXOOOXOOOOOOXOXOOOOOOXOXOOOOXOOOOOXXOXXXOXOOOOXXOOXXXOOOOOOXOOXOOX
OOXXOOOOXOXXOOOOOXXOOOXOOOOOOOOOOOOOOXOOOOOXOXXOXOXOOOOOOOOOOOOOOOXXOOOXOOOXOOOXOXOOOOOXOOXOXOOXOOOOX
OXOOOOXOOOXOOOOXXOOXOXOXOOOOXOXXOXOXOXOOXOXOXOXOOXOOXXOOXOOOOOXOOOOOOOOXOOOOOOXOOOXOOOXOOOOOOOOXXOOOO
XXXXOXOOOXOXOOOOOOOOOXOXOOXOOOXXOOOXOXXXOOOOXOOXXOOOXXXOOXOOOXXXOOOOOOXOOXOOXOXXOOOOXOOOOOXXXOOOXXXOO
OOOXOOOOOXXXXOOOOOOOXOOOOOOOXXOOOOOOOOOOOXXOOXXOOOOOXOOXOOXOOOOXXXOOOOXOOOOOOOOOOOOOXOXOOXOOOOXOOXOXO
OOOOOOOOOOOXXOOOOOXXOOOOOXOOOOOOOOOOXOXOXOOOOOOOXXOOOXOXOOOOOOXOOOOOOOXOOXOOOOOXOOOOOOXOXOOXOOXXOXOOO
OOOXXOOOXXXXOOOOOOXOOXOXOOOOXXOOOXXOOXOOOOXOXOOOOOXOOOOOOOOOXOXOOOOOOOOOOOOOOOXXOOXXOXOOOOOXOOOOXOXOO
XOXOOOOOXXOOOOOOOOOOOXOXXXOXXOOOXOXOXOXOXOOOOOXOOOOOOOOOOXXOOXOOOOOOOXOOOOOXXXOOOXOOOOOXXOOXOOOOOXOOX
XOOXOOOOOOOOOOOXOOXXOOOOOXOOOOXOXOOOXOOOOOOOOOXOXOOXOOOOOXXOOXXOXXXOOOOOOOXOXOOOOXOOXOXXOOOXOOXOOOOOO
OXOOOOOOOOOOOOOOOOOOXXXOOOOOOOOOOOXOXXOOXOOOOXOOOXOXOOOXOOOOOXOOOXOOOOXXXXOOOOOXXOOOOXOOOOXOOOXOOXOOO
XOOOOOOXOOOOXXOXOOOXOXXXOOXXOOOOOOOOOOOOXXXOOXOXOOXXOXOOOXOXOOXOOOOOOOOOOOOXOOXXOOOXXOOOXXXXOOOOXOOOO
OOOXXXOOOOOOXXOXOOOXXOXOOOOOXOOXXOOXOOOXXOOOOXOOXOOXOOOXOXOOOXOOXXOOOOXOOXOOXXOOOOOOOOOOOOOOOXOOOXOOX
OOOOOOOOXXXOOOOOOOXOOXOXOOOOOOXXOOOOOXOOOOOXOOXXOXOOXOOOXOOOXOOXXOXOXOXOXXXXOOOOXOOOOXOXOOOXOOXXOOOXX
OXOXOXOXOXOXOOXXXXXXOOOOOOOOXXOOOXOOOXOXXXOXOOXXOOXOOOXXXXOOOXOOOOXOOOOXOOOOOOOXOXOOOOXXOXXXOOOOOXOOX
XOOOOOOOOOOOOOOXOOXOOOOXOOOOOOOXOOXOXXXOOXOOXOOOXOOOOOOOXOOXOXOOOOOOOXOOOOOXXXOOOXXOOOXXOXOOOXOXOOXXO
OOOOXXOOXOOOOOOOOOOOOXXXXOOXXOOOOOOOOOOXOOXOXOXXXOOOOXOOOOOXXXOOOXOOXXXOOOOOOOXOXXXOXOOOXXXXOOXOOOOOX
OOXXXOOXOOOXOXOOOXOOOOXOOXXOOXOOOXOOOXOOOXXOOXOOXOOOXOOOXOOOOOOOOOOOOXOXOOOOXOOOXOOXXXOXOOOXOXOOXOOOO
OXOOXOXOXXOXXXOXXOOOOOOOOXOOOOXOOOXXOOOOOOXOXOOOOOXOXOOXXOOOXXXXOOXOOOOOOOOXOOOOXOXOOXOXOOXOXOOOOOOOO
XOOXOOOOXOOOOXOXOOOOOXXOXOOOXXOOXXXXOXOOXOOXOOOXOOXOOOOOOOOXOXXOOOOOOXOOOXOOOXXOXOOOOOXOOOOOOOOOXOXOO
OXOOOOXOXXOOOOXOXXXOOOXOOOOOOOXOXXOOOXXOXOOOOOOOOOOOXXOOOOOXOOOOOXOOOOOOOOOOOOOOXOXOOOXOOXOOOOOOXOOXO
OOOOOOOOOXOXOOOOOOOOOOXXXXOOXOOOOOXOOXOOOOOOOOXOOXOOXOXOOOOOXOOOOXOOOXXXXOOOOOXXOOOXOOXOOOXXOOOXXOOXX
OOOOOXOOOOXOOOOXOXOOOOXOOXOOOOOXOOOOXXOOXXXOOOOOOOOXOOXXOXXOXOOOXOXOXXXOOOOOOOOOOOXOOOOOOOXOOOOXOOOOO
OOOOXOOXOOOOXXXOOOOOXOXOOOXOOXOXXOOOOOXXOOOOOOOOOOXOXOXOXOOOOOOOOXOOOOXOXXOOOOOOXOOOOOXXXOXXOXXXOXXXO
OOOOOXOXXOOXOXXOXOOOXOXXOXXOOOXOOOXOXXOOXXOXXXOOXXOOOOOOOOXOOOXOOOOOXXOOXXOOOOOOOXOOOOXOOOOOXOXOXXOOX
OOOOOOOOOOXXXOOOOXOOXXXOXOOOOOOOXXXOOXOXOOOOXOOXXXOOXXOXXOOXXOXOOOXOOOOOOOXXXOOOOOXOOOOXXXXXOOOXOOXXO
XOXOXOOOOOOOOOOXOOOOXOOXOXXOOOXOOOOXXXOOOXOOOXXOOXOOOOXOOOOXOXOOOXOXOOXOOOOOXXOOOOOXXOOXOXOOOXOOOOXXX
XOXOOOXOXOOOOOOXOOOOXXOOOOXOOOXXXOOOXOOOOOOOOOXOOXOXOOXOOOXOOOOXXOOXXOOOOOOOOOOOOOOOOOXXXOOOOOOOOOOXO
OOOOOOXXOOOOOOOOOOXOOXOOOOOOOOOOOOOXOOXOOXOOXOOOOXOOXOXOOXOOXOOXOOOOXOOOOOXXOXXOOXOOOOOOOXXXOOOXXOOXO
XOOOOOXOOXOXXOOOOXOOOOOOXOOOOOXOXOOOXOOOOOOOXOXOOOOOOOXXOOOOOOOOOOOXXOXXOXOXOOXXOOXXOXOOOOXXXOXOOOOXO
OXXOOXOOOOOOOOOXXXOXXXXOOXXOOOXOOOOOOXOXOOOOOOOXOOXOOXOOXXOXOOXXXOOOXOOXXOOXOOOOOOOOXOOOOOXXOOOOOOOXO
XOOXOOOXXOOOOOXOOOOOXOXXOOXOXOXOXOOOXOOOXOOXOXOXOOOXOXOOXOXOOOOOOOXOXOOOOXOOOOOOOOOOOOXOXOXOOOOOOOOOO
